shiftSinceLineset,motionSinceLineset,snap_motion_gap,init_rel_y_dis,end_rel_y_dis,overall_y_change,init_rel_x_dis,end_rel_x_dis,overall_x_change,motion_s_avg,frames_in_motion,swapped_side,y_dis_travel_pos,y_dis_travel_neg,position,swapped_y_dir
0,1,0,983,201,782,-244,-649,405,341.95348837209303,43,0,288,1071,RB,1
0,1,0,2,-320,322,-475,-256,-219,234.14705882352942,34,1,211,539,FB,1
0,1,40,554,613,-59,-221,-146,-75,120.88888888888889,9,0,71,4,FB,0
0,1,0,1082,582,500,-151,-117,-34,230.3,20,0,0,474,WR,0
1,1,40,12,-469,481,-264,-116,-148,175.2058823529412,34,1,24,514,TE,0
1,1,40,1021,529,492,-260,-210,-50,137.52631578947367,38,0,10,517,WR,0
0,1,0,1243,828,415,-195,-202,7,251.76470588235293,17,0,15,421,WR,0
0,1,39,41,-1463,1504,-897,-208,-689,287.44642857142856,56,1,2,1513,WR,0
0,1,30,1552,-213,1765,-121,-541,420,335.57142857142856,56,1,11,1767,RB,0
0,1,0,929,391,538,-242,-354,112,359.1875,16,0,19,543,WR,0
0,1,0,1478,932,546,-162,-167,5,183.41379310344828,29,0,0,546,WR,0
0,1,0,653,-212,865,-217,-250,33,431.75,20,1,15,866,WR,0
1,1,36,814,1115,-301,-152,-149,-3,100.27450980392157,51,0,408,118,WR,1
1,1,22,1217,-1732,2949,-130,-163,33,457.32307692307694,65,1,12,2965,WR,0
1,1,32,242,-302,544,-502,-482,-20,100.83928571428571,56,1,8,536,RB,0
0,1,30,684,212,472,-348,-480,132,264.4,20,0,12,493,RB,0
0,1,38,355,433,-78,-188,-95,-93,120.14285714285714,14,0,109,36,TE,1
0,1,0,1199,359,840,-227,-361,134,480.8888888888889,18,0,9,835,WR,0
0,1,0,697,315,382,-203,-264,61,358.7837837837838,37,0,459,852,WR,1
1,1,90,1934,875,1059,-28,-77,49,227.5,46,0,14,1055,WR,0
0,1,95,588,828,-240,-70,-38,-32,114.765625,64,0,434,200,TE,1
1,1,105,256,374,-118,-454,-450,-4,86.9375,16,0,155,47,RB,1
1,1,88,1238,1924,-686,-65,12,-77,161.02325581395348,43,0,701,10,WR,0
0,1,44,342,-440,782,-214,-154,-60,260.59375,32,1,24,791,TE,0
0,1,26,307,1491,-1184,-744,-236,-508,321.3170731707317,41,0,1191,5,WR,0
0,1,29,1067,1509,-442,-191,-62,-129,182.03846153846155,26,0,441,4,WR,0
0,1,10,216,581,-365,-392,-191,-201,142.0,41,0,381,17,RB,0
0,1,40,857,464,393,-192,-164,-28,101.33333333333333,39,0,5,390,WR,0
0,1,0,984,552,432,-264,-394,130,245.26315789473685,19,0,30,450,WR,0
0,1,49,449,528,-79,-205,-170,-35,132.25,8,0,92,8,TE,0
1,1,59,793,1459,-666,-146,-92,-54,189.17142857142858,35,0,677,4,WR,0
1,1,63,1170,1313,-143,-213,-213,0,72.5,16,0,155,26,WR,0
0,1,19,1573,68,1505,-73,-175,102,261.3235294117647,68,0,13,1509,RB,0
0,1,46,163,-270,433,-509,-457,-52,164.0625,32,1,37,467,RB,0
0,1,0,468,125,343,-234,-255,21,321.1818181818182,11,0,15,353,FB,0
0,1,10,564,-1540,2104,-212,-95,-117,314.02985074626866,67,1,1,2099,WR,0
0,1,0,219,-128,347,-610,-616,6,306.8181818181818,11,1,3,344,RB,0
0,1,0,718,365,353,-200,-312,112,363.90909090909093,11,0,19,360,WR,0
0,1,0,447,441,6,-135,-126,-9,17.0,2,0,6,7,TE,1
0,1,18,547,547,0,-204,-209,5,32.0,1,0,9,7,RB,1
0,1,0,746,-525,1271,-229,-214,-15,385.3030303030303,33,1,3,1272,WR,0
0,1,0,436,207,229,-255,-257,2,236.9090909090909,11,0,17,241,FB,0
0,1,0,484,-524,1008,-275,-250,-25,484.76190476190476,21,1,3,1006,TE,0
0,1,0,12,91,-79,-465,-458,-7,107.71428571428571,7,0,76,1,FB,0
0,1,0,1511,931,580,-214,-193,-21,250.8695652173913,23,0,2,585,FB,0
0,1,0,1531,865,666,-174,-210,36,220.63333333333333,30,0,1,668,WR,0
0,1,0,509,543,-34,-126,-114,-12,24.571428571428573,7,0,54,34,TE,1
0,1,0,1529,900,629,-145,-132,-13,262.25,24,0,2,635,TE,0
1,1,12,1104,-1461,2565,-180,-60,-120,336.5584415584416,77,1,2,2553,WR,0
1,1,42,739,976,-237,-157,-153,-4,119.52631578947368,19,0,250,4,WR,0
1,1,5,518,257,261,-122,-391,269,92.71428571428571,49,0,35,311,TE,0
1,1,42,223,-203,426,-512,-497,-15,145.74193548387098,31,1,5,448,RB,0
0,1,0,929,1040,-111,-174,-233,59,361.32142857142856,56,0,1060,947,WR,1
0,1,0,435,-677,1112,-225,-251,26,297.56756756756755,37,1,2,1119,TE,0
0,1,6,406,420,-14,-232,-220,-12,37.0,2,0,19,5,WR,1
1,1,0,513,483,30,-114,35,-149,59.75,20,0,45,88,TE,1
0,1,1,601,-538,1139,-199,-139,-60,291.2564102564103,39,1,4,1144,TE,0
0,1,0,438,-587,1025,-229,-241,12,282.18918918918916,37,1,2,1043,TE,0
0,1,0,839,-233,1072,-196,-316,120,499.22727272727275,22,1,6,1064,WR,0
0,1,24,1026,-5,1031,-105,-466,361,284.7073170731707,41,1,26,1070,TE,0
0,1,0,894,610,284,-232,-329,97,257.2307692307692,13,0,20,314,RB,0
1,1,86,446,-427,873,-101,-96,-5,229.65,40,1,14,902,TE,0
1,1,60,535,-562,1097,-189,-135,-54,192.98333333333332,60,1,20,1123,TE,0
0,1,0,941,67,874,-154,-245,91,375.48387096774195,62,0,738,1612,WR,1
1,1,52,1250,468,782,-161,-140,-21,213.4,40,0,38,825,TE,0
0,1,77,108,238,-130,-652,-481,-171,126.82352941176471,17,0,123,13,RB,0
0,1,0,415,-455,870,-190,-167,-23,169.18867924528303,53,1,56,904,TE,0
0,1,23,1203,-470,1673,-204,-228,24,293.36206896551727,58,1,23,1715,QB,0
0,1,105,864,-420,1284,-208,-229,21,339.89473684210526,38,1,2,1304,FB,0
0,1,32,575,-933,1508,-232,-70,-162,303.64150943396226,53,1,4,1514,WR,0
0,1,21,943,-498,1441,-215,-188,-27,354.219512195122,41,1,25,1465,RB,0
0,1,24,509,-448,957,-232,-152,-80,262.10526315789474,38,1,5,970,TE,0
0,1,0,987,-20,1007,-160,-296,136,472.27272727272725,22,1,18,1008,WR,0
0,1,0,947,-178,1125,-180,-261,81,475.6666666666667,24,1,4,1141,WR,0
0,1,35,1609,-1199,2808,-142,-66,-76,428.1666666666667,66,1,14,2840,WR,0
0,1,0,873,274,599,-96,-328,232,278.52,25,0,5,621,WR,0
0,1,18,1691,-1541,3232,-107,-104,-3,424.0131578947368,76,1,10,3220,WR,0
0,1,0,824,-471,1295,-215,-179,-36,329.5833333333333,48,1,144,1446,RB,0
0,1,30,620,-377,997,-233,-268,35,342.5,30,1,6,1003,FB,0
0,1,27,807,471,336,-222,-255,33,115.15151515151516,33,0,35,377,WR,0
0,1,49,32,218,-186,-789,-416,-373,119.35483870967742,31,0,247,31,RB,0
0,1,0,236,-571,807,-441,-45,-396,229.49122807017545,57,1,215,995,TE,1
1,1,69,676,282,394,-56,0,-56,108.0,35,0,26,397,TE,0
0,1,0,919,-288,1207,-189,-209,20,461.38461538461536,26,1,10,1210,WR,0
0,1,60,442,-245,687,-149,-374,225,243.5483870967742,31,1,10,711,TE,0
0,1,36,882,-378,1260,-231,-241,10,319.775,40,1,34,1288,FB,0
0,1,0,857,-136,993,-137,-314,177,405.2307692307692,26,1,6,1006,WR,0
0,1,33,894,-243,1137,-113,-382,269,302.675,40,1,10,1159,TE,0
0,1,24,456,-474,930,-242,-80,-162,245.84615384615384,39,1,7,943,TE,0
0,1,56,7,609,-602,-467,-207,-260,216.71875,32,0,632,25,TE,0
0,1,0,1232,538,694,-62,-314,252,288.8333333333333,30,0,39,731,WR,0
1,1,58,625,7,618,-200,-737,537,208.6153846153846,39,0,4,633,RB,0
0,1,8,1257,-10,1267,-179,-452,273,222.7704918032787,61,1,17,1272,TE,0
1,1,96,569,0,569,-149,-776,627,212.14634146341464,41,0,33,595,RB,0
0,1,28,1244,-456,1700,-163,-106,-57,232.54054054054055,74,1,7,1722,TE,0
0,1,14,1185,-1075,2260,-238,-201,-37,408.56363636363636,55,1,7,2263,WR,0
0,1,28,50,215,-165,-817,-496,-321,167.30434782608697,23,0,168,12,RB,0
0,1,0,502,280,222,-230,-236,6,289.8181818181818,33,0,363,587,TE,1
1,1,71,424,-425,849,-111,-107,-4,254.97222222222223,36,1,26,857,TE,0
1,1,63,545,-568,1113,-218,-183,-35,258.8181818181818,44,1,21,1108,TE,0
0,1,41,223,-489,712,-433,-125,-308,228.77777777777777,36,1,38,728,TE,0
0,1,60,905,-359,1264,-198,-242,44,308.8292682926829,41,1,25,1281,FB,0
0,1,0,803,217,586,-168,-337,169,375.3529411764706,17,0,6,608,TE,0
0,1,0,1101,148,953,-192,-527,335,451.0,23,0,7,973,WR,0
0,1,0,732,-477,1209,-271,-273,2,381.75,32,1,6,1207,QB,0
0,1,0,962,-542,1504,-164,-336,172,549.6428571428571,28,1,20,1511,WR,0
1,1,24,37,971,-934,-142,-204,62,280.6764705882353,34,0,934,3,QB,0
1,1,7,640,457,183,-61,-71,10,88.36363636363636,22,0,19,198,TE,0
1,1,27,566,-207,773,-282,-486,204,273.38709677419354,31,1,30,803,FB,0
0,1,17,229,2413,-2184,-503,-241,-262,396.2631578947368,57,0,2172,8,FB,0
0,1,0,926,-500,1426,-271,-246,-25,449.1875,32,1,4,1434,QB,0
0,1,0,609,-273,882,-130,-266,136,344.5,58,1,546,1436,WR,1
0,1,33,7,18,-11,-723,-766,43,98.21875,64,0,93,62,RB,1
0,1,0,874,749,125,-254,-251,-3,158.625,8,0,11,144,FB,0
0,1,20,10,3,7,-720,-747,27,93.48611111111111,72,0,90,59,RB,1
0,1,0,1317,846,471,-249,-222,-27,318.46666666666664,15,0,9,484,FB,0
0,1,0,589,-391,980,-201,-208,7,396.24,25,1,0,976,TE,0
0,1,13,225,-287,512,-534,-539,5,160.36363636363637,33,1,2,523,RB,0
0,1,22,21,19,2,-824,-803,-21,112.27160493827161,81,0,87,49,RB,1
0,1,30,916,1007,-91,-126,-127,1,100.5,16,0,146,19,TE,0
0,1,38,174,-209,383,-473,-476,3,116.6,55,1,50,477,RB,0
0,1,0,458,355,103,-215,-221,6,288.9166666666667,36,0,458,566,TE,1
1,1,36,823,1442,-619,-106,-100,-6,137.95652173913044,46,0,630,20,WR,0
1,1,20,1070,1910,-840,-84,-47,-37,199.25581395348837,43,0,870,23,WR,0
1,1,14,104,290,-186,-506,-514,8,61.903225806451616,31,0,219,21,RB,0
0,1,52,84,833,-749,-267,-4,-263,142.88888888888889,54,0,703,15,WR,0
0,1,37,259,486,-227,-406,-95,-311,159.60344827586206,58,0,539,259,TE,1
0,1,0,1253,694,559,-116,-98,-18,224.30769230769232,26,0,0,570,WR,0
0,1,0,421,-588,1009,-193,-61,-132,222.6595744680851,47,1,2,1023,TE,0
0,1,35,947,-380,1327,-168,-221,53,333.0,40,1,13,1345,FB,0
0,1,0,788,-171,959,-239,-329,90,434.1304347826087,23,1,10,966,WR,0
0,1,68,541,214,327,-143,-415,272,189.2608695652174,23,0,10,327,TE,0
0,1,0,817,-304,1121,-262,-288,26,438.46153846153845,26,1,14,1127,WR,0
0,1,54,7,-182,189,-746,-470,-276,143.8695652173913,23,1,38,224,RB,0
1,1,54,20,217,-197,-755,-461,-294,97.41176470588235,34,0,222,9,RB,0
0,1,10,245,-600,845,-422,-106,-316,216.7910447761194,67,1,235,1070,TE,1
1,1,0,622,315,307,-31,-49,18,103.68571428571428,35,0,56,342,TE,0
0,1,0,875,-356,1231,-216,-226,10,298.1190476190476,42,1,18,1260,FB,0
0,1,0,845,-360,1205,-132,-326,194,568.8181818181819,22,1,24,1222,WR,0
0,1,40,892,-444,1336,-199,-221,22,357.3157894736842,38,1,3,1354,FB,0
0,1,0,845,-390,1235,-146,-346,200,580.3636363636364,22,1,7,1229,WR,0
0,1,26,608,607,1,-175,-178,3,87.74358974358974,39,0,164,169,WR,1
1,1,45,1226,740,486,-299,-86,-213,100.16883116883118,77,0,75,573,RB,0
1,1,41,1203,1477,-274,-91,-129,38,69.94047619047619,84,0,414,151,WR,1
0,1,0,298,-266,564,-583,-636,53,248.04347826086956,23,1,1,558,RB,0
0,1,0,1544,-1343,2887,-293,-137,-156,387.1875,80,1,74,2952,RB,0
0,1,0,1075,95,980,-149,-624,475,388.86,50,0,459,1413,RB,1
0,1,6,482,-552,1034,-267,-21,-246,160.02702702702703,74,1,92,1155,TE,0
0,1,0,1862,967,895,-215,-278,63,387.625,24,0,38,908,WR,0
0,1,0,1141,-386,1527,-189,-251,62,439.0285714285714,35,1,2,1543,RB,0
0,1,0,940,207,733,-228,-241,13,360.3809523809524,21,0,16,748,RB,0
1,1,0,926,1363,-437,-168,-115,-53,113.925,40,0,472,42,WR,0
1,1,1,1536,207,1329,-213,-456,243,240.53333333333333,60,0,68,1403,RB,0
0,1,0,978,426,552,-206,-179,-27,160.1818181818182,33,0,26,568,WR,0
0,1,0,261,-304,565,-630,-580,-50,130.94230769230768,52,1,17,585,RB,0
0,1,3,1606,-249,1855,-282,-420,138,347.94642857142856,56,1,8,1869,RB,0
0,1,1,185,188,-3,-480,-369,-111,24.0,1,0,4,12,RB,1
0,1,0,460,-530,990,-228,-235,7,236.02380952380952,42,1,24,989,TE,0
0,1,0,325,-544,869,-277,-68,-209,221.37209302325581,43,1,56,896,TE,0
0,1,12,851,-1369,2220,-264,-177,-87,422.66037735849056,53,1,67,2259,RB,0
0,1,5,1228,242,986,-256,-460,204,206.26,50,0,23,1020,RB,0
0,1,3,814,-976,1790,-242,-141,-101,360.52941176470586,51,1,26,1797,WR,0
0,1,0,488,539,-51,-241,-244,3,52.15909090909091,44,0,196,145,TE,1
0,1,5,195,-234,429,-538,-313,-225,166.03125,32,1,51,468,RB,0
0,1,1,665,-245,910,-98,-477,379,158.46835443037975,79,1,97,1016,TE,0
0,1,54,1031,-940,1971,-158,-174,16,502.1,40,1,10,2002,WR,0
1,1,0,2224,2204,20,-173,-67,-106,33.5,8,0,19,42,TE,1
1,1,11,1221,1202,19,-115,-10,-105,9.2,5,0,11,34,TE,1
1,1,0,1632,1644,-12,-162,-52,-110,6.0,2,0,26,10,RB,1
0,1,59,421,532,-111,-210,-154,-56,80.80645161290323,31,0,197,99,TE,1
0,1,0,1223,-88,1311,-180,-737,557,340.6179775280899,89,1,760,2088,RB,1
0,1,33,532,550,-18,-111,-99,-12,65.64102564102564,39,0,189,164,TE,1
0,1,0,552,-503,1055,12,-32,44,226.58,50,1,19,1091,TE,0
0,1,0,289,-322,611,-610,-536,-74,194.9375,32,1,8,636,RB,0
0,1,0,1511,667,844,-202,-191,-11,217.10526315789474,38,0,1,844,TE,0
0,1,0,259,-344,603,-615,-562,-53,163.19444444444446,36,1,26,622,RB,0
0,1,1,544,519,25,-142,-65,-77,28.35,20,0,35,32,TE,1
0,1,0,547,-275,822,-260,-536,276,226.0,43,1,5,856,TE,0
0,1,0,119,541,-422,-282,-179,-103,155.27027027027026,37,0,447,39,RB,0
0,1,19,37,526,-489,-269,-33,-236,188.93333333333334,30,0,528,30,TE,0
0,1,0,1758,893,865,-136,-243,107,434.35,20,0,2,871,RB,0
0,1,0,473,162,311,-237,-236,-1,266.0,78,0,896,1208,TE,1
0,1,0,762,579,183,-282,-269,-13,112.14285714285714,28,0,52,233,TE,1
0,1,1,482,-562,1044,-212,-134,-78,222.44897959183675,49,1,38,1082,TE,0
0,1,0,311,-1246,1557,-240,-172,-68,301.5263157894737,57,1,50,1619,WR,0
0,1,1,12,-14,26,-412,-300,-112,121.0,7,0,0,23,RB,0
0,1,18,832,-1097,1929,-201,-149,-52,381.54901960784315,51,1,2,1963,WR,0
0,1,0,1218,822,396,-89,-291,202,245.1904761904762,63,0,513,922,WR,1
0,1,69,168,517,-349,-362,-112,-250,188.88,25,0,357,27,TE,0
0,1,13,1885,503,1382,-191,-195,4,273.3,50,0,4,1365,TE,0
0,1,0,542,525,17,-202,74,-276,41.857142857142854,7,0,8,25,TE,1
0,1,21,466,-680,1146,-285,-137,-148,186.43548387096774,62,1,13,1129,TE,0
0,1,11,924,-1275,2199,-230,-187,-43,454.57142857142856,49,1,7,2185,RB,0
1,1,3,978,1402,-424,-123,-89,-34,94.43181818181819,44,0,455,18,WR,0
1,1,10,1560,235,1325,-155,-415,260,257.037037037037,54,0,18,1323,RB,0
0,1,0,553,551,2,-248,-283,35,53.23809523809524,21,0,50,43,TE,1
0,1,3,167,805,-638,-324,-144,-180,187.10256410256412,39,0,678,13,TE,0
0,1,1,572,-667,1239,-231,-157,-74,233.83018867924528,53,1,0,1236,TE,0
0,1,0,1290,-407,1697,-205,-290,85,450.02564102564105,39,1,36,1749,RB,0
0,1,0,927,952,-25,-104,-119,15,40.86363636363637,22,0,50,38,WR,1
0,1,0,653,-440,1093,-194,-217,23,208.3793103448276,58,1,63,1153,TE,0
0,1,0,685,-964,1649,-291,-177,-114,325.27450980392155,51,1,19,1665,WR,0
0,1,0,502,486,16,-131,-110,-21,28.0,18,0,64,87,TE,1
0,1,0,1445,-293,1738,-249,-480,231,282.6969696969697,66,1,109,1862,RB,0
0,1,0,1545,1564,-19,-131,-120,-11,55.875,24,0,58,67,WR,1
0,1,10,142,946,-804,238,221,17,266.375,32,0,832,8,WR,0
0,1,0,1508,1493,15,-186,-108,-78,63.8,10,0,29,31,WR,1
0,1,0,294,-258,552,-592,-597,5,125.57692307692308,52,1,84,643,RB,0
0,1,12,724,-1040,1764,-274,243,-517,370.93617021276594,47,1,6,1742,WR,0
0,1,16,249,-219,468,-569,-453,-116,192.13793103448276,29,1,22,491,RB,0
0,1,0,1013,-667,1680,-201,-217,16,343.8775510204082,49,1,4,1689,WR,0
0,1,6,1907,857,1050,-287,-235,-52,268.1025641025641,39,0,1,1046,WR,0
1,1,26,473,543,-70,-35,-55,20,66.48148148148148,54,0,220,109,TE,1
1,1,0,597,-658,1255,-126,-87,-39,211.16438356164383,73,1,55,1345,TE,0
0,1,0,1237,1232,5,-91,-81,-10,67.11111111111111,54,0,239,244,WR,1
0,1,0,101,-506,607,-250,-35,-215,215.87878787878788,33,1,16,631,TE,0
1,1,26,913,-1253,2166,-196,-142,-54,435.74,50,1,40,2203,WR,0
0,1,0,1266,384,882,-168,-129,-39,238.3846153846154,39,0,5,910,TE,0
0,1,1,417,-502,919,-284,-155,-129,228.87179487179486,39,1,43,907,TE,0
0,1,0,986,324,662,-240,-239,-1,376.2352941176471,17,0,20,632,RB,0
0,1,9,577,-517,1094,-184,-153,-31,292.64102564102564,39,1,13,1099,TE,0
0,1,59,345,1888,-1543,-453,-154,-299,321.01960784313724,51,0,1537,10,WR,0
0,1,3,451,525,-74,-120,-45,-75,66.72,25,0,143,68,TE,1
0,1,0,466,-588,1054,-170,-131,-39,201.26666666666668,60,1,59,1115,TE,0
0,1,0,603,578,25,-172,-29,-143,49.166666666666664,30,0,95,129,TE,1
0,1,11,797,-963,1760,-219,-166,-53,337.3018867924528,53,1,24,1781,WR,0
0,1,0,488,499,-11,-101,-69,-32,50.758620689655174,29,0,55,53,TE,1
0,1,0,95,-310,405,-269,-595,326,120.98214285714286,56,1,32,436,RB,0
0,1,3,263,269,-6,-523,-424,-99,57.94117647058823,17,0,59,55,RB,1
0,1,0,1575,893,682,-201,-166,-35,180.3783783783784,37,0,0,679,WR,0
0,1,0,481,519,-38,-101,-52,-49,24.8,10,0,65,26,TE,1
0,1,3,2115,2103,12,-110,-151,41,54.5,14,0,22,22,WR,1
0,1,0,384,388,-4,-610,-578,-32,59.30434782608695,23,0,34,17,RB,1
0,1,0,469,444,25,-227,-211,-16,244.58536585365854,41,0,490,529,TE,1
0,1,0,993,-712,1705,-196,-245,49,350.68,50,1,43,1732,WR,0
0,1,0,1013,-285,1298,-211,-346,135,321.73333333333335,60,1,305,1630,WR,1
0,1,8,677,-451,1128,250,91,159,301.72972972972974,37,1,6,1115,TE,0
0,1,4,37,554,-517,-486,-171,-315,237.53846153846155,26,0,540,0,FB,0
0,1,0,882,-262,1144,391,453,-62,371.5806451612903,62,1,565,1723,WR,1
0,1,8,582,160,422,-238,-359,121,136.40625,32,0,26,436,RB,0
0,1,32,1731,824,907,-167,-71,-96,246.56756756756758,37,0,16,927,WR,0
0,1,0,323,-438,761,-252,-132,-120,276.62068965517244,29,1,13,781,TE,0
0,1,0,410,-495,905,-77,-151,74,199.71698113207546,53,1,17,931,TE,0
0,1,54,846,17,829,-211,-851,640,258.3658536585366,41,0,4,845,WR,0
0,1,0,658,-822,1480,-222,-134,-88,308.88,50,1,13,1515,WR,0
0,1,0,424,-583,1007,-125,-200,75,231.2340425531915,47,1,17,1028,TE,0
0,1,0,2,35,-33,-500,-489,-11,151.0,3,0,48,24,FB,1
0,1,30,1911,911,1000,-230,-118,-112,241.8048780487805,41,0,3,985,TE,0
0,1,0,885,-11,896,-219,-433,214,305.8301886792453,53,1,296,1224,FB,1
0,1,16,879,-284,1163,-189,-301,112,330.8974358974359,39,1,22,1196,FB,0
0,1,17,225,-696,921,-463,-55,-408,249.925,40,1,4,943,WR,0
0,1,0,675,-810,1485,-206,-149,-57,328.0851063829787,47,1,15,1518,WR,0
0,1,0,1046,742,304,-205,-159,-46,214.14285714285714,14,0,0,304,WR,0
0,1,35,1269,-839,2108,-189,-161,-28,406.34615384615387,52,1,12,2116,WR,0
0,1,0,454,-393,847,-126,-149,23,196.12,50,1,27,903,TE,0
0,1,0,1048,-414,1462,-183,-188,5,338.52272727272725,44,1,9,1497,TE,0
0,1,0,233,-191,424,-554,-576,22,231.47368421052633,19,1,15,449,RB,0
0,1,0,913,668,245,-136,-344,208,271.5,12,0,5,242,WR,0
0,1,0,457,-873,1330,-215,-129,-86,348.2631578947368,38,1,0,1321,TE,0
0,1,0,938,-268,1206,-214,-310,96,314.4782608695652,46,1,90,1276,FB,0
0,1,0,874,-469,1343,-234,-227,-7,332.6666666666667,42,1,25,1398,FB,0
0,1,0,468,6,462,-193,-479,286,235.44,25,0,22,511,TE,0
0,1,5,207,-2223,2430,-499,-25,-474,441.44642857142856,56,1,3,2432,RB,0
0,1,0,5,816,-811,-277,-48,-229,289.37931034482756,29,0,807,0,TE,0
0,1,0,604,555,49,-154,-110,-44,22.5,8,0,21,62,TE,1
0,1,0,446,-661,1107,-120,-147,27,234.50980392156862,51,1,2,1107,TE,0
0,1,9,1274,1310,-36,-156,-51,-105,161.90425531914894,94,0,733,706,WR,1
0,1,43,538,792,-254,-282,-77,-205,127.04081632653062,49,0,414,145,WR,1
1,1,0,1181,414,767,-344,-225,-119,145.30357142857142,56,0,24,778,TE,0
0,1,24,653,707,-54,-209,-131,-78,161.84313725490196,51,0,441,398,WR,1
0,1,47,164,-11,175,-560,-698,138,93.76923076923077,39,1,62,219,RB,1
0,1,0,1098,394,704,-211,-86,-125,202.97142857142856,35,0,0,714,WR,0
0,1,0,847,289,558,-201,-401,200,211.0344827586207,29,0,14,555,WR,0
0,1,46,521,-510,1031,-222,-96,-126,245.9268292682927,41,1,18,1026,TE,0
0,1,0,664,-422,1086,-257,-211,-46,283.8695652173913,46,1,96,1186,WR,0
0,1,0,920,-11,931,-274,-526,252,302.39285714285717,56,1,346,1271,FB,1
0,1,0,469,-452,921,-105,-46,-59,187.2982456140351,57,1,51,942,TE,0
0,1,0,874,832,42,-155,25,-180,55.06666666666667,15,0,38,46,WR,1
0,1,0,1071,-932,2003,-251,-140,-111,548.9459459459459,37,1,0,2002,WR,0
0,1,0,20,14,6,-769,-717,-52,52.520833333333336,48,0,67,63,RB,1
0,1,0,433,-439,872,-88,-6,-82,200.0,53,1,42,927,TE,0
1,1,0,581,-511,1092,-185,-70,-115,231.07692307692307,52,1,43,1143,TE,0
0,1,0,976,529,447,-201,-175,-26,344.85714285714283,14,0,2,467,WR,0
0,1,4,531,-696,1227,-202,-114,-88,275.3777777777778,45,1,0,1230,TE,0
0,1,3,798,-497,1295,-188,-121,-67,287.1111111111111,45,1,2,1290,TE,0
0,1,0,109,264,-155,-308,-338,30,372.0,48,0,940,797,WR,1
0,1,0,1049,483,566,-196,-193,-3,145.17948717948718,39,0,9,583,WR,0
0,1,0,476,444,32,-129,-103,-26,44.13333333333333,15,0,25,46,TE,1
0,1,0,702,-464,1166,-229,-210,-19,225.3846153846154,52,1,6,1172,TE,0
0,1,9,720,-468,1188,-225,-136,-89,255.1086956521739,46,1,11,1180,TE,0
0,1,0,432,480,-48,-99,-2,-97,58.666666666666664,18,0,73,32,TE,1
0,1,0,249,-453,702,-249,-171,-78,281.48148148148147,27,1,38,728,TE,0
1,1,0,1241,647,594,-222,-196,-26,256.2173913043478,23,0,0,584,WR,0
1,1,0,16,49,-33,-687,-745,58,81.46153846153847,13,0,64,42,RB,1
0,1,11,467,-467,934,-248,-182,-66,327.8,30,1,4,940,TE,0
1,1,23,1272,162,1110,-168,-377,209,249.17391304347825,46,0,21,1099,RB,0
1,1,36,944,1375,-431,-30,72,-102,167.2962962962963,27,0,483,10,WR,0
0,1,8,530,-656,1186,-228,-87,-141,324.5263157894737,38,1,0,1191,TE,0
0,1,0,890,-447,1337,-195,-132,-63,378.1111111111111,36,1,22,1336,TE,0
0,1,0,456,-464,920,-239,-59,-180,289.8181818181818,33,1,10,941,TE,0
0,1,17,1991,1317,674,-217,-42,-175,207.0,33,0,6,679,WR,0
0,1,0,717,-417,1134,-177,-142,-35,278.6829268292683,41,1,23,1170,TE,0
0,1,0,683,-282,965,-262,-200,-62,405.28,25,1,37,994,WR,0
0,1,0,959,27,932,-196,-254,58,429.27272727272725,22,0,11,947,WR,0
0,1,0,530,-402,932,-225,-82,-143,235.85365853658536,41,1,33,945,TE,0
0,1,0,266,-219,485,-514,-589,75,344.0,16,1,2,524,RB,0
0,1,1,973,-220,1193,-136,-418,282,299.14,50,1,80,1303,WR,0
0,1,0,1029,815,214,-262,-429,167,153.8,20,0,2,209,FB,0
0,1,6,175,252,-77,-321,-489,168,169.11428571428573,35,0,257,200,TE,1
0,1,0,979,553,426,282,68,214,329.6029411764706,68,0,882,1325,WR,1
0,1,2,287,564,-277,-16,153,-169,331.8666666666667,45,0,847,576,WR,1
0,1,0,488,-562,1050,-210,-100,-110,348.375,32,1,0,1070,TE,0
0,1,42,279,465,-186,-239,-150,-89,180.0909090909091,11,0,185,11,TE,0
0,1,0,874,345,529,-217,-329,112,357.4375,16,0,11,552,WR,0
0,1,91,498,15,483,-206,-479,273,237.23076923076923,52,0,338,843,TE,1
0,1,0,440,-378,818,-258,-303,45,268.3125,32,1,24,839,TE,0
0,1,0,416,-535,951,-200,-163,-37,304.96875,32,1,17,979,TE,0
0,1,16,271,641,-370,-502,-112,-390,166.86206896551724,29,0,370,2,RB,0
0,1,0,1132,587,545,-158,-210,52,382.3333333333333,15,0,6,558,WR,0
0,1,8,495,-583,1078,-229,-96,-133,260.51162790697674,43,1,27,1107,TE,0
0,1,0,1079,-106,1185,-180,-309,129,530.695652173913,23,1,11,1192,WR,0
0,1,18,1143,-324,1467,-176,-543,367,337.7111111111111,45,1,7,1478,WR,0
0,1,46,769,629,140,-74,-69,-5,82.96296296296296,27,0,35,133,WR,1
0,1,0,1354,-129,1483,-135,-283,148,342.0,44,1,22,1478,WR,0
0,1,54,497,-498,995,-205,-201,-4,268.8421052631579,38,1,17,1037,TE,0
0,1,13,424,-436,860,-238,-184,-54,223.16216216216216,37,1,2,852,TE,0
0,1,0,435,334,101,-194,-184,-10,239.05,40,0,436,536,TE,1
0,1,0,1877,-142,2019,-130,-281,151,350.79661016949154,59,1,2,2033,WR,0
0,1,26,863,-945,1808,-236,-121,-115,346.25,52,1,11,1807,WR,0
0,1,0,335,-445,780,-176,-100,-76,256.7647058823529,34,1,7,799,TE,0
1,1,33,1256,689,567,-81,-69,-12,153.51351351351352,37,0,12,572,WR,0
0,1,0,1098,-377,1475,-161,-246,85,301.8360655737705,61,1,166,1643,WR,0
0,1,18,856,-1110,1966,-176,-175,-1,331.22033898305085,59,1,2,1976,WR,0
0,1,0,475,272,203,-210,-205,-5,259.44117647058823,34,0,347,554,TE,1
0,1,0,426,-458,884,-227,-145,-82,327.89285714285717,28,1,15,898,TE,0
0,1,41,493,-481,974,-193,-107,-86,281.74285714285713,35,1,18,990,TE,0
0,1,0,247,-163,410,-519,-594,75,359.9166666666667,12,1,5,414,RB,0
0,1,0,776,288,488,-172,-301,129,316.81159420289856,69,0,842,1322,WR,1
0,1,63,51,379,-328,-280,-266,-14,197.89473684210526,19,0,368,20,TE,0
0,1,33,1292,1260,32,-33,-53,20,98.76315789473684,38,0,186,208,WR,1
0,1,20,644,378,266,-279,-217,-62,143.78947368421052,19,0,0,262,TE,0
0,1,0,269,-265,534,-485,-390,-95,169.41666666666666,36,1,56,562,RB,0
0,1,1,519,-431,950,-171,-53,-118,216.44285714285715,70,1,318,1234,TE,1
0,1,0,265,468,-203,-265,-183,-82,286.0,42,0,703,493,TE,1
0,1,0,268,-412,680,-178,-89,-89,152.4,55,1,46,739,TE,0
0,1,34,214,-186,400,-478,-417,-61,134.9375,32,1,6,413,RB,0
1,1,25,1113,-1011,2124,-153,-159,6,360.3220338983051,59,1,2,2133,WR,0
1,1,13,619,-536,1155,-168,-148,-20,297.2894736842105,38,1,13,1172,TE,0
0,1,38,3184,-236,3420,-1408,-487,-921,323.9318181818182,88,1,17,3448,RB,0
0,1,11,843,-952,1795,-221,-165,-56,365.85714285714283,49,1,5,1790,WR,0
0,1,0,1068,-68,1136,-201,-297,96,479.25,24,1,2,1152,WR,0
1,1,47,6,-214,220,-761,-505,-256,80.2741935483871,62,1,28,221,RB,0
0,1,45,1276,1235,41,-88,-112,24,107.84057971014492,69,0,334,353,WR,1
0,1,23,475,-481,956,-163,-137,-26,265.94594594594594,37,1,11,974,TE,0
0,1,0,597,358,239,-230,-227,-3,344.98387096774195,62,0,940,1189,WR,1
0,1,18,477,-521,998,-161,-170,9,239.21428571428572,42,1,19,1029,TE,0
0,1,0,228,-1474,1702,-258,-35,-223,435.6,40,1,4,1706,WR,0
1,1,14,13,-165,178,-664,-424,-240,114.11111111111111,27,1,6,185,RB,0
1,1,0,509,-471,980,-82,-93,11,169.4927536231884,69,1,70,1038,TE,0
0,1,15,1056,-142,1198,-262,-340,78,250.42,50,1,7,1197,RB,0
0,1,51,1588,-198,1786,-186,-463,277,340.3888888888889,54,1,6,1796,FB,0
0,1,0,1173,439,734,-196,-258,62,382.0,20,0,24,751,WR,0
0,1,0,187,-251,438,-491,-543,52,259.63157894736844,19,1,42,489,RB,0
0,1,0,207,-219,426,-463,-452,-11,187.5,24,1,3,418,RB,0
0,1,6,222,-909,1131,-506,-210,-296,248.08695652173913,46,1,0,1099,RB,0
0,1,44,133,292,-159,-641,-497,-144,99.0,22,0,193,26,RB,0
0,1,13,250,-262,512,-512,-499,-13,194.3846153846154,26,1,25,515,RB,0
0,1,2,533,189,344,-166,-472,306,121.8,45,0,57,391,RB,0
0,1,0,593,344,249,-202,-252,50,358.3965517241379,58,0,888,1137,WR,1
0,1,52,207,-169,376,-458,-425,-33,135.3548387096774,31,1,23,393,RB,0
0,1,27,431,-552,983,-177,-180,3,281.14285714285717,35,1,4,998,TE,0
0,1,0,275,-581,856,-224,-91,-133,251.17142857142858,35,1,18,877,TE,0
0,1,26,783,-1334,2117,-193,-125,-68,432.1224489795918,49,1,5,2124,WR,0
0,1,0,949,487,462,-143,-224,81,376.0769230769231,13,0,3,467,WR,0
0,1,26,181,-518,699,-263,-114,-149,285.18518518518516,27,1,13,730,TE,0
0,1,5,1148,1104,44,-189,-150,-39,258.96491228070175,57,0,718,758,WR,1
0,1,0,484,-569,1053,-190,-124,-66,246.8139534883721,43,1,4,1070,TE,0
1,1,23,234,251,-17,-507,-503,-4,43.6,10,0,37,41,RB,1
1,1,78,160,483,-323,-236,-146,-90,191.57894736842104,19,0,336,25,TE,0
0,1,62,658,617,41,-181,-193,12,65.74528301886792,212,0,632,611,TE,1
0,1,0,864,-84,948,-219,-298,79,373.6923076923077,26,1,8,949,WR,0
0,1,6,690,-1147,1837,-261,-164,-97,363.4230769230769,52,1,2,1841,WR,0
1,1,28,497,615,-118,-203,-162,-41,73.375,16,0,143,39,TE,1
1,1,22,565,-484,1049,-179,-166,-13,302.8285714285714,35,1,19,1055,TE,0
0,1,3,1430,660,770,-178,-169,-9,216.02777777777777,36,0,9,783,TE,0
0,1,10,738,373,365,-240,-278,38,96.6470588235294,34,0,0,360,WR,0
0,1,0,520,117,403,-227,-261,34,255.5483870967742,31,0,196,597,TE,1
0,1,9,542,-456,998,-201,-286,85,263.27027027027026,37,1,2,1004,TE,0
0,1,51,243,210,33,-605,-543,-62,88.45,80,0,166,210,RB,1
1,1,19,833,811,22,-68,-73,5,121.89583333333333,48,0,284,299,WR,1
0,1,21,260,225,35,-512,-461,-51,121.39655172413794,58,0,182,194,RB,1
0,1,37,773,744,29,-150,-141,-9,98.20454545454545,44,0,203,217,WR,1
1,1,19,1423,889,534,-96,-74,-22,201.07692307692307,26,0,4,543,TE,0
0,1,13,234,187,47,-585,-559,-26,121.47619047619048,63,0,129,186,RB,1
0,1,39,465,-490,955,-203,-145,-58,266.52777777777777,36,1,15,957,TE,0
0,1,0,1028,821,207,-191,-239,48,107.13636363636364,22,0,3,205,WR,0
0,1,0,242,-86,328,-564,-616,52,237.73333333333332,15,1,3,332,RB,0
0,1,0,343,-924,1267,-309,-334,25,364.30357142857144,56,1,341,1611,WR,1
0,1,0,1288,307,981,-191,-227,36,192.7843137254902,51,0,10,996,TE,0
1,1,30,1848,490,1358,-163,-169,6,336.0243902439024,41,0,19,1375,TE,0
0,1,0,1332,848,484,-235,-182,-53,137.97142857142856,35,0,0,482,WR,0
0,1,9,255,1184,-929,-289,-177,-112,316.0,31,0,937,6,WR,0
0,1,30,12,6,6,-753,-630,-123,97.76363636363637,55,0,49,42,RB,1
0,1,5,18,-186,204,-707,-486,-221,82.5204081632653,98,1,88,255,RB,1
0,1,0,275,-604,879,-501,-676,175,402.95454545454544,22,1,7,873,RB,0
1,1,36,18,770,-752,-461,-99,-362,224.02631578947367,38,0,769,2,TE,0
0,1,0,6,-80,86,-764,-588,-176,133.02380952380952,42,0,227,301,RB,1
1,1,32,472,-508,980,-136,-147,11,238.97674418604652,43,1,9,977,TE,0
0,1,14,1,577,-576,-478,-212,-266,207.9655172413793,29,0,580,16,TE,0
0,1,22,92,2017,-1925,-510,-91,-419,350.82142857142856,56,0,1948,11,RB,0
0,1,8,1178,-1589,2767,-203,-124,-79,388.8901098901099,91,1,408,3164,WR,0
1,1,5,439,932,-493,-117,-66,-51,99.58823529411765,51,0,542,33,TE,0
0,1,0,206,-220,426,-555,-466,-89,111.88372093023256,43,1,26,475,RB,0
0,1,0,1773,1502,271,-158,-128,-30,234.07692307692307,13,0,20,297,WR,0
0,1,0,833,200,633,-256,-379,123,383.29411764705884,17,0,6,637,WR,0
0,1,0,692,-438,1130,-252,-199,-53,289.6,40,1,22,1156,TE,0
0,1,0,590,48,542,-178,-507,329,260.7037037037037,27,0,49,586,TE,0
1,1,0,753,737,16,-163,81,-244,36.0,1,0,11,2,WR,1
0,1,0,577,-531,1108,-227,8,-235,241.33333333333334,45,1,14,1096,TE,0
0,1,32,819,365,454,-211,-305,94,103.08928571428571,56,0,35,505,WR,0
0,1,0,1101,417,684,-222,-216,-6,255.89285714285714,28,0,0,693,WR,0
0,1,33,386,-457,843,-264,-205,-59,241.38888888888889,36,1,22,842,TE,0
0,1,37,426,-490,916,-194,-195,1,214.17777777777778,45,1,63,957,TE,0
0,1,9,204,-154,358,-496,-571,75,117.13888888888889,36,1,32,405,RB,0
0,1,94,776,-1168,1944,-258,-205,-53,320.0983606557377,61,1,4,1958,WR,0
0,1,62,424,-438,862,-202,-165,-37,235.92307692307693,39,1,9,888,TE,0
0,1,0,244,300,-56,-477,-292,-185,73.25,4,0,38,0,RB,0
0,1,29,471,-438,909,-228,-193,-35,250.8918918918919,37,1,12,936,TE,0
0,1,0,540,959,-419,-222,-136,-86,209.7391304347826,23,0,437,1,WR,0
0,1,11,585,-928,1513,-242,-163,-79,274.8103448275862,58,1,48,1550,WR,0
0,1,0,873,-461,1334,-233,-239,6,296.5869565217391,46,1,14,1347,TE,0
0,1,20,275,-830,1105,-268,-194,-74,307.64864864864865,37,1,7,1109,WR,0
0,1,0,201,249,-48,-449,-314,-135,232.35135135135135,37,0,416,367,TE,1
0,1,0,665,-300,965,-206,-264,58,472.95238095238096,21,1,16,983,WR,0
0,1,15,258,-235,493,-549,-563,14,190.03703703703704,27,1,19,514,RB,0
0,1,85,222,235,-13,-534,-531,-3,73.01030927835052,97,0,305,253,RB,1
0,1,87,1540,1446,94,-158,-203,45,94.81981981981981,111,0,416,499,WR,1
0,1,81,1055,1070,-15,-90,-102,12,89.90434782608696,115,0,474,490,WR,1
0,1,86,1883,1826,57,-75,-62,-13,151.32867132867133,143,0,1002,1090,WR,1
0,1,0,184,420,-236,-286,-134,-152,156.04761904761904,21,0,290,22,TE,0
0,1,0,1390,684,706,-229,-172,-57,179.175,40,0,3,704,WR,0
0,1,0,601,218,383,-200,-264,64,345.6666666666667,12,0,4,396,WR,0
0,1,0,608,116,492,-232,-257,25,228.9787234042553,47,0,274,757,TE,1
0,1,0,723,-624,1347,-253,-239,-14,366.3243243243243,37,1,8,1358,WR,0
0,1,8,796,-459,1255,-262,-220,-42,260.61224489795916,49,1,20,1263,TE,0
1,1,50,963,971,-8,-156,-158,2,34.0,1,0,8,4,WR,1
0,1,0,755,-819,1574,-211,-210,-1,352.1304347826087,46,1,0,1569,WR,0
0,1,0,566,240,326,-218,-190,-28,274.0833333333333,12,0,2,326,WR,0
0,1,0,1163,409,754,-183,-193,10,176.73809523809524,42,0,2,750,WR,0
0,1,0,1139,-1549,2688,-169,-168,-1,424.2142857142857,84,1,425,3129,WR,0
1,1,108,420,979,-559,-103,-72,-31,160.38235294117646,34,0,557,17,TE,0
0,1,0,532,536,-4,-72,-54,-18,121.0,2,0,2,19,TE,0
0,1,48,1210,2156,-946,-341,-161,-180,293.2121212121212,33,0,932,8,RB,0
0,1,2,710,-895,1605,-196,-226,30,310.4423076923077,52,1,7,1612,WR,0
0,1,0,729,-416,1145,-208,-239,31,298.9736842105263,38,1,13,1147,TE,0
0,1,1,728,-418,1146,-191,-244,53,200.21052631578948,57,1,9,1147,TE,0
1,1,0,610,-16,626,-246,-199,-47,207.3684210526316,38,1,64,695,TE,0
0,1,30,1207,428,779,-237,-196,-41,247.96774193548387,31,0,16,788,TE,0
0,1,0,1228,589,639,-212,-332,120,401.125,16,0,2,633,WR,0
0,1,16,34,256,-222,-842,-546,-296,90.51162790697674,43,0,247,30,RB,0
0,1,9,948,-2026,2974,-238,-213,-25,426.48571428571427,70,1,2,2974,WR,0
0,1,67,15,-295,310,-753,-480,-273,143.6206896551724,29,1,16,326,RB,0
0,1,17,567,-409,976,-208,-253,45,285.05882352941177,34,1,19,983,TE,0
0,1,0,751,-572,1323,-204,-308,104,351.9019607843137,51,1,208,1530,WR,0
0,1,0,954,489,465,-259,-293,34,385.0833333333333,12,0,13,473,RB,0
0,1,0,565,-433,998,-232,-191,-41,275.1666666666667,36,1,12,1006,TE,0
0,1,81,40,507,-467,-267,-276,9,243.0952380952381,21,0,484,14,TE,0
1,1,13,204,250,-46,-479,-529,50,177.1764705882353,51,0,202,164,RB,1
1,1,33,1399,477,922,-173,-235,62,284.24242424242425,33,0,17,932,TE,0
0,1,29,340,-423,763,-247,-128,-119,266.53333333333336,30,1,4,773,TE,0
0,1,0,717,80,637,-225,-257,32,328.6,20,0,10,639,WR,0
0,1,0,1011,6,1005,-268,-281,13,522.578947368421,19,0,2,999,WR,0
0,1,0,293,57,236,-532,-526,-6,238.8,10,0,2,236,FB,0
0,1,0,728,-218,946,-288,-312,24,398.4583333333333,24,1,13,955,WR,0
0,1,0,1254,623,631,-245,-348,103,377.8235294117647,17,0,6,621,WR,0
0,1,24,448,-384,832,-225,-123,-102,228.45945945945945,37,1,2,841,TE,0
0,1,0,749,400,349,-196,-272,76,349.72727272727275,11,0,9,356,WR,0
0,1,2,419,382,37,-271,-258,-13,125.83333333333333,18,0,83,120,TE,1
0,1,30,623,-371,994,-238,-260,22,254.76923076923077,39,1,8,1005,TE,0
0,1,43,878,204,674,-222,-576,354,219.63888888888889,36,0,21,685,RB,0
0,1,22,1540,220,1320,-133,-576,443,202.62637362637363,91,0,128,1462,RB,0
0,1,5,252,-221,473,-551,-512,-39,163.5064935064935,77,1,171,648,RB,1
1,1,20,998,1174,-176,-157,-166,9,130.31034482758622,29,0,290,102,WR,1
1,1,25,987,803,184,-57,-46,-11,138.14285714285714,14,0,10,211,WR,0
0,1,26,1438,302,1136,-279,-519,240,264.59090909090907,44,0,11,1143,RB,0
0,1,19,13,445,-432,-290,-243,-47,221.25,20,0,439,15,TE,0
0,1,13,26,-603,629,-289,-271,-18,219.02857142857144,35,1,57,691,WR,0
0,1,0,1179,704,475,-229,-286,57,368.7692307692308,13,0,3,468,WR,0
0,1,17,538,712,-174,-61,-66,5,111.85714285714286,14,0,186,2,TE,0
0,1,0,1443,1238,205,-233,-214,-19,232.44444444444446,9,0,4,202,WR,0
0,1,16,523,-391,914,-275,-222,-53,278.06060606060606,33,1,15,925,TE,0
0,1,0,867,596,271,-217,-269,52,115.82608695652173,23,0,1,265,WR,0
0,1,11,1374,-583,1957,-55,-94,39,277.05479452054794,73,1,21,1981,TE,0
0,1,10,417,-1745,2162,-265,-218,-47,455.6666666666667,48,1,2,2173,TE,0
1,1,0,34,590,-556,-473,-180,-293,234.78571428571428,28,0,578,29,TE,0
0,1,2,631,-418,1049,-251,-270,19,246.22222222222223,45,1,42,1099,TE,0
0,1,0,1194,590,604,-270,-242,-28,207.85714285714286,49,0,203,801,WR,1
0,1,0,1061,-41,1102,-389,-356,-33,485.69565217391306,23,1,2,1102,WR,0
0,1,46,178,204,-26,-549,-519,-30,27.0,1,0,32,11,RB,1
1,1,46,16,1729,-1713,-705,-238,-467,339.60377358490564,53,0,1716,8,RB,0
1,1,71,415,723,-308,-107,-163,56,107.20689655172414,29,0,334,15,TE,0
1,1,47,545,2100,-1555,-179,-226,47,317.44897959183675,49,0,1572,19,TE,0
0,1,7,1156,897,259,-190,-178,-12,192.0,37,0,224,489,WR,1
0,1,31,8,-1278,1286,-283,-185,-98,319.8292682926829,41,1,6,1284,WR,0
0,1,16,497,-512,1009,-307,-188,-119,230.36363636363637,44,1,15,1016,TE,0
0,1,36,121,-497,618,-141,39,-180,281.90909090909093,22,1,11,603,TE,0
0,1,6,695,478,217,-243,-270,27,191.76470588235293,34,0,225,440,TE,1
0,1,1,508,-400,908,-187,-189,2,227.8780487804878,41,1,22,938,TE,0
0,1,0,887,-375,1262,-306,-337,31,472.5925925925926,27,1,19,1272,WR,0
0,1,29,261,249,12,-546,-513,-33,88.8529411764706,34,0,146,151,RB,1
1,1,0,1150,1934,-784,-227,-174,-53,213.44736842105263,38,0,806,25,WR,0
1,1,6,924,1112,-188,-97,-102,5,95.88,25,0,208,26,WR,0
0,1,13,378,-458,836,-231,-238,7,284.4,30,1,16,853,TE,0
0,1,29,1242,387,855,-258,-181,-77,260.3939393939394,33,0,18,861,TE,0
0,1,0,821,603,218,-268,-345,77,354.35,40,0,598,819,WR,1
0,1,11,25,-425,450,-486,-220,-266,182.10714285714286,28,1,2,459,TE,0
1,1,0,1013,-628,1641,-279,-305,26,383.93023255813955,43,1,0,1641,WR,0
1,1,31,591,534,57,-150,-126,-24,75.41666666666667,12,0,10,83,TE,0
0,1,28,486,-395,881,-239,-202,-37,234.8108108108108,37,1,2,884,TE,0
0,1,0,736,5,731,-282,-340,58,410.0,18,0,24,744,WR,0
0,1,16,9,370,-361,-249,-211,-38,222.61111111111111,18,0,390,13,TE,0
0,1,34,601,869,-268,-179,-178,-1,173.66666666666666,15,0,253,4,RB,0
0,1,16,439,-433,872,-199,-202,3,304.7241379310345,29,1,9,879,TE,0
0,1,45,90,-202,292,-537,-502,-35,142.4090909090909,22,1,4,306,RB,0
0,1,5,1921,-719,2640,-243,-275,32,486.55555555555554,54,1,6,2658,WR,0
0,1,43,1494,428,1066,-248,-249,1,284.18918918918916,37,0,14,1062,TE,0
0,1,31,928,-1074,2002,-242,-184,-58,414.6458333333333,48,1,12,2002,WR,0
1,1,32,1345,-1305,2650,-227,-199,-28,407.2,65,1,22,2685,WR,0
1,1,19,630,410,220,-115,-227,112,119.95833333333333,24,0,11,254,TE,0
0,1,24,227,189,38,-454,-433,-21,108.43243243243244,37,0,142,150,RB,1
0,1,70,1942,842,1100,-217,-178,-39,288.2307692307692,39,0,40,1131,TE,0
0,1,23,1046,-1158,2204,-247,-180,-67,395.9107142857143,56,1,7,2198,WR,0
0,1,12,1239,487,752,-184,-143,-41,353.95454545454544,22,0,10,755,TE,0
0,1,0,1337,503,834,-164,-69,-95,196.6904761904762,42,0,22,853,TE,0
0,1,0,543,-131,674,-365,-256,-109,359.2631578947368,19,1,4,683,FB,0
0,1,34,344,-290,634,-284,-528,244,268.77777777777777,27,1,2,638,FB,0
0,1,0,483,42,441,-109,-246,137,201.72,25,0,2,449,TE,0
0,1,0,924,-102,1026,-212,-186,-26,521.65,20,1,3,1024,WR,0
0,1,0,808,151,657,-224,-263,39,443.3333333333333,15,0,4,670,WR,0
0,1,1,282,-681,963,-590,-227,-363,253.17073170731706,41,1,0,963,RB,0
0,1,2,1143,483,660,-150,-158,8,266.85714285714283,28,0,41,701,TE,0
0,1,51,1847,485,1362,-220,-191,-29,311.09090909090907,44,0,6,1383,TE,0
1,1,47,426,-624,1050,-221,-138,-83,256.8292682926829,41,1,17,1059,TE,0
1,1,0,155,-270,425,-619,-504,-115,123.11428571428571,35,1,16,427,RB,0
0,1,0,1546,954,592,-184,-125,-59,252.58333333333334,24,0,16,601,TE,0
0,1,0,1880,1650,230,-133,-178,45,201.58333333333334,12,0,8,236,WR,0
0,1,0,220,-323,543,-536,-489,-47,223.48,25,1,0,541,RB,0
0,1,19,1293,456,837,-225,-182,-43,284.8965517241379,29,0,22,854,TE,0
0,1,0,992,-415,1407,262,48,214,470.9,30,1,7,1410,TE,0
0,1,0,454,14,440,-87,-219,132,357.9166666666667,12,0,6,427,TE,0
0,1,0,1142,503,639,-241,-153,-88,206.6451612903226,31,0,6,641,TE,0
0,1,0,479,47,432,-216,-285,69,294.1333333333333,15,0,9,448,TE,0
0,1,30,616,445,171,-234,-180,-54,136.0,13,0,2,174,TE,0
0,1,0,746,-621,1367,-223,-125,-98,393.1621621621622,37,1,0,1374,TE,0
0,1,0,1082,160,922,-187,-256,69,463.15,20,0,13,939,WR,0
0,1,0,453,114,339,-191,-258,67,258.0,15,0,22,380,TE,0
0,1,0,77,-262,339,-623,-588,-35,201.88888888888889,18,1,0,339,RB,0
0,1,0,954,-208,1162,-164,-357,193,542.3636363636364,22,1,14,1171,WR,0
0,1,0,1065,-189,1254,-202,-311,109,542.4347826086956,23,1,2,1249,WR,0
1,1,0,251,409,-158,-492,-283,-209,146.6315789473684,19,0,158,0,TE,0
0,1,0,1851,1245,606,-182,-177,-5,226.65384615384616,26,0,11,608,WR,0
0,1,0,463,-507,970,-210,-225,15,245.51282051282053,39,1,4,986,TE,0
0,1,0,1173,462,711,-260,-312,52,417.3529411764706,17,0,6,717,RB,0
0,1,0,718,146,572,-152,-322,170,256.07142857142856,56,0,425,992,WR,1
0,1,0,615,494,121,-173,-155,-18,144.54545454545453,11,0,21,140,TE,0
0,1,22,54,-993,1047,-290,-181,-109,404.85185185185185,27,1,4,1044,WR,0
0,1,0,454,394,60,-205,-198,-7,129.75,4,0,3,55,TE,0
0,1,0,176,-702,878,-580,-567,-13,448.85,20,1,0,878,RB,0
0,1,13,339,210,129,-485,-461,-24,100.51724137931035,29,0,80,210,WR,1
0,1,68,1523,542,981,-233,-200,-33,230.79545454545453,44,0,33,1008,TE,0
0,1,1,978,-1991,2969,-174,-216,42,343.82758620689657,87,1,16,2988,WR,0
0,1,57,763,-1311,2074,-214,-267,53,446.2340425531915,47,1,22,2079,WR,0
0,1,1,15,18,-3,-699,-676,-23,137.41666666666666,36,0,25,44,RB,1
0,1,0,1389,480,909,-130,-152,22,259.2368421052632,38,0,47,962,TE,0
0,1,32,1622,482,1140,-173,-163,-10,286.7073170731707,41,0,28,1167,TE,0
0,1,0,874,-431,1305,-265,-565,300,365.078431372549,51,1,204,1520,WR,0
0,1,0,273,-781,1054,-349,-282,-67,300.05555555555554,36,1,10,1057,WR,0
0,1,29,564,-991,1555,-307,-51,-256,318.3137254901961,51,1,2,1557,WR,0
0,1,0,522,160,362,-273,-297,24,306.3333333333333,12,0,3,375,WR,0
0,1,57,1278,549,729,-194,-156,-38,177.0,41,0,2,745,TE,0
0,1,0,1166,693,473,-248,-270,22,370.6923076923077,13,0,20,478,WR,0
0,1,0,1037,496,541,-187,-183,-4,202.5,28,0,35,579,TE,0
0,1,78,1865,490,1375,-162,-155,-7,381.7567567567568,37,0,28,1399,TE,0
0,1,45,1592,460,1132,-278,-163,-115,295.2564102564103,39,0,24,1144,TE,0
0,1,49,89,105,-16,-248,-186,-62,72.8,10,0,24,14,WR,1
0,1,0,877,-534,1411,-179,-234,55,570.8,25,1,14,1420,WR,0
0,1,0,376,-89,465,-265,-462,197,176.0,30,1,6,477,FB,0
0,1,0,919,-817,1736,-161,-270,109,486.6111111111111,36,1,6,1740,WR,0
0,1,0,825,-874,1699,-197,-192,-5,358.72340425531917,47,1,5,1721,WR,0
0,1,38,1938,496,1442,-186,-153,-33,323.90909090909093,44,0,19,1441,TE,0
0,1,0,869,259,610,-114,-177,63,358.94444444444446,18,0,6,627,WR,0
0,1,0,887,68,819,-171,-457,286,266.76363636363635,55,0,283,1109,FB,1
0,1,0,859,21,838,-206,-455,249,265.3958333333333,48,0,178,1020,FB,0
0,1,0,826,55,771,-248,-471,223,276.3404255319149,47,0,226,990,FB,1
0,1,1,436,1061,-625,-283,-144,-139,227.6,55,0,938,323,TE,1
0,1,0,432,49,383,-210,-270,60,294.7142857142857,14,0,18,419,TE,0
0,1,0,470,111,359,-212,-231,19,386.7,10,0,16,383,TE,0
0,1,0,1085,571,514,-118,-252,134,406.53846153846155,13,0,4,525,WR,0
0,1,0,973,753,220,-145,-205,60,265.875,8,0,8,222,WR,0
0,1,0,470,-446,916,-203,-156,-47,272.0,35,1,23,945,TE,0
0,1,0,1108,520,588,-175,-133,-42,231.04,25,0,2,591,WR,0
0,1,0,609,270,339,-185,-256,71,146.66666666666666,24,0,3,349,TE,0
0,1,0,553,149,404,-103,-265,162,257.36842105263156,19,0,19,420,TE,0
0,1,4,883,-1027,1910,-220,-195,-25,389.6734693877551,49,1,2,1908,WR,0
0,1,0,536,-386,922,-73,-119,46,457.4761904761905,21,1,0,927,TE,0
0,1,24,212,-424,636,-413,-170,-243,230.2,30,1,8,657,FB,0
0,1,0,1399,714,685,-237,-357,120,357.55,20,0,30,705,WR,0
0,1,2,599,622,-23,-206,-184,-22,193.375,56,0,547,529,TE,1
0,1,0,254,-373,627,-485,-691,206,371.3333333333333,18,1,2,635,RB,0
0,1,27,453,-468,921,-190,-218,28,238.2439024390244,41,1,25,967,TE,0
0,1,0,1060,-350,1410,-169,-436,267,486.0689655172414,29,1,6,1400,WR,0
0,1,0,474,-191,665,-167,-369,202,201.81578947368422,38,1,52,699,FB,0
0,1,0,1036,-306,1342,-218,-291,73,388.5405405405405,37,1,29,1381,WR,0
0,1,45,1056,431,625,-201,-237,36,195.48387096774192,31,0,4,635,FB,0
0,1,2,686,-581,1267,-146,-156,10,240.27272727272728,55,1,31,1294,TE,0
0,1,0,411,160,251,-229,-276,47,133.775,40,0,49,304,TE,0
0,1,5,170,-2012,2182,-512,-175,-337,401.375,56,1,32,2212,RB,0
0,1,34,13,15,-2,-772,-733,-39,125.95238095238095,42,0,66,40,RB,1
1,1,2,699,-452,1151,-261,-164,-97,243.64,50,1,44,1173,TE,0
0,1,0,1046,-355,1401,-133,-256,123,491.35714285714283,28,1,4,1395,WR,0
0,1,0,1152,1093,59,-200,-219,19,235.12121212121212,33,0,351,409,WR,1
0,1,0,1035,-885,1920,-198,-205,7,424.4130434782609,46,1,8,1927,TE,0
0,1,0,521,-475,996,-232,-138,-94,284.7368421052632,38,1,16,1013,FB,0
0,1,6,5,-210,215,-688,-478,-210,110.4074074074074,27,1,19,243,RB,0
0,1,0,999,-300,1299,-213,-302,89,499.46153846153845,26,1,13,1303,WR,0
0,1,0,603,-520,1123,-295,-275,-20,290.46938775510205,49,1,178,1299,FB,0
0,1,46,831,-732,1563,-255,-167,-88,340.1521739130435,46,1,6,1586,TE,0
0,1,1,613,-482,1095,-191,-160,-31,237.23529411764707,51,1,43,1141,TE,0
0,1,0,914,452,462,-184,-316,132,388.46153846153845,13,0,19,485,WR,0
0,1,0,3,552,-549,-509,-157,-352,200.9090909090909,33,0,550,3,TE,0
0,1,0,503,215,288,-196,-234,38,157.85,20,0,20,301,TE,0
0,1,0,263,-400,663,-522,-621,99,350.5263157894737,19,1,2,654,RB,0
0,1,0,527,202,325,-168,-266,98,230.14285714285714,14,0,7,338,TE,0
0,1,0,1531,539,992,-217,-206,-11,253.56410256410257,39,0,12,1005,TE,0
0,1,0,250,-447,697,-535,-609,74,346.3809523809524,21,1,30,719,RB,0
0,1,25,1022,484,538,-293,-209,-84,200.3,30,0,29,565,FB,0
0,1,0,411,-1418,1829,-250,-224,-26,443.9761904761905,42,1,0,1863,FB,0
0,1,0,906,-553,1459,-277,-203,-74,524.3571428571429,28,1,0,1458,WR,0
0,1,0,1652,1152,500,-177,-204,27,190.3846153846154,26,0,0,493,WR,0
0,1,0,1816,888,928,-99,-271,172,395.0833333333333,24,0,1,901,RB,0
0,1,25,1141,568,573,-177,-177,0,124.375,48,0,23,585,TE,0
0,1,27,1855,217,1638,-258,-573,315,215.6990291262136,103,0,116,1745,RB,0
0,1,0,435,141,294,-154,-230,76,169.8095238095238,21,0,49,343,TE,0
0,1,13,1209,518,691,-141,-124,-17,200.5,34,0,2,693,WR,0
0,1,21,552,-482,1034,-184,-143,-41,280.4054054054054,37,1,5,1043,TE,0
0,1,0,1062,473,589,-227,-309,82,370.5882352941176,17,0,15,613,WR,0
0,1,3,2081,1059,1022,-215,-228,13,271.6756756756757,37,0,0,1009,WR,0
0,1,1,431,-485,916,-109,-114,5,188.03571428571428,56,1,19,939,TE,0
0,1,0,776,-538,1314,-182,-267,85,535.92,25,1,4,1323,WR,0
0,1,4,1280,687,593,-226,-120,-106,217.37037037037038,27,0,2,604,TE,0
0,1,41,935,1270,-335,-198,-48,-150,193.21052631578948,19,0,359,6,WR,0
0,1,5,152,521,-369,-305,-183,-122,210.45,20,0,377,8,RB,0
0,1,5,556,427,129,-220,-240,20,228.43478260869566,46,0,481,605,FB,1
0,1,4,222,-217,439,-582,-572,-10,158.75,28,1,12,456,RB,0
0,1,0,481,447,34,-210,-182,-28,44.30769230769231,26,0,49,80,TE,1
0,1,0,787,-839,1626,-162,-194,32,361.0444444444444,45,1,0,1624,WR,0
0,1,0,459,161,298,-163,-239,76,207.8,15,0,30,318,TE,0
0,1,15,1203,479,724,-202,-135,-67,217.41176470588235,34,0,4,734,WR,0
0,1,0,1845,1178,667,-137,-190,53,254.8148148148148,27,0,0,667,WR,0
0,1,0,910,-250,1160,-199,-294,95,495.25,24,1,20,1172,WR,0
0,1,0,203,-452,655,-397,-185,-212,157.6590909090909,44,1,42,695,FB,0
0,1,0,499,431,68,-248,-218,-30,36.111111111111114,9,0,22,77,TE,1
0,1,0,1052,573,479,-160,-260,100,393.38461538461536,13,0,13,489,WR,0
1,1,30,1,183,-182,-718,-530,-188,105.78125,32,0,224,34,RB,0
1,1,13,496,325,171,-201,-339,138,82.87878787878788,33,0,14,164,FB,0
1,1,27,951,2181,-1230,-411,-123,-288,402.9375,32,0,1244,2,RB,0
1,1,0,1800,1342,458,-58,-58,0,113.38095238095238,42,0,1,454,WR,0
1,1,0,1058,769,289,-69,-33,-36,120.69565217391305,23,0,16,292,TE,0
0,1,9,554,-483,1037,-318,-193,-125,283.2368421052632,38,1,36,1072,TE,0
0,1,2,487,-470,957,-186,-7,-179,172.91044776119404,67,1,9,958,TE,0
0,1,3,455,399,56,-260,-195,-65,191.47540983606558,61,0,537,586,FB,1
0,1,36,1692,250,1442,-355,-584,229,358.64285714285717,42,0,19,1456,RB,0
0,1,0,236,-1826,2062,-503,-125,-378,369.625,56,1,4,2067,RB,0
1,1,14,1373,-614,1987,-195,-126,-69,365.8727272727273,55,1,5,1996,TE,0
1,1,30,307,494,-187,-331,-122,-209,123.77777777777777,18,0,194,8,RB,0
0,1,0,523,-604,1127,-210,-255,45,334.97058823529414,34,1,0,1135,TE,0
0,1,0,1078,-832,1910,-207,-251,44,467.2682926829268,41,1,13,1921,TE,0
0,1,3,1389,459,930,-188,-188,0,221.38297872340425,47,0,49,978,TE,0
0,1,0,492,-1363,1855,-220,-129,-91,403.5217391304348,46,1,0,1848,TE,0
0,1,0,555,-254,809,290,14,276,367.4347826086956,23,1,9,832,FB,0
0,1,4,504,-452,956,-241,-205,-36,246.5897435897436,39,1,5,962,TE,0
0,1,1,502,1383,-881,-282,-123,-159,334.8888888888889,27,0,882,5,WR,0
0,1,49,51,-166,217,-556,-354,-202,110.9047619047619,21,1,2,242,RB,0
0,1,0,718,-242,960,-246,-354,108,288.65714285714284,35,1,15,951,RB,0
0,1,0,315,-562,877,-197,-118,-79,276.11764705882354,34,1,33,915,TE,0
0,1,0,1249,-869,2118,-237,-147,-90,355.6885245901639,61,1,25,2146,WR,0
0,1,14,1709,684,1025,-127,-173,46,157.8,65,0,1,1020,WR,0
0,1,51,455,1007,-552,-186,-113,-73,177.51612903225808,31,0,589,8,TE,0
0,1,0,880,-202,1082,-154,-275,121,259.34090909090907,44,1,9,1094,WR,0
0,1,0,593,508,85,-91,-90,-1,47.903225806451616,31,0,82,178,TE,1
0,1,35,456,360,96,-285,-332,47,70.47058823529412,34,0,87,186,TE,1
0,1,0,214,3,211,-511,-509,-2,98.41666666666667,24,0,35,244,FB,0
0,1,0,2,475,-473,-467,-90,-377,177.2058823529412,34,0,477,4,TE,0
0,1,0,187,142,45,-522,-523,1,158.25,4,0,2,67,RB,0
0,1,21,1251,208,1043,-191,-547,356,315.9166666666667,36,0,8,1062,RB,0
0,1,0,8,151,-143,-468,-473,5,163.77777777777777,9,0,160,4,FB,0
1,1,87,734,-1178,1912,-198,-69,-129,320.88709677419354,62,1,16,1917,WR,0
1,1,48,447,-778,1225,-80,-164,84,180.83544303797467,79,1,62,1277,TE,0
0,1,22,34,2074,-2040,-785,-181,-604,413.234375,128,0,3628,1587,RB,1
1,1,79,781,-863,1644,-90,-66,-24,283.61290322580646,62,1,56,1711,WR,0
0,1,65,23,955,-932,-559,-214,-345,169.85915492957747,71,0,1081,149,WR,0
0,1,0,721,349,372,-210,-264,54,311.9230769230769,13,0,26,396,WR,0
0,1,0,495,488,7,-108,-76,-32,29.846153846153847,13,0,51,68,TE,1
0,1,11,631,-1287,1918,-210,-111,-99,389.7551020408163,49,1,2,1914,WR,0
0,1,19,857,-1055,1912,-221,-190,-31,389.44897959183675,49,1,2,1919,WR,0
0,1,0,655,-499,1154,-228,-147,-81,150.40740740740742,81,1,64,1213,TE,0
0,1,0,1419,713,706,-238,-176,-62,306.2608695652174,23,0,6,698,TE,0
0,1,0,567,481,86,-211,-318,107,337.1463414634146,41,0,671,752,FB,1
0,1,0,41,495,-454,-285,-101,-184,215.45833333333334,24,0,457,15,TE,0
0,1,0,1457,878,579,-276,-190,-86,209.22222222222223,27,0,4,568,WR,0
0,1,0,1822,1506,316,-234,-219,-15,215.46666666666667,15,0,8,328,WR,0
0,1,0,610,296,314,-217,-237,20,186.72222222222223,18,0,6,322,WR,0
0,1,0,565,526,39,-111,-72,-39,34.57142857142857,28,0,63,97,TE,1
0,1,0,933,-1041,1974,-204,-243,39,425.5869565217391,46,1,15,1971,WR,0
0,1,0,283,-237,520,-549,-580,31,197.66666666666666,27,1,18,524,RB,0
0,1,3,1468,704,764,-178,-131,-47,189.3170731707317,41,0,26,779,TE,0
0,1,63,730,-439,1169,-226,-195,-31,279.90697674418607,43,1,51,1230,TE,0
0,1,1,595,-9,604,-194,-537,343,225.61290322580646,31,1,21,644,FB,0
0,1,2,481,852,-371,-257,-206,-51,237.23076923076923,65,0,960,586,TE,1
1,1,15,869,-855,1724,-229,-251,22,405.76190476190476,42,1,4,1734,WR,0
1,1,48,1173,711,462,-84,-146,62,160.35714285714286,28,0,15,468,WR,0
0,1,39,1236,1968,-732,-237,-176,-61,249.93103448275863,29,0,740,5,WR,0
0,1,23,203,1039,-836,-512,-176,-336,294.030303030303,33,0,833,13,WR,0
0,1,41,1253,221,1032,-179,-481,302,311.81081081081084,37,0,12,1073,RB,0
0,1,1,354,474,-120,-286,-288,2,66.6086956521739,23,0,144,15,TE,0
1,1,37,675,530,145,-163,-209,46,103.8,15,0,24,144,WR,0
1,1,8,1041,-1179,2220,-188,-249,61,372.7049180327869,61,1,24,2235,WR,0
0,1,0,911,289,622,-180,-247,67,424.8,15,0,2,623,WR,0
0,1,0,883,321,562,-241,-266,25,425.61538461538464,13,0,3,556,WR,0
0,1,0,1400,526,874,-168,-189,21,271.3125,32,0,15,884,WR,0
0,1,32,1309,-2,1311,-302,-754,452,320.20454545454544,44,1,11,1323,RB,0
0,1,67,497,-602,1099,-253,-168,-85,286.2894736842105,38,1,6,1112,TE,0
0,1,1,1250,-739,1989,-217,-231,14,400.1,50,1,9,2000,WR,0
0,1,0,462,-407,869,-214,-215,1,248.86111111111111,36,1,54,899,TE,0
0,1,0,892,393,499,-273,-382,109,378.92857142857144,14,0,2,514,WR,0
0,1,0,1392,522,870,-244,-193,-51,222.9,40,0,20,891,TE,0
0,1,27,764,-1090,1854,-184,-154,-30,425.9767441860465,43,1,9,1848,WR,0
0,1,0,635,-488,1123,-232,-258,26,428.4,45,1,399,1523,WR,1
0,1,23,867,-1095,1962,-126,-175,49,346.08620689655174,58,1,15,1989,WR,0
0,1,48,204,174,30,-478,-459,-19,105.25,44,0,121,125,RB,1
1,1,13,662,-1009,1671,-194,-156,-38,345.7916666666667,48,1,13,1664,WR,0
1,1,0,472,478,-6,-87,-107,20,62.074074074074076,27,0,118,92,TE,1
0,1,8,157,-735,892,-495,-233,-262,237.92307692307693,39,1,0,887,RB,0
0,1,0,192,-371,563,-561,-571,10,316.7368421052632,19,1,32,576,RB,0
0,1,0,469,-619,1088,-246,-188,-58,265.6818181818182,44,1,44,1127,TE,0
0,1,0,816,-902,1718,-193,-203,10,323.0,54,1,7,1723,WR,0
0,1,59,500,-445,945,-200,-148,-52,245.84615384615384,39,1,2,954,TE,0
0,1,0,605,-483,1088,-187,-154,-33,236.95744680851064,47,1,11,1113,TE,0
0,1,0,556,249,307,-228,-274,46,128.0909090909091,22,0,20,306,TE,0
0,1,0,1394,666,728,-162,-219,57,328.77272727272725,22,0,2,735,WR,0
0,1,0,1450,515,935,-186,-193,7,279.0,33,0,0,922,WR,0
0,1,21,947,-231,1178,-296,-459,163,286.15909090909093,44,1,7,1204,RB,0
0,1,0,561,558,3,-181,-244,63,217.88235294117646,51,0,559,561,TE,1
0,1,11,772,289,483,-186,-447,261,223.16,25,0,4,497,WR,0
0,1,0,1036,128,908,-209,-313,104,379.88,25,0,8,920,WR,0
0,1,0,1582,908,674,-124,-198,74,429.6875,16,0,21,685,WR,0
0,1,0,887,404,483,-229,-319,90,394.3076923076923,13,0,2,487,WR,0
0,1,0,1901,1118,783,-171,-118,-53,289.85185185185185,27,0,3,784,WR,0
0,1,0,786,365,421,-201,-305,104,215.41666666666666,24,0,14,444,RB,0
0,1,22,390,312,78,-139,-118,-21,59.5,22,0,42,122,TE,1
0,1,0,947,658,289,-260,-240,-20,189.33333333333334,15,0,6,293,TE,0
0,1,17,418,-493,911,-288,-93,-195,214.5909090909091,44,1,4,907,TE,0
0,1,29,293,878,-585,-490,-176,-314,264.8888888888889,27,0,604,21,RB,0
0,1,0,256,565,-309,-497,-244,-253,203.5,22,0,325,2,WR,0
0,1,0,559,420,139,-225,-271,46,217.0,7,0,11,146,WR,0
0,1,1,535,398,137,-73,-121,48,193.2051282051282,39,0,306,427,WR,1
0,1,0,927,-342,1269,-268,-302,34,338.43589743589746,39,1,30,1302,WR,0
0,1,13,290,1895,-1605,-469,-185,-284,377.26666666666665,45,0,1616,6,RB,0
0,1,0,504,-441,945,59,-42,101,211.07407407407408,54,1,34,1003,TE,0
0,1,30,5,-578,583,-303,72,-375,225.28125,32,1,4,620,TE,0
0,1,0,656,-500,1156,-180,-135,-45,298.2857142857143,42,1,2,1215,TE,0
0,1,12,1594,534,1060,-269,-19,-250,306.97222222222223,36,0,8,1077,TE,0
0,1,0,1778,1250,528,-126,16,-142,183.56666666666666,30,0,1,533,WR,0
1,1,40,1373,586,787,-205,-77,-128,239.90625,32,0,7,777,RB,0
1,1,46,934,1227,-293,-83,25,-108,122.5,24,0,310,6,WR,0
1,1,0,1388,430,958,-216,-138,-78,212.51111111111112,45,0,5,975,TE,0
0,1,6,216,-1260,1476,-522,-42,-480,353.6046511627907,43,1,5,1478,RB,0
0,1,0,861,475,386,-253,-298,45,301.61538461538464,13,0,2,391,RB,0
0,1,0,1015,504,511,-210,-213,3,371.2,15,0,4,526,WR,0
1,1,17,607,-498,1105,-149,150,-299,258.82978723404256,47,1,34,1175,TE,0
1,1,54,488,-387,875,-107,203,-310,252.3684210526316,38,1,10,927,TE,0
0,1,0,964,-834,1798,-60,53,-113,387.7916666666667,48,1,22,1783,WR,0
0,1,0,731,418,313,-216,-255,39,198.91176470588235,34,0,175,488,WR,1
0,1,0,455,60,395,-284,-280,-4,284.42857142857144,14,0,3,390,TE,0
0,1,2,872,-618,1490,-238,-152,-86,323.82608695652175,46,1,0,1486,TE,0
0,1,25,154,799,-645,-503,-102,-401,213.0,34,0,643,16,RB,0
0,1,0,1172,545,627,-232,-254,22,375.88235294117646,17,0,3,624,WR,0
0,1,0,766,-738,1504,-178,-181,3,302.98,50,1,5,1499,WR,0
0,1,0,956,389,567,-167,-295,128,395.26666666666665,15,0,7,560,WR,0
0,1,0,474,-612,1086,-231,-122,-109,280.43243243243245,37,1,16,1068,TE,0
0,1,0,905,659,246,-326,-321,-5,206.0,12,0,2,247,TE,0
0,1,0,951,306,645,-224,-277,53,388.47058823529414,17,0,3,658,WR,0
0,1,29,1288,493,795,-167,-161,-6,255.03125,32,0,13,804,TE,0
0,1,0,937,-744,1681,-242,-282,40,523.9375,32,1,6,1692,WR,0
0,1,0,278,656,-378,-467,-253,-214,180.1153846153846,26,0,378,13,WR,0
0,1,0,722,-364,1086,-193,-275,82,281.075,40,1,25,1115,TE,0
0,1,4,439,-530,969,-232,-112,-120,272.1388888888889,36,1,2,977,TE,0
0,1,0,1426,862,564,-165,-157,-8,171.65625,32,0,0,564,WR,0
0,1,0,850,364,486,-279,-347,68,347.4,15,0,18,499,WR,0
0,1,0,891,-921,1812,-170,-236,66,376.14285714285717,49,1,9,1832,WR,0
0,1,2,409,-539,948,-207,-75,-132,271.27777777777777,36,1,0,961,TE,0
0,1,0,812,98,714,-172,-340,168,431.27777777777777,18,0,3,736,WR,0
0,1,6,1468,603,865,-180,-132,-48,236.83333333333334,36,0,4,869,WR,0
0,1,0,443,87,356,-252,-280,28,273.6923076923077,13,0,6,354,TE,0
0,1,0,865,413,452,-218,-300,82,335.42857142857144,14,0,17,453,WR,0
0,1,0,83,489,-406,-260,-99,-161,253.88235294117646,17,0,422,24,TE,0
0,1,0,1247,724,523,-225,-183,-42,249.5,22,0,12,541,WR,0
0,1,0,716,-528,1244,-239,-339,100,486.03846153846155,26,1,16,1254,WR,0
0,1,26,224,-1868,2092,-453,-108,-345,409.1509433962264,53,1,12,2107,RB,0
0,1,0,726,-494,1220,-171,-188,17,286.6046511627907,43,1,4,1227,TE,0
0,1,0,786,794,-8,-152,-134,-18,106.0,2,0,7,11,WR,1
0,1,0,229,285,-56,-488,-486,-2,47.0,5,0,46,4,RB,0
0,1,0,649,624,25,-91,114,-205,91.33333333333333,3,0,2,14,TE,0
0,1,0,667,-697,1364,-147,-182,35,335.7560975609756,41,1,4,1374,WR,0
0,1,0,472,-359,831,-196,-105,-91,278.8125,32,1,28,866,TE,0
1,1,0,534,-590,1124,-203,32,-235,254.51063829787233,47,1,87,1185,TE,0
1,1,53,383,-448,831,-121,58,-179,291.8,30,1,47,839,TE,0
0,1,0,550,726,-176,-295,-57,-238,368.48936170212767,94,0,1809,1608,WR,1
0,1,0,1005,-367,1372,-179,-253,74,387.25,36,1,14,1381,WR,0
0,1,7,963,-432,1395,-167,-204,37,340.3170731707317,41,1,6,1395,TE,0
0,1,0,1400,809,591,-173,-73,-100,210.78571428571428,28,0,0,589,WR,0
0,1,0,1722,1276,446,-142,-38,-104,166.03703703703704,27,0,3,454,WR,0
0,1,0,425,335,90,-114,-89,-25,50.541666666666664,24,0,14,115,TE,0
0,1,11,1128,265,863,-224,-377,153,272.0,32,0,8,872,TE,0
0,1,0,1064,763,301,-147,-254,107,268.4166666666667,12,0,2,315,WR,0
0,1,0,681,-524,1205,-235,-138,-97,232.58823529411765,51,1,13,1185,TE,0
0,1,0,512,1696,-1184,-146,-192,46,289.9767441860465,43,0,1244,22,WR,0
0,1,0,574,335,239,-184,-278,94,124.42857142857143,21,0,7,241,WR,0
0,1,2,601,-424,1025,-369,-162,-207,314.6666666666667,33,1,2,1043,TE,0
0,1,42,526,637,-111,-122,35,-157,83.4,20,0,171,38,TE,1
0,1,10,231,243,-12,-498,-368,-130,120.45283018867924,53,0,191,201,RB,1
0,1,0,1939,1965,-26,-97,66,-163,20.333333333333332,12,0,82,80,WR,1
0,1,0,776,-591,1367,-205,-128,-77,308.6666666666667,45,1,9,1391,WR,0
1,1,0,543,473,70,-220,-193,-27,68.86842105263158,38,0,129,188,TE,1
1,1,13,13,16,-3,-755,-622,-133,84.5,40,0,26,36,RB,1
0,1,0,1006,366,640,-215,-304,89,289.875,24,0,26,665,WR,0
0,1,0,805,282,523,-246,-184,-62,315.5,18,0,15,540,WR,0
0,1,0,760,-522,1282,-213,-86,-127,260.40816326530614,49,1,24,1287,TE,0
0,1,22,350,200,150,-481,-488,7,93.55555555555556,27,0,16,188,RB,0
0,1,5,739,202,537,-193,-464,271,188.17142857142858,35,0,27,562,RB,0
0,1,0,1818,1075,743,-168,-119,-49,237.26666666666668,30,0,2,716,WR,0
0,1,14,176,-480,656,-267,-226,-41,286.2083333333333,24,1,8,663,TE,0
1,1,0,382,-438,820,-301,-60,-241,221.3684210526316,38,1,26,810,TE,0
1,1,31,230,-206,436,-584,-376,-208,164.8,25,1,25,416,RB,0
0,1,70,565,-1281,1846,-235,-59,-176,366.8627450980392,51,1,4,1865,WR,0
0,1,0,375,-418,793,-215,22,-237,230.14285714285714,35,1,3,784,TE,0
0,1,0,463,-486,949,-95,-217,122,237.0222222222222,45,1,20,957,TE,0
0,1,48,258,-1550,1808,-546,-205,-341,388.3469387755102,49,1,14,1801,RB,0
0,1,0,566,-390,956,-28,-193,165,258.81081081081084,37,1,11,964,TE,0
0,1,0,573,1773,-1200,-203,-196,-7,312.8421052631579,38,0,1199,15,WR,0
0,1,8,1046,-913,1959,282,-37,319,310.7142857142857,63,1,0,1945,WR,0
0,1,0,864,566,298,-154,-144,-10,79.22222222222223,36,0,17,293,TE,0
0,1,0,1182,227,955,-274,-292,18,315.4848484848485,33,0,31,1011,RB,0
0,1,0,975,567,408,-211,-299,88,258.8235294117647,17,0,13,408,WR,0
0,1,0,2257,1358,899,-197,-100,-97,214.77551020408163,49,0,73,987,WR,0
0,1,0,645,-491,1136,-93,-131,38,285.9,40,1,7,1132,TE,0
0,1,10,1584,627,957,-228,-130,-98,265.4594594594595,37,0,6,989,TE,0
0,1,0,580,1815,-1235,-166,-195,29,302.390243902439,41,0,1243,4,WR,0
0,1,0,1653,1154,499,-282,-199,-83,278.05263157894734,19,0,6,518,TE,0
0,1,40,206,-224,430,-552,-401,-151,156.67741935483872,31,1,9,490,RB,0
0,1,7,545,-279,824,-185,-426,241,267.3125,32,1,20,840,WR,0
0,1,0,523,560,-37,-206,-162,-44,124.69444444444444,36,0,205,215,TE,1
0,1,9,1135,491,644,-228,-180,-48,196.0,33,0,5,675,TE,0
0,1,36,1805,1963,-158,-127,-12,-115,79.52631578947368,19,0,160,7,RB,0
0,1,0,1316,474,842,-225,-306,81,462.22222222222223,18,0,18,807,WR,0
1,1,26,1396,579,817,-111,-141,30,210.6,40,0,10,819,RB,0
0,1,0,182,-661,843,-365,-248,-117,321.2142857142857,56,1,450,1289,WR,1
0,1,5,670,-625,1295,-260,-142,-118,359.42105263157896,38,1,13,1304,TE,0
0,1,0,1062,300,762,-204,-242,38,300.5769230769231,26,0,14,775,WR,0
0,1,7,1174,436,738,-239,-153,-86,309.96,25,0,4,745,TE,0
0,1,0,1567,972,595,-221,-223,2,225.64,25,0,0,592,TE,0
0,1,0,752,230,522,-236,-281,45,443.5,12,0,10,539,WR,0
0,1,0,536,532,4,-254,-244,-10,274.85714285714283,49,0,681,672,TE,1
0,1,0,755,-188,943,-205,-147,-58,448.7142857142857,21,1,9,938,WR,0
0,1,9,256,-267,523,-502,-498,-4,122.18604651162791,43,1,12,530,RB,0
0,1,25,896,-1275,2171,-211,-137,-74,399.4909090909091,55,1,20,2173,WR,0
0,1,27,249,-864,1113,-495,-159,-336,226.71153846153845,52,1,10,1142,RB,0
0,1,0,546,-410,956,-193,-230,37,285.70588235294116,34,1,7,962,TE,0
0,1,0,456,-477,933,-113,-221,108,212.8235294117647,51,1,48,975,TE,0
0,1,0,798,340,458,-173,-325,152,346.7857142857143,14,0,17,463,WR,0
0,1,0,448,-429,877,-166,-133,-33,199.96,50,1,37,920,TE,0
0,1,0,1607,890,717,-140,-103,-37,278.4,25,0,14,679,TE,0
0,1,23,1260,1127,133,-196,-110,-86,91.875,16,0,31,171,WR,1
0,1,6,222,-217,439,-580,-440,-140,129.11764705882354,34,1,2,449,RB,0
0,1,0,266,340,-74,-256,-232,-24,304.3220338983051,59,0,926,845,TE,1
0,1,38,524,-1328,1852,-257,-73,-184,411.29787234042556,47,1,15,1874,WR,0
0,1,0,617,-421,1038,-285,-251,-34,305.47058823529414,34,1,5,1034,TE,0
0,1,0,509,-436,945,-182,-204,22,288.3529411764706,34,1,0,949,TE,0
0,1,0,745,81,664,-201,-310,109,398.52941176470586,17,0,6,667,WR,0
0,1,0,570,-357,927,-229,-185,-44,286.0,33,1,14,935,WR,0
0,1,0,500,-550,1050,-182,-83,-99,257.8837209302326,43,1,9,1145,TE,0
0,1,2,477,-648,1125,-197,-138,-59,246.6304347826087,46,1,9,1138,TE,0
0,1,1,416,287,129,-220,-251,31,221.1315789473684,38,0,357,505,TE,1
0,1,30,151,-264,415,-536,-487,-49,206.7,20,1,12,411,RB,0
0,1,0,1995,1991,4,-40,349,-389,118.66666666666667,3,0,19,6,WR,1
0,1,0,1325,1857,-532,-221,257,-478,240.28,25,0,525,12,RB,0
0,1,48,735,-795,1530,-178,-172,-6,312.57142857142856,49,1,4,1552,TE,0
0,1,0,490,468,22,-183,-197,14,211.94117647058823,34,0,348,366,TE,1
0,1,0,829,-504,1333,-219,-285,66,391.1764705882353,34,1,2,1334,WR,0
0,1,0,316,353,-37,-510,-114,-396,81.0,3,0,33,4,RB,0
0,1,0,2018,2006,12,-77,330,-407,69.0,4,0,13,18,WR,1
0,1,0,433,416,17,-106,314,-420,131.25,4,0,2,22,TE,0
0,1,31,157,231,-74,-407,-376,-31,60.42857142857143,14,0,86,17,RB,1
0,1,6,1038,269,769,-448,-436,-12,247.375,32,0,11,779,RB,0
0,1,1,21,191,-170,-698,-492,-206,105.48,25,0,190,8,RB,0
0,1,0,562,-484,1046,-150,-145,-5,297.2647058823529,34,1,6,1045,TE,0
0,1,0,1410,657,753,-175,-191,16,261.0689655172414,29,0,10,757,TE,0
0,1,8,484,495,-11,-246,-262,16,228.8695652173913,46,0,523,529,TE,1
0,1,2,753,707,46,-178,-171,-7,46.34615384615385,26,0,69,111,TE,1
0,1,7,706,-649,1355,-253,-235,-18,315.74418604651163,43,1,2,1353,RB,0
0,1,0,571,142,429,-228,-300,72,177.5185185185185,27,0,38,470,TE,0
0,1,17,8,-562,570,-503,-145,-358,263.32,25,1,10,583,RB,0
0,1,6,1151,502,649,-185,-157,-28,199.0625,32,0,14,643,TE,0
0,1,0,539,-252,791,-197,-258,61,379.0,21,1,5,793,TE,0
0,1,38,902,-1076,1978,-179,-84,-95,337.1333333333333,60,1,28,1998,WR,0
0,1,0,1637,1008,629,-169,-35,-134,251.36,25,0,2,631,WR,0
0,1,0,761,-258,1019,-242,-185,-57,505.0,20,1,2,998,WR,0
0,1,32,356,2271,-1915,-282,-163,-119,434.3333333333333,45,0,1923,2,RB,0
0,1,16,772,-920,1692,-240,-139,-101,314.962962962963,54,1,2,1694,WR,0
0,1,38,1988,472,1516,-203,-177,-26,270.140350877193,57,0,22,1527,TE,0
0,1,0,948,726,222,-161,-147,-14,201.45454545454547,11,0,14,232,WR,0
0,1,48,1052,2255,-1203,-338,-155,-183,405.741935483871,31,0,1216,2,RB,0
0,1,36,870,-1075,1945,-197,-215,18,305.0615384615385,65,1,6,1971,WR,0
0,1,17,301,257,44,-513,-500,-13,94.33333333333333,48,0,172,222,RB,1
0,1,0,761,-174,935,-260,-322,62,463.6190476190476,21,1,2,938,WR,0
0,1,62,580,1233,-653,-310,-146,-164,279.5,24,0,634,2,RB,0
0,1,23,652,-1189,1841,-261,-169,-92,350.8490566037736,53,1,5,1848,WR,0
0,1,0,1087,-1204,2291,-242,-251,9,426.037037037037,54,1,10,2298,WR,0
0,1,2,631,-708,1339,-207,-233,26,338.71794871794873,39,1,10,1327,RB,0
0,1,44,554,-1142,1696,-275,-142,-133,357.2708333333333,48,1,6,1687,WR,0
0,1,0,292,335,-43,-103,-70,-33,39.67857142857143,28,0,133,87,TE,1
0,1,0,374,-270,644,-233,-88,-145,348.59090909090907,22,1,2,775,TE,0
0,1,12,553,-771,1324,-217,-128,-89,284.3673469387755,49,1,34,1366,TE,0
1,1,28,2015,-1495,3510,-119,-136,17,486.8611111111111,72,1,12,3515,WR,0
0,1,0,695,697,-2,-52,295,-347,101.33333333333333,3,0,12,4,TE,1
0,1,0,1464,1485,-21,-40,320,-360,125.5,2,0,14,4,WR,1
0,1,32,552,2294,-1742,-321,144,-465,389.10869565217394,46,0,1759,11,RB,0
0,1,0,770,665,105,-219,-247,28,207.4,35,0,311,413,WR,1
0,1,0,882,-45,927,-247,-383,136,465.6666666666667,21,1,20,960,WR,0
0,1,0,675,-386,1061,-256,-204,-52,277.425,40,1,21,1096,WR,0
0,1,0,274,207,67,-509,-397,-112,174.25,4,0,6,67,RB,0
0,1,0,858,805,53,-93,57,-150,133.5,6,0,6,49,TE,0
0,1,0,1968,1983,-15,-82,87,-169,150.66666666666666,6,0,14,2,WR,0
0,1,0,945,1073,-128,-191,-129,-62,96.91666666666667,12,0,120,2,WR,0
1,1,0,952,1504,-552,-62,-25,-37,192.60714285714286,28,0,554,8,WR,0
1,1,0,1503,247,1256,-153,-442,289,265.531914893617,47,0,6,1261,RB,0
0,1,0,1137,-245,1382,-217,-267,50,489.9310344827586,29,1,6,1408,WR,0
0,1,20,674,-797,1471,-250,-152,-98,331.68888888888887,45,1,8,1505,WR,0
0,1,64,304,501,-197,-314,-57,-257,143.85714285714286,21,0,250,27,TE,0
0,1,24,702,-641,1343,-192,-217,25,315.6511627906977,43,1,20,1346,TE,0
0,1,24,886,-1180,2066,-241,-237,-4,420.18367346938777,49,1,17,2072,WR,0
0,1,0,1264,10,1254,-277,-617,340,267.0612244897959,49,0,0,1252,RB,0
1,1,61,270,198,72,-423,-428,5,74.325,40,0,93,142,RB,1
1,1,62,333,524,-191,-360,-128,-232,85.28205128205128,39,0,243,26,TE,0
0,1,0,1363,20,1343,-154,-658,504,320.1458333333333,48,0,23,1367,WR,0
0,1,0,815,-563,1378,-254,-254,0,538.9230769230769,26,1,3,1384,WR,0
1,1,0,1008,1162,-154,-289,-142,-147,64.14814814814815,27,0,172,15,WR,0
1,1,0,590,1035,-445,-133,14,-147,172.21428571428572,28,0,455,2,TE,0
0,1,0,844,-914,1758,-203,-161,-42,337.78846153846155,52,1,4,1763,WR,0
0,1,0,988,623,365,-224,-658,434,448.4310344827586,58,0,1038,1417,RB,1
0,1,24,268,-571,839,-584,-272,-312,289.6774193548387,31,1,31,829,RB,0
0,1,0,314,-92,406,-459,-406,-53,221.61111111111111,18,1,2,395,FB,0
0,1,0,851,841,10,-201,-153,-48,71.5,4,0,2,21,WR,0
0,1,0,1191,374,817,-182,-191,9,247.24242424242425,33,0,4,821,WR,0
0,1,0,375,28,347,-397,-383,-14,156.22727272727272,22,0,4,347,TE,0
0,1,0,891,1,890,-230,-274,44,484.36842105263156,19,0,10,892,WR,0
0,1,0,1515,600,915,-216,-150,-66,267.44117647058823,34,0,4,913,TE,0
0,1,0,477,-446,923,-184,-162,-22,262.18918918918916,37,1,21,939,TE,0
0,1,3,485,-506,991,-93,-141,48,252.07142857142858,42,1,9,1014,TE,0
0,1,0,974,663,311,-243,-260,17,247.84615384615384,13,0,2,328,WR,0
0,1,0,318,158,160,-443,-415,-28,149.3,10,0,8,151,TE,0
0,1,28,277,-344,621,-516,-480,-36,148.54347826086956,92,1,209,799,RB,1
0,1,0,839,372,467,-77,-320,243,188.38709677419354,31,0,28,488,WR,0
1,1,51,484,-468,952,-118,-136,18,237.8372093023256,43,1,18,970,TE,0
1,1,58,1156,389,767,-255,-212,-43,223.35294117647058,34,0,6,774,WR,0
0,1,0,1928,1368,560,-219,-245,26,288.7,20,0,14,579,WR,0
0,1,30,421,-542,963,-184,-151,-33,272.75,36,1,4,965,TE,0
0,1,27,250,-580,830,-511,-226,-285,267.9714285714286,35,1,8,850,RB,0
0,1,0,38,-162,200,-664,-471,-193,64.09473684210526,95,1,121,257,FB,1
0,1,0,1255,-983,2238,-229,-193,-36,376.3333333333333,60,1,3,2246,WR,0
0,1,0,269,-730,999,-493,-255,-238,370.82758620689657,29,1,6,998,RB,0
0,1,8,547,-539,1086,-58,-75,17,206.17543859649123,57,1,29,1091,TE,0
0,1,0,1424,-266,1690,-254,-505,251,334.8679245283019,53,1,17,1740,RB,0
0,1,22,502,-543,1045,-170,-101,-69,280.05263157894734,38,1,8,1068,TE,0
0,1,3,882,-505,1387,-203,-178,-25,282.77966101694915,59,1,149,1528,WR,0
0,1,0,920,339,581,-223,-343,120,342.3888888888889,18,0,12,587,WR,0
0,1,0,945,304,641,-209,-407,198,287.48979591836735,49,0,378,1022,FB,1
0,1,0,334,-266,600,-513,-704,191,338.63157894736844,19,1,13,614,RB,0
0,1,0,269,-110,379,-569,-743,174,273.29411764705884,17,1,17,413,RB,0
0,1,0,454,-491,945,-130,-116,-14,198.18867924528303,53,1,41,982,TE,0
0,1,61,519,-476,995,-160,-132,-28,257.0,39,1,31,1009,TE,0
0,1,6,1173,720,453,-228,-158,-70,156.0,31,0,12,467,WR,0
0,1,0,858,318,540,-157,-275,118,286.57142857142856,21,0,20,553,WR,0
0,1,6,499,-572,1071,-186,1,-187,250.0222222222222,45,1,23,1090,TE,0
0,1,17,241,-295,536,-477,-524,47,183.5,34,1,37,586,RB,0
1,1,11,1434,1134,300,-135,-90,-45,112.96428571428571,28,0,1,296,WR,0
1,1,13,1111,1417,-306,-77,-153,76,118.78571428571429,28,0,323,10,WR,0
0,1,0,3,-158,161,-500,-488,-12,147.1818181818182,11,1,0,161,FB,0
0,1,0,8,-188,196,-480,-469,-11,182.8181818181818,11,1,4,196,FB,0
0,1,0,700,-58,758,-238,-256,18,466.11764705882354,17,1,2,777,WR,0
0,1,7,385,400,-15,-245,-199,-46,162.62222222222223,45,0,373,364,TE,1
1,1,0,529,699,-170,-165,-45,-120,68.3125,32,0,163,3,TE,0
1,1,18,5,-1573,1578,-728,-136,-592,307.33962264150944,53,1,2,1574,RB,0
1,1,28,1442,899,543,-155,-81,-74,141.725,40,0,13,565,WR,0
1,1,32,429,1279,-850,-110,-122,12,225.56410256410257,39,0,862,6,TE,0
1,1,0,686,2178,-1492,-121,-55,-66,337.22727272727275,44,0,1500,6,TE,0
0,1,0,679,350,329,-230,-336,106,187.6086956521739,23,0,47,384,WR,0
0,1,0,1286,670,616,-250,-260,10,221.0,27,0,1,613,TE,0
0,1,0,868,-687,1555,-242,-209,-33,431.6388888888889,36,1,2,1557,WR,0
0,1,28,228,890,-662,-452,-228,-224,217.21212121212122,33,0,669,10,RB,0
0,1,3,767,-634,1401,-276,-294,18,280.61538461538464,52,1,10,1410,WR,0
0,1,1,2,201,-199,-705,-474,-231,115.54545454545455,22,0,198,0,RB,0
0,1,3,673,-444,1117,-216,-212,-4,253.2888888888889,45,1,24,1151,TE,0
0,1,0,776,290,486,-195,-275,80,257.80645161290323,31,0,155,645,WR,1
0,1,21,329,1917,-1588,-349,-200,-149,333.5416666666667,48,0,1589,3,RB,0
0,1,0,461,612,-151,-228,-272,44,191.8421052631579,38,0,438,287,WR,1
0,1,0,866,639,227,-159,-197,38,136.0,16,0,12,211,WR,0
0,1,0,251,486,-235,-497,-545,48,190.23076923076923,13,0,263,22,RB,0
0,1,17,18,199,-181,-739,-394,-345,99.95,60,0,338,157,RB,1
0,1,39,1491,1336,155,-154,-92,-62,71.0,31,0,39,175,WR,1
0,1,0,776,618,158,-198,-269,71,161.58333333333334,12,0,4,176,WR,0
0,1,21,18,600,-582,-486,-199,-287,230.53333333333333,30,0,628,34,TE,0
0,1,0,1019,-285,1304,-226,-335,109,337.55263157894734,76,1,613,1914,RB,1
0,1,0,257,-2173,2430,-506,-182,-324,397.741935483871,62,1,3,2426,RB,0
0,1,2,1411,734,677,-71,-26,-45,141.22916666666666,48,0,10,696,WR,0
0,1,0,865,683,182,-225,-256,31,148.46153846153845,13,0,10,182,WR,0
0,1,0,291,-1745,2036,-491,-292,-199,461.6,45,1,3,2035,RB,0
0,1,39,936,-853,1789,-270,-182,-88,324.3818181818182,55,1,14,1817,WR,0
0,1,0,726,562,164,-243,-273,30,100.75,16,0,3,166,WR,0
0,1,25,1006,-1391,2397,-249,-204,-45,386.5,62,1,6,2402,RB,0
0,1,1,1336,420,916,-178,-179,1,149.98461538461538,65,0,82,987,TE,0
0,1,0,1247,806,441,-189,-291,102,346.15384615384613,13,0,4,459,WR,0
0,1,0,1028,31,997,-204,-583,379,331.2093023255814,43,0,152,1144,RB,0
0,1,0,1348,885,463,-192,-220,28,242.8421052631579,19,0,22,455,TE,0
0,1,0,1467,-363,1830,-170,-271,101,486.7631578947368,38,1,4,1838,WR,0
0,1,0,770,-1218,1988,-227,-243,16,292.231884057971,69,1,0,1985,WR,0
0,1,0,1336,454,882,-173,-165,-8,221.475,40,0,0,881,TE,0
0,1,18,1161,246,915,-283,-437,154,171.91549295774647,71,0,131,1029,RB,0
0,1,14,719,-1286,2005,-193,-182,-11,306.1384615384615,65,1,0,1979,WR,0
0,1,0,983,-1077,2060,-284,-211,-73,356.3965517241379,58,1,6,2062,WR,0
0,1,0,895,-385,1280,208,36,172,386.8888888888889,36,1,42,1321,WR,0
0,1,0,242,203,39,-510,-503,-7,207.2,85,0,807,853,RB,1
0,1,0,688,481,207,-241,-294,53,219.37037037037038,27,0,183,404,WR,1
0,1,10,752,-922,1674,-250,-169,-81,314.1132075471698,53,1,4,1668,WR,0
0,1,0,1287,851,436,-229,-242,13,281.6666666666667,15,0,2,439,WR,0
0,1,0,1347,600,747,-207,-207,0,280.55555555555554,27,0,5,749,TE,0
0,1,0,1093,772,321,-185,-193,8,102.46153846153847,39,0,47,366,WR,0
0,1,0,468,-476,944,-242,-236,-6,443.0,22,1,0,944,TE,0
0,1,0,776,-1495,2271,-203,-311,108,431.33962264150944,53,1,2,2269,WR,0
0,1,0,236,-307,543,-464,-453,-11,214.76923076923077,26,1,0,538,RB,0
0,1,0,744,-1405,2149,-200,-332,132,408.9811320754717,53,1,6,2155,WR,0
0,1,6,709,413,296,-195,-325,130,163.65,20,0,21,313,TE,0
0,1,0,649,-403,1052,-271,-196,-75,313.29411764705884,34,1,5,1054,TE,0
0,1,0,727,776,-49,-262,-325,63,121.04,25,0,161,99,WR,1
0,1,0,794,-584,1378,-152,85,-237,309.60869565217394,46,1,4,1401,WR,0
0,1,0,340,-657,997,-291,-214,-77,264.9230769230769,39,1,0,999,WR,0
0,1,0,252,-572,824,-477,-37,-440,252.88235294117646,34,1,2,813,TE,0
0,1,0,455,148,307,-190,-159,-31,263.5,12,0,4,311,TE,0
0,1,0,234,-747,981,-610,-505,-105,430.1666666666667,24,1,8,1008,RB,0
0,1,0,543,-234,777,-236,-311,75,385.5238095238095,21,1,20,802,FB,0
0,1,0,3,185,-182,-460,-468,8,124.35714285714286,14,0,182,22,FB,0
0,1,14,679,-526,1205,-238,-219,-19,253.6326530612245,49,1,10,1221,FB,0
0,1,41,603,-470,1073,-266,-182,-84,246.6590909090909,44,1,11,1072,TE,0
0,1,0,1086,756,330,-251,-280,29,296.72727272727275,11,0,6,339,WR,0
0,1,0,720,-439,1159,-239,-222,-17,276.95238095238096,42,1,2,1164,TE,0
0,1,8,545,-328,873,-216,-153,-63,273.5625,32,1,10,874,TE,0
0,1,33,179,-478,657,-274,-118,-156,320.2857142857143,21,1,2,655,TE,0
0,1,39,1025,895,130,-31,-58,27,79.8125,16,0,28,138,WR,1
0,1,0,1125,519,606,-206,-362,156,375.11764705882354,17,0,23,607,WR,0
0,1,0,181,-501,682,-498,-228,-270,247.96875,32,1,18,702,RB,0
0,1,46,586,-510,1096,-246,-172,-74,262.85714285714283,42,1,2,1112,TE,0
0,1,2,1092,537,555,-247,-246,-1,200.5185185185185,27,0,2,549,TE,0
0,1,9,1047,-785,1832,-160,-179,19,394.40425531914894,47,1,9,1839,WR,0
0,1,59,664,-498,1162,-239,-157,-82,317.3421052631579,38,1,16,1181,TE,0
0,1,35,99,1337,-1238,-680,-167,-513,370.4871794871795,39,0,1244,10,WR,0
0,1,0,445,355,90,-195,-253,58,161.0,24,0,147,238,TE,1
0,1,0,219,-463,682,-432,-154,-278,259.73333333333335,30,1,11,698,TE,0
0,1,6,217,-229,446,-514,-495,-19,198.95652173913044,23,1,2,452,RB,0
0,1,0,674,-694,1368,-239,-107,-132,335.3658536585366,41,1,10,1386,TE,0
0,1,0,482,275,207,-238,-296,58,200.3846153846154,13,0,2,217,FB,0
0,1,0,1486,546,940,-239,-244,5,337.0,28,0,6,938,WR,0
0,1,0,811,-816,1627,-260,-234,-26,432.8421052631579,38,1,7,1644,WR,0
0,1,0,1019,1470,-451,-255,-119,-136,227.04545454545453,22,0,451,5,WR,0
1,1,36,602,1314,-712,-90,-118,28,199.64864864864865,37,0,726,21,WR,0
1,1,43,136,-263,399,-579,-576,-3,123.46875,32,1,2,410,RB,0
0,1,0,284,-308,592,-513,-549,36,377.875,16,1,2,582,RB,0
0,1,0,734,275,459,-209,-290,81,312.3333333333333,15,0,4,456,WR,0
0,1,10,1303,467,836,-329,-68,-261,181.4,50,0,33,857,TE,0
0,1,64,39,-189,228,-590,-422,-168,147.72222222222223,18,1,6,253,RB,0
0,1,28,508,-738,1246,-293,-42,-251,361.86842105263156,38,1,15,1260,WR,0
0,1,16,6,1,5,-743,-750,7,102.0,44,0,64,80,RB,1
0,1,24,1126,857,269,-237,-142,-95,177.67857142857142,28,0,100,368,WR,1
0,1,0,966,205,761,-130,-311,181,374.6666666666667,21,0,8,774,WR,0
0,1,6,777,-886,1663,-249,-157,-92,244.64473684210526,76,1,77,1749,WR,0
0,1,63,747,-602,1349,-108,-254,146,280.2692307692308,52,1,43,1384,WR,0
0,1,0,969,509,460,-228,-343,115,303.05882352941177,17,0,16,468,WR,0
0,1,0,1107,-690,1797,-231,-69,-162,344.22641509433964,53,1,0,1808,WR,0
0,1,51,876,961,-85,-179,-149,-30,247.58333333333334,48,0,664,574,WR,1
0,1,0,767,35,732,-195,-267,72,405.89473684210526,19,0,6,758,WR,0
1,1,0,431,-192,623,-109,-430,321,180.6829268292683,41,1,16,649,FB,0
1,1,7,737,-415,1152,-226,-71,-155,352.05555555555554,36,1,30,1177,WR,0
1,1,11,7,-494,501,-461,-112,-349,179.44444444444446,36,1,14,523,TE,0
0,1,0,536,-488,1024,-180,-187,7,277.8918918918919,37,1,1,1026,TE,0
0,1,0,310,-669,979,-488,-131,-357,384.5769230769231,52,1,468,1431,RB,1
0,1,0,845,193,652,-269,-454,185,449.1875,16,0,1,650,RB,0
0,1,0,890,470,420,-191,-569,378,347.05882352941177,17,0,7,423,WR,0
0,1,18,262,234,28,-535,-475,-60,156.04651162790697,43,0,138,167,RB,1
0,1,3,423,-409,832,-242,-201,-41,257.25,32,1,6,823,FB,0
0,1,52,266,-1536,1802,-496,-192,-304,398.4375,48,1,36,1818,RB,0
0,1,19,195,534,-339,-484,-144,-340,165.32,25,0,337,2,RB,0
0,1,1,551,534,17,-205,-147,-58,44.888888888888886,9,0,7,23,TE,1
0,1,4,729,-470,1199,-264,-171,-93,318.13513513513516,37,1,3,1202,WR,0
0,1,0,590,-1,591,-233,-481,248,249.84615384615384,26,1,16,620,RB,0
0,1,1,519,-340,859,-229,-194,-35,313.2962962962963,27,1,7,876,TE,0
0,1,49,541,-3,544,-207,-454,247,236.48,25,1,27,543,RB,0
0,1,0,897,-740,1637,-175,-150,-25,401.5365853658537,41,1,15,1638,WR,0
0,1,0,490,415,75,-136,38,-174,102.5,4,0,29,2,WR,0
0,1,0,445,511,-66,-148,0,-148,65.16666666666667,6,0,0,31,TE,0
0,1,0,11,-50,61,-650,-483,-167,56.857142857142854,7,0,47,4,RB,0
0,1,0,832,-1193,2025,-200,-225,25,469.7674418604651,43,1,5,2024,TE,0
0,1,33,1244,-283,1527,-326,-420,94,360.89130434782606,46,1,2,1541,RB,0
0,1,50,237,-1574,1811,-478,-101,-377,404.5652173913044,46,1,2,1831,RB,0
0,1,0,889,78,811,-139,-603,464,342.3421052631579,38,0,163,960,WR,0
0,1,0,732,-289,1021,-266,-304,38,491.3809523809524,21,1,2,1031,WR,0
0,1,2,410,-1039,1449,-304,-178,-126,337.9111111111111,45,1,6,1525,WR,0
0,1,56,593,-231,824,-340,-361,21,246.35135135135135,37,1,10,815,RB,0
0,1,13,553,-503,1056,-186,-203,17,287.5135135135135,37,1,11,1063,TE,0
0,1,61,780,290,490,-425,-427,2,266.6842105263158,19,0,15,482,RB,0
0,1,0,1524,1135,389,-222,-212,-10,183.14285714285714,21,0,0,388,TE,0
0,1,73,1309,307,1002,-246,-371,125,251.1904761904762,42,0,4,1036,RB,0
0,1,0,1177,619,558,-266,-118,-148,231.82608695652175,23,0,0,548,TE,0
0,1,5,1245,456,789,-211,-134,-77,247.8709677419355,31,0,1,788,TE,0
0,1,0,513,-832,1345,-195,-153,-42,334.8,40,1,2,1352,TE,0
0,1,0,739,-212,951,-272,-250,-22,465.42857142857144,21,1,4,959,WR,0
0,1,0,679,-774,1453,-322,-145,-177,263.69354838709677,62,1,31,1477,TE,0
0,1,24,1043,213,830,-353,-317,-36,254.35897435897436,39,0,51,882,RB,0
0,1,0,1627,882,745,-242,-239,-3,385.42857142857144,21,0,35,787,WR,0
1,1,45,1182,1168,14,-85,-43,-42,33.0,1,0,14,18,WR,1
1,1,36,1412,1501,-89,-135,-4,-131,108.8,10,0,82,8,TE,0
0,1,21,262,495,-233,-472,-223,-249,147.6315789473684,19,0,244,10,RB,0
0,1,0,478,-164,642,-268,-333,65,339.2352941176471,34,1,261,898,WR,1
0,1,0,1081,854,227,-237,-687,450,331.62068965517244,29,0,281,500,WR,1
0,1,13,738,-896,1634,-265,-179,-86,370.6136363636364,44,1,2,1633,WR,0
0,1,47,1340,472,868,-257,-220,-37,206.1219512195122,41,0,16,875,TE,0
0,1,21,674,840,-166,-88,25,-113,71.19047619047619,21,0,184,3,TE,0
0,1,0,1048,-257,1305,-315,-326,11,470.85714285714283,28,1,5,1307,WR,0
0,1,0,477,-514,991,-204,-153,-51,278.64864864864865,37,1,6,1005,TE,0
0,1,25,744,746,-2,-228,-238,10,28.0,1,0,5,10,FB,1
0,1,0,69,291,-222,-284,-289,5,408.74,50,0,1106,891,TE,1
0,1,0,1041,739,302,-174,-414,240,165.24,25,0,16,306,RB,0
0,1,10,2009,1209,800,-134,-170,36,225.27777777777777,36,0,10,808,WR,0
0,1,0,31,177,-146,-328,-450,122,224.75,8,0,177,11,FB,0
0,1,17,334,501,-167,-260,-84,-176,165.84615384615384,13,0,184,32,FB,0
0,1,0,954,-198,1152,-268,-259,-9,445.65384615384613,26,1,2,1154,WR,0
0,1,0,518,469,49,-222,-262,40,95.71428571428571,7,0,19,65,TE,1
0,1,8,534,190,344,-216,-375,159,146.14705882352942,34,0,28,371,TE,0
0,1,0,487,-384,871,-183,-152,-31,182.37254901960785,51,1,31,903,TE,0
0,1,0,560,296,264,-196,-175,-21,140.05555555555554,18,0,8,265,FB,0
0,1,0,545,262,283,-188,-225,37,152.86363636363637,22,0,49,349,FB,0
0,1,0,883,156,727,-257,-267,10,372.40983606557376,61,0,779,1512,TE,1
0,1,0,397,445,-48,-85,-95,10,54.333333333333336,33,0,158,111,TE,1
0,1,0,3,54,-51,-709,-668,-41,127.76923076923077,13,0,118,64,RB,1
0,1,0,429,392,37,-164,-54,-110,48.833333333333336,6,0,2,37,TE,0
0,1,0,493,300,193,-199,-120,-79,127.57894736842105,19,0,31,270,FB,0
0,1,12,811,1724,-913,-191,-163,-28,290.9375,32,0,918,13,TE,0
0,1,0,375,-526,901,-265,-152,-113,225.52272727272728,44,1,36,955,TE,0
0,1,5,658,-1216,1874,-129,-110,-19,276.73333333333335,75,1,68,2012,WR,0
0,1,7,782,-246,1028,-265,-444,179,169.50746268656715,67,1,96,1044,WR,0
0,1,0,244,284,-40,-403,-425,22,49.935483870967744,31,0,109,70,FB,1
0,1,0,1204,638,566,-194,-312,118,450.53846153846155,13,0,12,581,WR,0
0,1,0,522,-453,975,-355,-118,-237,254.17073170731706,41,1,30,1013,WR,0
0,1,0,462,62,400,-183,-238,55,259.75,16,0,22,402,TE,0
0,1,33,411,-581,992,-330,-138,-192,235.95454545454547,44,1,20,1002,WR,0
0,1,24,1625,291,1334,-223,-451,228,292.96,50,0,36,1408,RB,0
0,1,0,473,-1052,1525,-256,-89,-167,401.81081081081084,37,1,7,1490,WR,0
0,1,20,243,545,-302,-526,-245,-281,125.8,35,0,293,2,RB,0
0,1,5,495,1140,-645,-403,-176,-227,193.6216216216216,37,0,648,2,RB,0
0,1,0,283,-676,959,-291,-207,-84,307.9375,32,1,0,959,TE,0
1,1,0,439,-317,756,-194,-503,309,165.9607843137255,51,1,4,759,FB,0
1,1,0,32,229,-197,-748,-526,-222,101.76666666666667,30,0,242,49,RB,1
0,1,0,763,526,237,274,-265,539,223.6,10,0,3,234,TE,0
0,1,0,548,-184,732,-224,-280,56,217.82857142857142,35,1,45,760,FB,0
0,1,0,840,-369,1209,-311,-315,4,507.9166666666667,24,1,2,1221,FB,0
0,1,0,388,365,23,-71,-87,16,61.878787878787875,33,0,138,165,TE,1
0,1,0,492,-621,1113,-238,-170,-68,188.2173913043478,69,1,16,1129,TE,0
0,1,0,873,-226,1099,-205,-356,151,363.7096774193548,31,1,10,1101,WR,0
0,1,0,920,126,794,-215,-468,253,204.48214285714286,56,0,149,939,FB,0
0,1,0,517,149,368,-196,-249,53,282.46666666666664,15,0,15,408,TE,0
0,1,0,276,-392,668,-483,-168,-315,247.3125,32,1,22,723,FB,0
0,1,0,1900,1008,892,-185,-146,-39,250.8108108108108,37,0,0,890,WR,0
0,1,51,737,-528,1265,-286,-260,-26,301.780487804878,41,1,6,1275,WR,0
0,1,0,77,-225,302,-646,-630,-16,150.6818181818182,22,1,20,312,RB,0
0,1,0,494,-433,927,-133,-143,10,234.9512195121951,41,1,27,947,TE,0
0,1,0,468,-499,967,-229,-244,15,238.38095238095238,42,1,35,1006,TE,0
0,1,0,598,254,344,-220,-503,283,193.73076923076923,26,0,36,370,RB,0
0,1,0,1676,1647,29,-123,-121,-2,40.5,2,0,6,31,RB,1
0,1,0,435,-361,796,-228,-281,53,284.76666666666665,30,1,37,843,FB,0
0,1,0,780,-174,954,-278,-271,-7,438.1363636363636,22,1,2,963,TE,0
0,1,0,730,-157,887,-224,-277,53,345.9230769230769,26,1,8,887,TE,0
0,1,0,851,171,680,-202,-337,135,359.22222222222223,18,0,9,608,WR,0
0,1,0,345,-419,764,-233,-239,6,275.42424242424244,33,1,36,883,TE,0
0,1,0,320,711,-391,-279,-276,-3,237.95348837209303,43,0,684,290,WR,1
0,1,0,743,1392,-649,-240,25,-265,177.45945945945945,37,0,662,6,TE,0
0,1,50,506,195,311,-479,-353,-126,197.11764705882354,17,0,2,327,RB,0
0,1,4,539,-1066,1605,-133,-304,171,303.3018867924528,53,1,24,1624,TE,0
0,1,0,467,386,81,-258,-264,6,165.6,5,0,4,100,FB,0
0,1,14,446,-576,1022,-274,-167,-107,216.9375,48,1,16,1047,TE,0
0,1,0,496,183,313,-186,-258,72,278.53846153846155,13,0,21,346,TE,0
0,1,0,783,-93,876,-193,-296,103,434.1363636363636,22,1,5,926,WR,0
0,1,0,809,469,340,-276,-287,11,318.1818181818182,11,0,8,354,FB,0
0,1,0,507,253,254,-178,-249,71,83.96666666666667,30,0,35,269,TE,0
0,1,0,315,-147,462,-442,-368,-74,165.61290322580646,31,1,31,488,RB,0
0,1,0,555,370,185,-147,-93,-54,58.61290322580645,31,0,27,207,TE,0
0,1,0,426,404,22,-22,51,-73,35.45454545454545,22,0,78,97,TE,1
0,1,6,1165,-598,1763,-96,-164,68,359.8627450980392,51,1,25,1803,WR,0
0,1,17,468,-554,1022,-230,-187,-43,210.2,50,1,1,1024,TE,0
0,1,53,123,258,-135,-617,-551,-66,132.41666666666666,12,0,153,8,RB,0
0,1,1,38,-610,648,-233,-205,-28,235.51724137931035,29,1,16,648,TE,0
0,1,0,483,129,354,-183,-322,139,351.8636363636364,66,0,957,1306,TE,1
0,1,0,951,597,354,-308,-291,-17,165.04,50,0,235,604,FB,1
0,1,0,1050,529,521,-320,-166,-154,337.8,15,0,21,477,WR,0
0,1,12,524,-683,1207,-140,-175,35,232.28301886792454,53,1,4,1227,TE,0
0,1,0,804,-285,1089,-264,-378,114,454.15384615384613,26,1,34,1122,WR,0
0,1,10,54,1173,-1119,-284,-217,-67,281.8292682926829,41,0,1131,4,WR,0
0,1,21,1247,214,1033,-140,-573,433,249.0,46,0,36,1071,RB,0
0,1,0,1402,616,786,-191,-163,-28,195.6341463414634,41,0,9,798,TE,0
0,1,0,1019,618,401,-160,-223,63,308.92857142857144,14,0,14,408,RB,0
0,1,0,969,556,413,-144,-94,-50,184.3181818181818,22,0,8,407,TE,0
0,1,1,637,-562,1199,-157,-171,14,224.53703703703704,54,1,24,1219,TE,0
1,1,29,787,-539,1326,-201,-76,-125,309.6818181818182,44,1,13,1328,TE,0
1,1,32,913,-1195,2108,-150,-176,26,402.8679245283019,53,1,5,2118,WR,0
0,1,0,980,390,590,-184,-267,83,410.8,15,0,6,602,RB,0
0,1,9,639,-514,1153,-255,-210,-45,227.6,50,1,10,1161,TE,0
0,1,0,972,34,938,-158,-253,95,502.3157894736842,19,0,2,942,RB,0
0,1,0,1088,387,701,-169,-449,280,429.7368421052632,19,0,7,722,WR,0
0,1,36,607,-443,1050,-184,-182,-2,246.41463414634146,41,1,13,1072,TE,0
0,1,0,588,-657,1245,-214,-245,31,375.7878787878788,33,1,31,1266,TE,0
0,1,12,866,-729,1595,-238,-236,-2,335.27659574468083,47,1,14,1584,WR,0
0,1,1,440,-480,920,-186,-197,11,280.54545454545456,33,1,0,921,TE,0
0,1,25,1515,743,772,-169,-170,1,234.0,32,0,7,771,WR,0
0,1,0,599,264,335,-176,-248,72,181.47368421052633,19,0,12,346,TE,0
0,1,0,1015,480,535,-136,-221,85,392.5,14,0,4,532,WR,0
0,1,0,1053,456,597,-206,-731,525,447.7692307692308,52,0,787,1388,RB,1
0,1,0,268,-153,421,-513,-553,40,317.6923076923077,13,1,20,412,RB,0
0,1,14,402,-528,930,-244,-127,-117,324.3,30,1,1,929,TE,0
0,1,0,557,601,-44,-106,-91,-15,31.6,15,0,83,39,TE,1
0,1,33,1454,277,1177,-239,-398,159,286.83720930232556,43,0,14,1198,RB,0
0,1,0,526,457,69,-56,-71,15,40.69444444444444,36,0,67,138,TE,1
0,1,0,790,-801,1591,-186,-185,-1,451.65714285714284,35,1,6,1595,WR,0
0,1,28,1264,432,832,-157,-197,40,254.78125,32,0,10,856,TE,0
0,1,0,986,516,470,-198,-343,145,347.8,15,0,10,485,WR,0
0,1,0,198,-1877,2075,-552,-116,-436,338.5483870967742,62,1,12,2060,RB,0
0,1,0,265,-865,1130,-512,-203,-309,243.35294117647058,51,1,33,1178,RB,0
0,1,0,634,-1227,1861,-239,-98,-141,409.7173913043478,46,1,8,1856,WR,0
0,1,0,705,-941,1646,-171,-149,-22,341.1041666666667,48,1,0,1649,WR,0
0,1,0,1196,505,691,-174,39,-213,233.96774193548387,31,0,31,731,TE,0
0,1,0,798,371,427,-196,-419,223,178.75862068965517,29,0,11,437,RB,0
1,1,8,415,-667,1082,-218,-132,-86,250.04347826086956,46,1,38,1126,TE,0
1,1,19,952,-555,1507,-177,-169,-8,353.74418604651163,43,1,4,1509,WR,0
0,1,28,8,468,-460,-441,-188,-253,159.80555555555554,36,0,486,28,TE,0
0,1,0,575,-60,635,-174,-253,79,271.1666666666667,24,1,22,654,TE,0
0,1,0,56,581,-525,-262,-63,-199,139.80769230769232,52,0,589,60,TE,0
1,1,0,585,-910,1495,-291,-116,-175,298.34615384615387,52,1,1,1495,TE,0
0,1,5,115,-820,935,-368,-164,-204,245.56410256410257,39,1,0,927,RB,0
0,1,1,864,-1091,1955,-187,-73,-114,427.1521739130435,46,1,2,1962,WR,0
1,1,15,660,667,-7,-132,-33,-99,58.875,8,0,16,13,TE,1
0,1,12,1340,559,781,-153,-77,-76,237.87878787878788,33,0,10,784,TE,0
0,1,4,1219,-1134,2353,-191,-164,-27,483.44897959183675,49,1,2,2356,WR,0
0,1,27,521,-477,998,-209,-124,-85,281.9166666666667,36,1,5,1019,TE,0
0,1,0,601,-589,1190,-223,-215,-8,329.4166666666667,36,1,12,1211,TE,0
0,1,23,510,498,12,-191,-187,-4,40.0,4,0,27,38,TE,1
0,1,17,138,-444,582,-507,-160,-347,226.46428571428572,28,1,17,578,TE,0
0,1,0,808,-1017,1825,-210,-237,27,406.3777777777778,45,1,0,1824,WR,0
0,1,0,1008,-771,1779,-172,-229,57,400.64444444444445,45,1,2,1786,WR,0
0,1,39,765,782,-17,-165,-169,4,38.0,2,0,22,2,WR,0
0,1,11,190,-584,774,-509,-188,-321,289.43333333333334,30,1,12,789,RB,0
0,1,0,568,600,-32,-172,-83,-89,53.25,20,0,74,50,TE,1
0,1,0,172,542,-370,-251,-52,-199,138.5,36,0,398,26,TE,0
0,1,0,454,82,372,-174,-197,23,294.1666666666667,12,0,7,333,TE,0
0,1,0,960,-1002,1962,-264,-156,-108,489.975,40,1,4,1957,WR,0
0,1,0,881,-470,1351,-154,-152,-2,341.05,40,1,8,1362,TE,0
0,1,11,630,-442,1072,-236,-114,-122,366.6,30,1,4,1085,TE,0
0,1,17,188,-598,786,-516,-152,-364,244.97142857142856,35,1,6,808,RB,0
0,1,0,634,-531,1165,-149,-151,2,212.82758620689654,58,1,8,1174,TE,0
0,1,0,252,-736,988,-231,-131,-100,445.69565217391306,23,1,0,989,TE,0
0,1,0,527,-551,1078,-227,-195,-32,246.48888888888888,45,1,11,1088,TE,0
0,1,0,968,369,599,-222,-279,57,392.9375,16,0,8,619,RB,0
0,1,36,1389,1333,56,-166,-124,-42,70.29629629629629,27,0,52,135,WR,1
0,1,0,722,-385,1107,-246,-227,-19,473.95652173913044,23,1,2,1082,WR,0
0,1,11,1278,530,748,-192,-178,-14,236.96774193548387,31,0,4,747,TE,0
0,1,0,1664,906,758,-284,-121,-163,225.6969696969697,33,0,2,727,TE,0
1,1,2,360,657,-297,-272,-46,-226,116.77142857142857,35,0,340,46,TE,0
1,1,0,438,-521,959,-329,-96,-233,331.51612903225805,31,1,22,983,WR,0
0,1,4,470,-554,1024,-252,-176,-76,319.030303030303,33,1,1,1022,TE,0
1,1,46,1008,1319,-311,-104,16,-120,124.22222222222223,27,0,336,8,WR,0
1,1,2,1341,268,1073,-269,-355,86,231.5531914893617,47,0,3,1054,RB,0
0,1,2,222,-2012,2234,-397,-46,-351,433.3018867924528,53,1,13,2260,WR,0
0,1,0,685,634,51,-172,-161,-11,52.36363636363637,11,0,7,59,TE,0
0,1,0,542,-551,1093,-273,-66,-207,299.3783783783784,37,1,30,1111,TE,0
0,1,5,158,-581,739,-480,-79,-401,211.2051282051282,39,1,5,763,RB,0
0,1,48,484,-494,978,-205,-169,-36,233.27906976744185,43,1,18,971,TE,0
0,1,0,1462,910,552,-108,-137,29,207.75,28,0,4,588,WR,0
0,1,0,963,326,637,-192,-160,-32,243.1951219512195,41,0,198,800,WR,1
0,1,0,472,-163,635,-181,-266,85,321.2916666666667,24,1,71,694,TE,0
1,1,41,707,-821,1528,-184,-66,-118,310.078431372549,51,1,12,1552,WR,0
1,1,76,1785,491,1294,-159,-141,-18,305.72093023255815,43,0,41,1316,TE,0
1,1,29,833,973,-140,-88,-166,78,78.9375,32,0,172,24,WR,0
0,1,33,0,-586,586,-520,-181,-339,232.71428571428572,28,0,6,608,TE,0
0,1,42,1204,-214,1418,-357,-447,90,339.3636363636364,44,1,34,1429,RB,0
0,1,0,1050,-459,1509,-211,-305,94,477.4375,32,1,13,1512,WR,0
0,1,5,747,-519,1266,-218,-127,-91,314.5365853658537,41,1,14,1284,TE,0
0,1,0,503,46,457,-202,-187,-15,314.8157894736842,38,0,367,826,TE,1
0,1,16,10,3,7,-796,-674,-122,171.32692307692307,52,0,113,76,RB,1
0,1,13,804,-466,1270,-200,-227,27,227.64835164835165,91,1,407,1645,WR,1
0,1,0,835,-760,1595,-210,-137,-73,354.31111111111113,45,1,3,1598,WR,0
0,1,44,533,-508,1041,-256,-171,-85,305.75,36,1,23,1083,WR,0
0,1,0,810,-801,1611,-244,-227,-17,356.9555555555556,45,1,3,1610,WR,0
0,1,0,602,374,228,-62,-187,125,128.38636363636363,44,0,133,344,TE,1
1,1,23,17,579,-562,-466,-3,-463,193.34883720930233,43,0,647,66,TE,0
0,1,0,206,-188,394,-554,-526,-28,126.61290322580645,31,1,9,409,RB,0
0,1,13,36,-910,946,-257,-83,-174,281.24242424242425,33,1,4,950,WR,0
0,1,0,858,-278,1136,-199,-286,87,441.12307692307695,65,1,868,2027,WR,1
0,1,16,39,-567,606,-283,-71,-212,281.1304347826087,23,1,2,609,TE,0
0,1,0,568,521,47,-172,-137,-35,97.6,5,0,9,56,TE,0
0,1,32,191,-240,431,-556,-373,-183,145.96666666666667,30,1,10,455,RB,0
0,1,55,233,-813,1046,-364,-90,-274,284.3,40,1,2,1060,TE,0
0,1,0,468,254,214,-228,-320,92,125.53333333333333,30,0,90,287,TE,1
0,1,22,869,253,616,-187,-411,224,214.86666666666667,30,0,2,618,WR,0
0,1,0,571,-1254,1825,-250,-216,-34,313.86206896551727,58,1,10,1834,WR,0
0,1,0,560,399,161,-148,-200,52,248.21951219512195,41,0,443,600,TE,1
0,1,23,1875,-487,2362,-246,-156,-90,419.55357142857144,56,1,5,2355,TE,0
1,1,39,28,1676,-1648,-715,57,-772,356.9183673469388,49,0,1663,8,RB,0
1,1,45,1327,860,467,-67,113,-180,110.6046511627907,43,0,11,472,WR,0
1,1,41,612,2066,-1454,-112,46,-158,314.82608695652175,46,0,1457,13,TE,0
1,1,27,487,1260,-773,-96,46,-142,203.8108108108108,37,0,781,20,TE,0
0,1,0,502,-446,948,-309,3,-312,252.47619047619048,42,1,26,1012,TE,0
0,1,0,1335,-1715,3050,-156,-177,21,427.2716049382716,81,1,240,3281,WR,0
1,1,120,517,1002,-485,-48,-42,-6,154.03125,32,0,499,30,TE,0
0,1,0,527,-479,1006,-262,-247,-15,272.94594594594594,37,1,4,1013,TE,0
0,1,37,161,459,-298,-270,-91,-179,156.9047619047619,21,0,305,16,TE,0
0,1,0,498,501,-3,-200,-218,18,155.36363636363637,33,0,265,254,TE,1
0,1,0,477,337,140,-264,-319,55,113.8076923076923,26,0,90,236,TE,1
0,1,28,149,267,-118,-586,-447,-139,108.5,18,0,124,9,RB,0
0,1,12,743,243,500,-178,-485,307,208.42857142857142,28,0,7,511,WR,0
0,1,18,337,-514,851,-309,-132,-177,302.43333333333334,30,1,6,846,TE,0
0,1,0,599,524,75,-168,-189,21,112.16666666666667,6,0,18,77,TE,1
1,1,40,1047,1158,-111,-222,-214,-8,55.9,20,0,129,9,WR,0
0,1,55,182,203,-21,-487,-424,-63,35.5,2,0,2,13,RB,0
0,1,0,1260,328,932,-209,-297,88,495.5263157894737,19,0,9,925,WR,0
0,1,0,815,269,546,-241,-265,24,378.6666666666667,15,0,6,559,WR,0
0,1,23,1434,248,1186,-288,-486,198,235.92592592592592,54,0,44,1216,RB,0
0,1,0,778,376,402,-113,-557,444,288.4761904761905,21,0,7,419,WR,0
0,1,0,298,377,-79,-234,-203,-31,206.9090909090909,22,0,253,174,TE,1
0,1,1,427,-395,822,-252,-248,-4,293.3448275862069,29,1,19,844,TE,0
0,1,0,862,474,388,-202,-235,33,279.35714285714283,14,0,13,412,WR,0
0,1,18,461,-511,972,-229,-73,-156,246.3658536585366,41,1,15,992,TE,0
0,1,22,1405,554,851,-189,-122,-67,173.08163265306123,49,0,9,863,WR,0
0,1,17,462,262,200,-233,-321,88,167.16666666666666,30,0,158,348,TE,1
0,1,0,1115,281,834,-211,-315,104,239.77142857142857,35,0,16,840,WR,0
0,1,0,1030,-217,1247,-189,-339,150,325.6666666666667,39,1,32,1276,TE,0
0,1,34,1385,1402,-17,-80,-34,-46,42.0,1,0,15,9,TE,1
1,1,25,923,1272,-349,-220,-161,-59,269.2142857142857,14,0,350,2,TE,0
1,1,37,906,913,-7,-83,-74,-9,39.5,2,0,7,3,WR,1
0,1,9,242,1473,-1231,-425,-67,-358,308.8536585365854,41,0,1230,1,RB,0
0,1,11,766,-473,1239,-227,-134,-93,277.9148936170213,47,1,15,1258,WR,0
0,1,32,787,-412,1199,-204,-195,-9,279.6818181818182,44,1,14,1222,WR,0
0,1,31,620,623,-3,-196,-195,-1,38.0,1,0,2,6,WR,1
1,1,57,0,1674,-1674,-644,-11,-633,382.5,46,0,1676,20,RB,0
1,1,68,789,716,73,-178,21,-199,70.48648648648648,37,0,44,96,TE,1
1,1,65,1340,869,471,-70,18,-88,141.46875,32,0,2,488,WR,0
1,1,58,563,1980,-1417,-167,-76,-91,346.275,40,0,1441,13,TE,0
1,1,65,454,1241,-787,-116,-66,-50,225.44117647058823,34,0,802,4,TE,0
0,1,19,477,-477,954,-285,-114,-171,270.7567567567568,37,1,7,957,TE,0
0,1,0,578,539,39,-190,-192,2,135.0,2,0,5,31,TE,0
0,1,0,614,-408,1022,-129,-162,33,300.7352941176471,34,1,6,1024,TE,0
0,1,42,483,-380,863,-198,-230,32,233.54054054054055,37,1,2,877,TE,0
0,1,10,246,-1724,1970,-583,-18,-565,393.8076923076923,52,1,12,1983,RB,0
0,1,0,1482,523,959,-209,-240,31,280.77142857142854,35,0,28,991,TE,0
0,1,24,221,945,-724,-526,-151,-375,203.28947368421052,38,0,730,2,RB,0
0,1,0,407,-13,420,-234,-439,205,169.63333333333333,30,1,37,460,TE,0
0,1,2,1248,-1367,2615,-206,-69,-137,443.33898305084745,59,1,16,2619,WR,0
0,1,0,455,-449,904,-238,-193,-45,196.625,56,1,97,1000,TE,0
0,1,0,170,17,153,-592,-614,22,160.58333333333334,12,0,42,198,RB,1
0,1,0,530,264,266,-148,-221,73,349.125,8,0,10,278,WR,0
0,1,0,484,-430,914,-222,-218,-4,208.54761904761904,42,1,5,914,TE,0
0,1,0,1532,283,1249,-99,-546,447,317.6279069767442,43,0,15,1264,WR,0
0,1,0,605,483,122,-227,-190,-37,233.75555555555556,45,0,472,593,TE,1
0,1,0,984,631,353,-176,-253,77,208.55555555555554,18,0,12,352,WR,0
0,1,0,478,-393,871,-231,-258,27,225.94871794871796,39,1,15,887,TE,0
0,1,0,758,565,193,-174,-294,120,267.3333333333333,9,0,17,201,WR,0
0,1,5,1497,-526,2023,-231,-188,-43,420.9791666666667,48,1,2,2017,TE,0
0,1,0,1016,-1017,2033,-162,-253,91,514.8,40,1,2,2034,WR,0
0,1,8,1385,638,747,-329,-243,-86,225.9090909090909,33,0,3,748,TE,0
0,1,1,1506,-357,1863,-165,-257,92,389.5833333333333,48,1,19,1886,TE,0
0,1,0,724,497,227,-94,-280,186,273.45454545454544,11,0,16,230,WR,0
0,1,8,504,792,-288,-295,-158,-137,218.6875,16,0,295,4,WR,0
0,1,0,514,-799,1313,-175,-115,-60,323.6666666666667,42,1,12,1326,WR,0
1,1,14,562,-1438,2000,-187,-105,-82,406.18367346938777,49,1,2,1991,TE,0
1,1,34,14,216,-202,-743,-515,-228,114.24,25,0,220,17,RB,0
0,1,7,1465,609,856,-210,-202,-8,246.85294117647058,34,0,1,853,TE,0
0,1,12,1395,546,849,-228,-222,-6,250.02941176470588,34,0,16,862,TE,0
1,1,0,143,520,-377,-264,-152,-112,201.30434782608697,23,0,403,38,TE,0
1,1,0,54,-358,412,-340,-183,-157,137.1219512195122,41,1,80,484,TE,0
0,1,0,867,-639,1506,-86,-217,131,362.06666666666666,45,1,4,1525,WR,0
1,1,0,6,-483,489,-260,-146,-114,167.025,40,1,68,555,TE,0
1,1,0,138,-396,534,-257,-228,-29,213.86206896551724,29,1,51,585,TE,0
0,1,0,871,-741,1612,-77,-262,185,344.5882352941176,51,1,16,1636,WR,0
0,1,0,347,-728,1075,-268,-157,-111,345.45454545454544,33,1,15,1077,WR,0
0,1,4,1430,198,1232,-163,-547,384,254.66,50,0,17,1247,RB,0
0,1,0,197,200,-3,-538,-159,-379,53.625,16,0,52,54,RB,1
0,1,0,1800,1922,-122,-76,298,-374,120.27777777777777,18,0,154,36,WR,1
0,1,42,207,-628,835,-222,-201,-21,322.18518518518516,27,1,21,848,TE,0
1,1,0,420,-556,976,-111,-201,90,256.0232558139535,43,1,27,1003,TE,0
0,1,0,485,-376,861,-216,-109,-107,213.08163265306123,49,1,78,943,TE,0
0,1,0,448,16,432,-199,-612,413,161.21621621621622,37,0,12,442,TE,0
0,1,49,482,794,-312,-250,-136,-114,166.2173913043478,23,0,326,12,WR,0
0,1,0,786,654,132,-213,-287,74,219.375,8,0,16,151,WR,0
0,1,0,848,71,777,-187,-320,133,398.04761904761904,21,0,22,799,WR,0
0,1,31,584,815,-231,-296,-35,-261,169.8,15,0,215,6,WR,0
0,1,0,825,350,475,-208,-299,91,353.0,14,0,8,484,WR,0
0,1,13,941,-514,1455,-230,-221,-9,363.475,40,1,2,1448,TE,0
0,1,22,1291,589,702,-225,-200,-25,212.03030303030303,33,0,20,722,RB,0
0,1,17,11,746,-735,-332,-105,-227,283.81481481481484,27,0,732,7,WR,0
0,1,0,317,-641,958,-403,-172,-231,195.80327868852459,61,1,101,1057,TE,0
0,1,0,262,-16,278,-529,-633,104,271.0,11,1,4,286,RB,0
0,1,13,2,-7,9,-787,-751,-36,122.0,62,0,29,70,RB,1
0,1,11,1161,253,908,-273,-531,258,297.969696969697,33,0,16,933,RB,0
0,1,0,791,-1178,1969,-243,-197,-46,524.5263157894736,38,1,7,1975,WR,0
0,1,5,517,-365,882,-191,-257,66,250.75675675675674,37,1,32,910,TE,0
0,1,0,320,529,-209,-217,-216,-1,140.25,16,0,216,4,TE,0
0,1,4,1158,921,237,-187,-183,-4,174.13333333333333,15,0,17,250,WR,0
1,1,1,412,-517,929,-146,-157,11,220.75,48,1,98,1022,TE,0
1,1,44,498,-400,898,-227,-240,13,291.6060606060606,33,1,30,927,TE,0
0,1,0,939,-750,1689,-41,-278,237,360.03921568627453,51,1,6,1703,WR,0
1,1,48,823,666,157,-253,-82,-171,98.5,22,0,28,172,WR,0
1,1,0,427,-509,936,-150,-121,-29,260.8,40,1,53,982,TE,0
1,1,0,550,-374,924,-209,-215,6,242.475,40,1,50,970,TE,0
0,1,0,713,-730,1443,-73,-203,130,339.48936170212767,47,1,21,1468,WR,0
0,1,0,1311,438,873,-159,-304,145,325.9655172413793,29,0,24,894,WR,0
0,1,0,904,-486,1390,-192,-228,36,350.6461538461538,65,1,445,1831,WR,1
0,1,51,443,-467,910,-292,-150,-142,219.9047619047619,42,1,12,900,TE,0
0,1,12,1202,-928,2130,-216,-181,-35,385.2,55,1,10,2137,WR,0
0,1,0,741,-757,1498,-205,-239,34,387.12820512820514,39,1,0,1495,WR,0
0,1,0,474,-392,866,-243,-248,5,334.5,26,1,0,866,TE,0
0,1,0,1946,991,955,-222,-277,55,350.5925925925926,27,0,2,948,WR,0
0,1,0,726,391,335,-207,-354,147,111.64516129032258,31,0,11,338,TE,0
0,1,20,263,-823,1086,-281,-182,-99,336.3636363636364,33,1,4,1094,WR,0
0,1,0,849,599,250,-202,-267,65,197.73076923076923,26,0,128,377,WR,1
0,1,27,821,-485,1306,-243,-158,-85,347.7631578947368,38,1,6,1327,TE,0
0,1,0,966,-353,1319,-180,-337,157,492.85185185185185,27,1,3,1315,WR,0
0,1,0,1086,435,651,-230,-111,-119,204.3125,32,0,5,645,TE,0
0,1,0,539,382,157,-257,-230,-27,370.8421052631579,38,0,626,787,TE,1
0,1,0,715,-620,1335,-233,-203,-30,310.64516129032256,62,1,308,1627,WR,1
0,1,22,861,-910,1771,-214,-114,-100,318.64285714285717,56,1,13,1801,WR,0
0,1,12,411,414,-3,-227,-204,-23,11.6,5,0,28,18,TE,1
0,1,9,243,828,-585,-532,-249,-283,201.58823529411765,34,0,584,4,RB,0
0,1,0,1443,-451,1894,-218,-167,-51,484.7435897435897,39,1,3,1879,TE,0
0,1,30,748,-783,1531,-170,-172,2,266.7413793103448,58,1,8,1546,WR,0
0,1,46,353,-490,843,-280,-168,-112,260.27272727272725,33,1,17,838,TE,0
0,1,0,1182,-297,1479,-200,-239,39,377.875,40,1,7,1505,WR,0
0,1,0,864,668,196,-153,-168,15,258.11764705882354,51,0,559,748,WR,1
0,1,32,1249,435,814,-219,-128,-91,222.10526315789474,38,0,19,831,TE,0
0,1,0,1149,351,798,-126,-241,115,390.8095238095238,21,0,5,814,WR,0
0,1,0,838,-654,1492,-224,-240,16,371.15,40,1,8,1505,WR,0
1,1,47,1003,1364,-361,-70,-58,-12,165.9090909090909,22,0,381,19,WR,0
0,1,0,1344,569,775,-193,-155,-38,221.34285714285716,35,0,4,776,TE,0
1,1,70,625,211,414,-426,-494,68,204.0909090909091,22,0,15,428,RB,0
0,1,26,765,470,295,-244,-232,-12,155.65,20,0,4,303,TE,0
0,1,0,71,283,-212,-640,-462,-178,87.53571428571429,28,0,216,26,RB,0
0,1,16,248,202,46,-527,-521,-6,97.25,28,0,136,171,RB,1
0,1,0,1490,1056,434,-189,-203,14,204.47619047619048,21,0,3,448,WR,0
0,1,49,620,-939,1559,-238,-186,-52,388.2682926829268,41,1,6,1581,WR,0
0,1,39,410,0,410,-532,-720,188,219.27272727272728,22,0,10,412,RB,0
0,1,7,449,-416,865,-206,-239,33,232.68421052631578,38,1,10,876,TE,0
0,1,0,949,-476,1425,-144,-238,94,375.72222222222223,54,1,302,1716,WR,0
0,1,20,836,-750,1586,-230,-169,-61,363.3863636363636,44,1,6,1587,WR,0
0,1,0,719,-505,1224,-223,-247,24,382.84375,32,1,8,1229,WR,0
0,1,0,338,318,20,-275,-272,-3,138.5,6,0,24,44,TE,1
0,1,42,521,845,-324,-229,-137,-92,180.9090909090909,22,0,345,27,WR,0
1,1,21,1659,1886,-227,-66,-69,3,112.57142857142857,21,0,253,10,WR,0
1,1,11,292,-210,502,-562,-527,-35,175.53333333333333,30,1,4,512,RB,0
0,1,0,439,446,-7,-242,-242,0,282.8157894736842,38,0,543,530,TE,1
0,1,0,858,-201,1059,-179,-288,109,438.16,25,1,20,1074,WR,0
0,1,6,1283,526,757,-301,-141,-160,217.02857142857144,35,0,2,756,TE,0
0,1,0,1357,422,935,-194,-282,88,424.72727272727275,22,0,4,934,WR,0
0,1,0,984,580,404,-150,-190,40,178.13636363636363,22,0,2,403,WR,0
0,1,0,619,335,284,-209,-287,78,109.11111111111111,27,0,8,301,TE,0
0,1,0,1688,1025,663,-224,-199,-25,348.57894736842104,19,0,3,658,WR,0
0,1,0,899,-618,1517,-174,-218,44,475.75,32,1,5,1525,WR,0
0,1,0,369,882,-513,-279,29,-308,276.0,20,0,516,10,WR,0
0,1,0,1476,1078,398,-171,47,-218,199.61904761904762,21,0,8,412,WR,0
0,1,0,1883,968,915,-248,-127,-121,346.85185185185185,27,0,0,909,WR,0
0,1,12,271,-248,519,-535,-483,-52,148.4857142857143,35,1,2,531,RB,0
0,1,0,1798,835,963,-243,-150,-93,283.45714285714286,35,0,12,973,WR,0
0,1,0,628,-725,1353,-330,-347,17,314.1212121212121,66,1,349,1700,WR,1
0,1,0,993,-463,1456,-141,-306,165,387.0,38,1,4,1461,WR,0
0,1,0,1506,1059,447,-186,-174,-12,254.11111111111111,18,0,11,454,WR,0
0,1,0,875,-356,1231,-203,-312,109,429.1666666666667,48,1,395,1634,WR,1
0,1,0,1300,-693,1993,-161,-312,151,455.29787234042556,47,1,69,2061,WR,0
0,1,5,1123,231,892,-376,-498,122,230.8409090909091,44,0,54,949,RB,0
0,1,9,336,310,26,-542,-531,-11,131.6046511627907,43,0,201,204,RB,1
0,1,0,838,658,180,-184,-213,29,241.77777777777777,9,0,16,210,WR,0
0,1,0,1441,408,1033,-156,-125,-31,255.94871794871796,39,0,17,1021,TE,0
1,1,29,714,-797,1511,-224,-113,-111,323.5833333333333,48,1,5,1516,WR,0
1,1,20,6,-1327,1333,-670,-7,-663,271.9824561403509,57,1,5,1340,RB,0
1,1,12,418,663,-245,-132,-207,75,70.26470588235294,34,0,254,8,TE,0
1,1,24,139,-2156,2295,-525,-169,-356,442.47169811320754,53,1,4,2300,TE,0
0,1,0,1022,698,324,-188,-182,-6,126.45161290322581,31,0,43,373,WR,0
0,1,0,124,-623,747,-286,-183,-103,286.3611111111111,36,1,124,870,WR,0
0,1,22,700,-737,1437,-174,-191,17,298.3541666666667,48,1,5,1444,WR,0
0,1,0,1516,973,543,-208,-231,23,256.23809523809524,21,0,2,536,TE,0
0,1,0,1377,-581,1958,-219,-331,112,444.95652173913044,46,1,52,1974,WR,0
1,1,0,661,-872,1533,-311,-168,-143,278.25454545454545,55,1,16,1532,WR,0
1,1,0,408,851,-443,-243,-168,-75,142.42857142857142,35,0,500,29,TE,0
1,1,19,716,-725,1441,-223,-29,-194,334.0,46,1,21,1484,WR,0
0,1,10,999,1527,-528,-136,-119,-17,205.68,25,0,523,16,WR,0
0,1,0,506,228,278,-239,-266,27,161.1764705882353,17,0,26,296,WR,0
0,1,36,732,-1013,1745,-257,-128,-129,340.65384615384613,52,1,6,1750,WR,0
0,1,36,1419,722,697,231,-240,471,212.0,34,0,20,704,RB,0
0,1,28,150,158,-8,-295,-463,168,102.52380952380952,21,0,23,6,RB,1
0,1,15,1370,672,698,-312,-26,-286,245.33333333333334,30,0,10,715,TE,0
0,1,0,869,-479,1348,-272,-294,22,371.27777777777777,36,1,11,1348,WR,0
0,1,6,260,161,99,-423,-411,-12,240.33734939759037,83,0,938,1042,RB,1
0,1,20,886,590,296,-198,-167,-31,89.6,30,0,2,310,WR,0
0,1,37,1602,554,1048,-250,-186,-64,312.8529411764706,34,0,15,1069,TE,0
0,1,0,752,-1403,2155,-241,-25,-216,456.4791666666667,48,1,2,2200,WR,0
0,1,0,625,630,-5,-97,74,-171,42.75,12,0,29,44,TE,1
0,1,0,14,540,-526,-494,-144,-350,154.9795918367347,49,0,606,81,TE,0
0,1,8,1168,551,617,-222,-211,-11,174.97058823529412,34,0,4,610,WR,0
0,1,0,1067,268,799,-279,-339,60,231.73170731707316,41,0,40,860,RB,0
0,1,0,789,-967,1756,-282,-174,-108,336.6730769230769,52,1,10,1751,WR,0
0,1,5,1084,707,377,-133,-120,-13,138.73076923076923,26,0,2,380,WR,0
0,1,0,542,543,-1,-224,-179,-45,36.875,8,0,53,4,TE,0
0,1,0,1371,504,867,-227,-83,-144,188.9387755102041,49,0,19,919,TE,0
1,1,29,227,144,83,-562,-517,-45,279.3965517241379,58,0,766,854,RB,1
1,1,48,360,443,-83,-264,-262,-2,73.96296296296296,27,0,150,75,TE,1
0,1,0,659,-512,1171,-265,-241,-24,336.44444444444446,36,1,20,1190,WR,0
0,1,0,505,448,57,-190,-179,-11,29.545454545454547,11,0,25,83,TE,1
0,1,0,422,-464,886,-230,-181,-49,220.5121951219512,41,1,2,886,TE,0
0,1,10,1060,859,201,-175,-128,-47,96.65217391304348,23,0,27,213,WR,0
0,1,0,536,-1192,1728,-246,-15,-231,324.5,54,1,7,1731,WR,0
0,1,0,540,520,20,-125,49,-174,47.875,8,0,26,50,TE,1
0,1,0,910,-636,1546,-267,-14,-253,525.7586206896551,29,1,8,1512,WR,0
0,1,0,498,413,85,-285,-34,-251,107.2,5,0,28,63,TE,1
0,1,18,1,70,-69,-697,-614,-83,141.77777777777777,45,0,129,97,RB,1
0,1,20,930,-845,1775,-159,-91,-68,364.1458333333333,48,1,14,1734,WR,0
1,1,36,220,168,52,-483,-536,53,109.28205128205128,39,0,28,95,RB,1
1,1,63,74,1064,-990,-297,-187,-110,277.27027027027026,37,0,1001,8,WR,0
0,1,0,1091,746,345,-260,-175,-85,230.8,15,0,5,337,WR,0
0,1,0,533,507,26,-121,54,-175,28.181818181818183,11,0,5,51,TE,0
0,1,0,2276,2298,-22,-186,3,-189,40.6,5,0,5,0,RB,0
0,1,18,29,78,-49,-774,-654,-120,91.73076923076923,26,0,38,35,RB,1
0,1,0,13,25,-12,-428,-382,-46,113.5,2,0,16,4,TE,1
1,1,24,184,-182,366,-536,-397,-139,192.47619047619048,21,1,6,406,RB,0
0,1,0,482,-426,908,-241,-179,-62,248.9512195121951,41,1,102,986,TE,0
0,1,0,520,562,-42,-143,-44,-99,51.588235294117645,17,0,49,29,TE,1
0,1,0,793,-1249,2042,-180,21,-201,423.6986301369863,73,1,530,2559,WR,1
0,1,18,3,-187,190,-713,-491,-222,75.125,32,1,16,196,RB,0
0,1,0,1043,-1187,2230,-136,-40,-96,292.35526315789474,76,1,4,2214,WR,0
0,1,5,476,605,-129,-265,-26,-239,92.88235294117646,34,0,220,61,TE,1
0,1,3,846,-422,1268,-291,-183,-108,291.4,45,1,5,1318,WR,0
0,1,0,485,461,24,-118,113,-231,58.23076923076923,13,0,6,50,TE,0
0,1,6,439,-553,992,-221,-29,-192,200.16326530612244,49,1,20,987,TE,0
0,1,0,870,648,222,-193,-181,-12,93.56,25,0,8,246,WR,0
0,1,0,364,384,-20,-524,-382,-142,100.5,24,0,81,73,RB,1
0,1,0,269,336,-67,-535,-518,-17,72.98275862068965,58,0,275,227,RB,1
0,1,0,932,237,695,-198,-291,93,412.42105263157896,19,0,4,758,WR,0
0,1,12,1137,-1028,2165,-179,-18,-161,319.0,68,1,20,2159,WR,0
0,1,0,603,-354,957,-193,-165,-28,347.1914893617021,47,1,298,1293,WR,1
0,1,0,516,500,16,-75,48,-123,77.0,3,0,21,2,TE,0
0,1,32,1114,163,951,-224,-272,48,261.5135135135135,37,0,6,955,RB,0
0,1,0,609,-1034,1643,-248,-38,-210,293.08620689655174,58,1,38,1662,WR,0
0,1,0,595,573,22,-142,-25,-117,34.68421052631579,19,0,78,76,TE,1
0,1,0,1481,988,493,-159,-55,-104,168.3793103448276,29,0,0,493,WR,0
0,1,0,508,492,16,-120,-20,-100,35.77777777777778,9,0,17,62,TE,1
1,1,0,821,-1932,2753,-188,33,-221,269.6355140186916,107,1,20,2752,WR,0
1,1,0,607,493,114,-62,19,-81,75.48717948717949,39,0,54,200,TE,1
1,1,30,968,1572,-604,-121,9,-130,176.42857142857142,35,0,640,2,WR,0
0,1,0,657,-491,1148,-221,-255,34,295.71794871794873,39,1,7,1159,TE,0
0,1,0,654,648,6,-293,-247,-46,63.166666666666664,12,0,43,39,RB,1
0,1,0,757,1335,-578,-296,-41,-255,229.46428571428572,28,0,567,16,WR,0
0,1,0,1073,1064,9,-106,-61,-45,121.33333333333333,3,0,3,12,WR,1
0,1,0,618,586,32,-132,7,-139,35.578947368421055,19,0,65,81,TE,1
1,1,12,1209,24,1185,-172,-645,473,366.19444444444446,36,0,10,1232,RB,0
1,1,0,34,420,-386,-641,-230,-411,173.45454545454547,33,0,444,26,RB,0
0,1,0,470,474,-4,-105,-2,-103,57.8235294117647,34,0,119,102,TE,1
0,1,0,1014,586,428,-227,-107,-120,138.75,32,0,26,447,TE,0
0,1,13,1292,-270,1562,-190,-432,242,345.2391304347826,46,1,30,1582,RB,0
0,1,0,448,493,-45,-230,-206,-24,159.75555555555556,45,0,381,318,TE,1
0,1,3,840,465,375,-236,-137,-99,191.5,44,0,238,597,WR,1
0,1,55,745,-961,1706,-223,-154,-69,347.9387755102041,49,1,26,1712,WR,0
0,1,0,1743,1113,630,-195,-203,8,200.93548387096774,31,0,2,614,TE,0
0,1,17,430,497,-67,-271,-224,-47,153.6875,48,0,397,350,TE,1
0,1,0,758,286,472,-250,-286,36,409.6666666666667,12,0,18,473,WR,0
0,1,0,430,-394,824,-230,-192,-38,236.86111111111111,36,1,28,856,TE,0
0,1,0,982,-137,1119,-185,-318,133,483.0416666666667,24,1,4,1125,WR,0
0,1,0,1245,114,1131,-207,-167,-40,306.69444444444446,36,0,2,1101,WR,0
0,1,0,422,145,277,-225,-311,86,252.8125,32,0,268,526,TE,1
0,1,0,979,-225,1204,-210,-285,75,500.0416666666667,24,1,2,1182,WR,0
0,1,59,1135,176,959,-369,-500,131,356.07142857142856,28,0,4,976,RB,0
0,1,84,191,-1058,1249,-224,-164,-60,360.37142857142857,35,1,10,1237,WR,0
0,1,64,200,-1792,1992,-373,-146,-227,406.56,50,1,6,1995,RB,0
0,1,11,464,-407,871,-224,-216,-8,194.0681818181818,44,1,27,900,TE,0
0,1,0,962,926,36,-212,-185,-27,317.9056603773585,53,0,816,855,WR,1
0,1,0,219,-723,942,-477,-163,-314,285.02777777777777,36,1,4,951,RB,0
0,1,44,1443,1500,-57,-74,-54,-20,40.5,2,0,36,5,WR,0
0,1,52,399,-460,859,-224,-162,-62,319.9642857142857,28,1,11,889,TE,0
0,1,0,845,548,297,-148,-192,44,145.5909090909091,22,0,8,322,WR,0
0,1,0,937,-607,1544,-171,-221,50,393.38461538461536,39,1,6,1531,WR,0
0,1,53,696,1439,-743,-269,-225,-44,221.27272727272728,33,0,747,14,WR,0
0,1,32,204,-206,410,-560,-479,-81,160.03703703703704,27,1,20,436,RB,0
0,1,0,423,-808,1231,-243,-196,-47,234.8653846153846,52,1,8,1223,TE,0
0,1,0,1105,287,818,-190,-300,110,303.258064516129,31,0,69,891,WR,0
1,1,46,929,539,390,-259,-192,-67,114.8936170212766,47,0,39,440,WR,0
1,1,36,1250,-1919,3169,-115,-85,-30,453.9577464788732,71,1,12,3172,WR,0
0,1,5,992,600,392,-231,-151,-80,166.04,25,0,13,399,TE,0
0,1,0,446,611,-165,-260,-227,-33,175.85714285714286,49,0,528,351,TE,1
0,1,16,1457,467,990,-98,-108,10,233.3181818181818,44,0,43,1017,TE,0
0,1,5,424,-486,910,-199,-113,-86,206.0212765957447,47,1,28,938,TE,0
0,1,87,1378,1529,-151,-154,-52,-102,63.88,25,0,154,15,WR,0
0,1,9,1343,468,875,-213,-164,-49,204.97619047619048,42,0,3,864,TE,0
0,1,29,533,-462,995,-219,-172,-47,242.6,40,1,2,988,TE,0
0,1,7,589,1207,-618,-175,-169,-6,205.93103448275863,29,0,603,15,WR,0
0,1,64,1340,525,815,-194,-120,-74,240.0,35,0,8,851,TE,0
0,1,19,1442,581,861,-127,-154,27,216.95,40,0,8,884,TE,0
0,1,0,928,698,230,-142,-197,55,173.23076923076923,13,0,8,223,WR,0
0,1,22,1950,1159,791,-151,-190,39,196.4,40,0,23,797,TE,0
0,1,9,434,-411,845,-234,-257,23,233.05555555555554,36,1,12,853,TE,0
0,1,0,491,606,-115,-227,-237,10,208.75510204081633,49,0,568,457,TE,1
0,1,0,1933,1298,635,-234,-184,-50,295.57142857142856,21,0,6,615,WR,0
0,1,51,510,-435,945,-252,-121,-131,278.05882352941177,34,1,10,951,TE,0
0,1,66,1497,590,907,-273,-159,-114,216.5,44,0,11,939,TE,0
0,1,16,878,335,543,-131,-230,99,191.82142857142858,28,0,4,534,WR,0
0,1,0,197,-315,512,-476,-314,-162,177.06666666666666,30,1,8,512,RB,0
0,1,4,1287,719,568,-281,-205,-76,187.03030303030303,33,0,24,605,TE,0
0,1,0,840,-16,856,-256,-327,71,382.6521739130435,23,1,6,869,WR,0
0,1,0,794,-249,1043,-182,-318,136,486.72727272727275,22,1,4,1058,TE,0
0,1,42,5,16,-11,-696,-780,84,107.07272727272728,55,0,66,91,RB,1
0,1,50,23,16,7,-572,-545,-27,36.25,4,0,25,18,WR,1
0,1,13,164,1327,-1163,-511,-190,-321,293.1463414634146,41,0,1170,2,WR,0
0,1,0,1289,440,849,-203,-200,-3,225.28571428571428,56,0,211,1056,TE,1
1,1,3,1244,466,778,-195,-150,-45,211.51282051282053,39,0,33,819,TE,0
0,1,42,1,-16,17,-703,-686,-17,124.57377049180327,61,0,94,125,RB,1
0,1,59,26,-11,37,-747,-756,9,93.18181818181819,66,0,56,97,RB,1
0,1,35,8,0,8,-645,-643,-2,89.62921348314607,89,0,79,76,RB,1
0,1,0,895,-428,1323,-230,-325,95,238.77586206896552,58,1,6,1318,WR,0
0,1,21,1062,1041,21,-167,-71,-96,100.78947368421052,38,0,178,220,TE,1
1,1,24,206,196,10,-480,-444,-36,82.3,30,0,92,71,RB,1
0,1,23,1922,1886,36,-69,-4,-65,107.07142857142857,28,0,122,180,WR,1
0,1,16,1056,-525,1581,-160,-62,-98,378.6046511627907,43,1,6,1607,TE,0
0,1,0,690,68,622,-191,-550,359,275.21276595744683,47,0,266,879,WR,1
1,1,15,771,1140,-369,-129,-8,-121,122.34482758620689,29,0,355,5,WR,0
0,1,0,1543,1333,210,-153,-170,17,230.2,10,0,4,213,WR,0
0,1,46,333,444,-111,-247,-176,-71,120.6875,16,0,151,42,TE,1
0,1,0,709,-823,1532,-196,-204,8,398.7435897435897,39,1,2,1546,WR,0
0,1,0,1095,1053,42,-173,-168,-5,272.0,58,0,784,834,WR,1
0,1,29,1750,500,1250,-274,-109,-165,349.0833333333333,36,0,4,1264,TE,0
0,1,19,250,-316,566,-491,-536,45,203.6,30,1,18,585,WR,0
0,1,0,582,359,223,-410,-461,51,160.0,20,0,28,258,WR,0
0,1,0,458,423,35,-117,-43,-74,51.72222222222222,18,0,44,59,TE,1
1,1,36,1280,-1,1281,-277,-776,499,397.2368421052632,38,1,54,1328,RB,0
0,1,0,750,-278,1028,-216,-330,114,296.89473684210526,38,1,25,1020,WR,0
0,1,0,405,-866,1271,-239,5,-244,338.1578947368421,38,1,0,1254,WR,0
0,1,0,455,-1910,2365,-208,-58,-150,464.37254901960785,51,1,18,2374,TE,0
0,1,3,11,-14,25,-789,-705,-84,45.785714285714285,14,0,14,8,RB,1
0,1,0,1122,693,429,-229,-277,48,299.1333333333333,15,0,18,431,RB,0
0,1,34,520,1976,-1456,-195,-95,-100,305.1224489795918,49,0,1490,18,WR,0
0,1,10,536,-393,929,-220,-127,-93,245.68421052631578,38,1,22,995,TE,0
0,1,0,779,408,371,-174,-233,59,275.57142857142856,14,0,2,391,WR,0
0,1,0,502,171,331,-248,-218,-30,362.9,10,0,8,362,RB,0
0,1,0,602,302,300,-414,-317,-97,149.64,25,0,22,337,RB,0
0,1,64,172,-118,290,-365,-171,-194,90.24242424242425,33,1,12,288,RB,0
0,1,34,457,209,248,-220,-425,205,95.53731343283582,67,0,118,371,RB,1
0,1,5,253,-255,508,-465,-364,-101,185.96428571428572,28,1,15,529,RB,0
0,1,53,28,217,-189,-512,-364,-148,124.16666666666667,18,0,207,21,RB,0
0,1,10,687,-552,1239,-185,-190,5,305.325,40,1,4,1249,TE,0
0,1,49,207,250,-43,-571,-446,-125,115.23170731707317,82,0,334,276,RB,1
0,1,0,1154,794,360,-256,-705,449,388.12820512820514,39,0,494,872,RB,1
0,1,0,908,480,428,-230,-305,75,181.125,24,0,4,431,WR,0
0,1,0,1529,1174,355,-336,-281,-55,145.04166666666666,24,0,1,346,WR,0
0,1,5,184,705,-521,-292,-273,-19,285.2926829268293,41,0,844,322,TE,1
1,1,65,663,770,-107,-208,-65,-143,71.59574468085107,47,0,193,102,WR,1
1,1,53,184,-1677,1861,-419,-85,-334,261.02702702702703,74,1,4,1869,RB,0
1,1,64,60,2070,-2010,-503,-210,-293,321.4920634920635,63,0,2005,7,TE,0
1,1,70,14,1248,-1234,-370,-197,-173,221.0701754385965,57,0,1244,19,WR,0
1,1,71,177,799,-622,-430,-163,-267,182.14814814814815,54,0,749,113,WR,0
0,1,17,1456,1891,-435,-150,-193,43,140.42857142857142,35,0,440,16,WR,0
0,1,32,666,-1029,1695,-226,-167,-59,356.0408163265306,49,1,2,1708,WR,0
0,1,74,1371,445,926,-244,-250,6,271.42424242424244,33,0,17,923,TE,0
0,1,50,244,-2200,2444,-427,-218,-209,432.87931034482756,58,1,10,2445,RB,0
0,1,39,661,-854,1515,-289,-281,-8,265.2280701754386,57,1,8,1536,WR,0
0,1,0,285,282,3,-486,-363,-123,39.42857142857143,21,0,72,96,RB,1
0,1,0,1585,1568,17,-122,-134,12,97.4,5,0,26,57,WR,1
1,1,87,209,29,180,-594,-668,74,103.64285714285714,28,0,13,193,RB,0
0,1,57,943,-838,1781,-238,-191,-47,341.3076923076923,52,1,11,1802,TE,0
0,1,0,464,-510,974,-263,-263,0,280.57142857142856,35,1,2,973,TE,0
0,1,13,516,992,-476,-84,-83,-1,154.24137931034483,29,0,472,6,TE,0
0,1,30,1542,495,1047,-232,-211,-21,238.1086956521739,46,0,45,1078,TE,0
0,1,25,1,-2,3,-822,-757,-65,130.07462686567163,67,0,92,75,RB,1
1,1,24,20,16,4,-839,-731,-108,100.0,70,0,77,112,RB,1
0,1,68,230,239,-9,-566,-613,47,126.63829787234043,47,0,168,147,RB,1
0,1,44,551,733,-182,-95,17,-112,79.34615384615384,26,0,197,25,TE,0
0,1,10,299,197,102,-480,-471,-9,90.2909090909091,55,0,107,241,RB,1
0,1,7,188,182,6,-462,-546,84,156.32692307692307,104,0,669,695,RB,1
0,1,34,275,832,-557,-488,-207,-281,213.89655172413794,29,0,545,24,RB,0
0,1,6,909,-993,1902,-312,-198,-114,339.5,56,1,3,1901,WR,0
0,1,0,1012,728,284,-209,-263,54,245.0909090909091,11,0,11,277,WR,0
0,1,11,504,-467,971,-158,-127,-31,242.3,40,1,6,985,TE,0
0,1,59,523,-524,1047,-194,-142,-52,281.35135135135135,37,1,30,1050,TE,0
0,1,0,911,725,186,-249,-272,23,252.0,8,0,4,215,RB,0
0,1,0,998,442,556,-32,-279,247,312.6666666666667,18,0,20,546,WR,0
0,1,18,500,-525,1025,-171,-129,-42,270.4736842105263,38,1,16,1020,TE,0
0,1,7,248,-1303,1551,-436,-264,-172,346.7659574468085,47,1,12,1576,RB,0
0,1,0,961,684,277,-210,-255,45,336.55555555555554,9,0,5,291,WR,0
0,1,22,860,-513,1373,-277,-236,-41,224.53846153846155,65,1,20,1403,TE,0
0,1,0,1002,793,209,-220,-240,20,287.7142857142857,7,0,14,211,WR,0
0,1,5,513,201,312,-242,-371,129,112.17241379310344,29,0,19,319,TE,0
0,1,0,999,460,539,-263,-369,106,370.3333333333333,15,0,10,534,WR,0
0,1,17,757,-456,1213,-196,-184,-12,232.4909090909091,55,1,53,1262,TE,0
0,1,12,604,-1,605,-197,-506,309,225.3448275862069,29,1,18,609,FB,0
0,1,0,2128,1506,622,-195,-217,22,276.39130434782606,23,0,10,639,WR,0
0,1,0,514,-478,992,-193,-257,64,254.5,40,1,20,1017,TE,0
1,1,10,652,640,12,-134,-118,-16,60.5,4,0,0,6,WR,0
0,1,0,1902,1374,528,-254,-329,75,160.71428571428572,35,0,3,535,WR,0
0,1,17,250,-1775,2025,-209,-161,-48,331.5409836065574,61,1,5,2024,WR,0
0,1,30,1203,920,283,-258,-170,-88,89.35483870967742,31,0,2,278,WR,0
0,1,0,1462,1045,417,-217,49,-266,141.78571428571428,28,0,0,395,WR,0
0,1,0,1274,413,861,-273,-155,-118,235.97222222222223,36,0,0,852,TE,0
0,1,4,231,-188,419,-549,-476,-73,123.25581395348837,43,1,62,470,RB,0
0,1,19,1491,927,564,-180,-63,-117,150.10526315789474,38,0,5,582,WR,0
0,1,0,836,360,476,-161,-177,16,145.17948717948718,39,0,37,520,WR,0
0,1,0,847,847,0,-97,-35,-62,92.0,3,0,8,15,WR,1
0,1,0,1746,1147,599,-191,-211,20,204.83333333333334,30,0,18,609,WR,0
0,1,0,1224,384,840,-180,-293,113,480.3333333333333,18,0,11,850,WR,0
0,1,26,196,-1791,1987,-455,-120,-335,345.8833333333333,60,1,15,2002,RB,0
0,1,0,878,431,447,-218,-219,1,222.35,20,0,2,447,WR,0
0,1,7,1302,716,586,-191,-62,-129,221.40740740740742,27,0,0,591,RB,0
0,1,22,501,504,-3,-261,-174,-87,42.0,1,0,9,8,RB,1
0,1,10,50,48,2,-731,-707,-24,98.08928571428571,56,0,66,98,RB,1
0,1,22,662,-640,1302,-302,-216,-86,177.21875,96,1,172,1486,WR,0
0,1,44,24,31,-7,-786,-780,-6,113.83783783783784,37,0,22,44,RB,1
0,1,54,1087,967,120,-162,-213,51,98.84615384615384,13,0,24,131,WR,1
0,1,35,304,-248,552,-493,-467,-26,213.66666666666666,27,1,12,577,RB,0
0,1,0,868,-1167,2035,-119,-205,86,376.89285714285717,56,1,1,2034,WR,0
0,1,0,983,-417,1400,-186,-290,104,514.3928571428571,28,1,15,1403,WR,0
0,1,0,544,-950,1494,-306,59,-365,417.3783783783784,37,1,2,1494,WR,0
1,1,18,626,-533,1159,-214,-201,-13,228.24528301886792,53,1,18,1183,TE,0
0,1,0,509,491,18,-98,-132,34,112.3125,64,0,368,386,TE,1
0,1,0,180,633,-453,-292,-166,-126,151.61363636363637,44,0,547,102,TE,1
1,1,46,1096,1368,-272,-370,21,-391,160.07692307692307,26,0,306,2,WR,0
0,1,40,1763,1216,547,-110,-56,-54,187.6451612903226,31,0,4,585,WR,0
0,1,8,1328,547,781,-143,-108,-35,243.87878787878788,33,0,12,821,RB,0
0,1,0,1120,-409,1529,-213,-280,67,406.38461538461536,39,1,30,1552,WR,0
1,1,49,17,224,-207,-760,-542,-218,103.60714285714286,28,0,257,31,RB,0
0,1,21,251,-2216,2467,-425,-178,-247,401.46031746031747,63,1,3,2461,RB,0
0,1,39,140,-1893,2033,-533,7,-540,364.7741935483871,62,1,41,2056,WR,0
0,1,14,267,-578,845,-470,-131,-339,235.89743589743588,39,1,7,885,RB,0
1,1,41,964,968,-4,-111,-106,-5,33.0,1,0,14,2,TE,0
0,1,0,398,568,-170,-274,-184,-90,97.18518518518519,27,0,211,44,TE,1
0,1,0,455,-472,927,-241,-213,-28,214.4047619047619,42,1,4,937,TE,0
1,1,42,765,-1159,1924,-260,-114,-146,465.9767441860465,43,1,12,1970,WR,0
1,1,58,1652,1530,122,-82,-12,-70,60.36363636363637,22,0,11,159,WR,0
0,1,17,228,-2138,2366,-461,-182,-279,397.78333333333336,60,1,3,2363,RB,0
0,1,0,819,255,564,-230,-313,83,327.6111111111111,18,0,5,573,WR,0
0,1,42,1246,-615,1861,-219,-214,-5,261.4367816091954,87,1,262,2074,TE,0
0,1,0,1580,784,796,-194,-189,-5,260.6774193548387,31,0,25,806,RB,0
1,1,5,217,-224,441,-497,-457,-40,187.8846153846154,26,1,17,462,RB,0
1,1,9,384,-587,971,-294,-209,-85,220.72727272727272,44,1,2,965,TE,0
0,1,8,356,-543,899,-231,-165,-66,249.41666666666666,36,1,0,898,TE,0
0,1,13,396,-469,865,-280,-153,-127,170.1,60,1,87,952,TE,0
0,1,0,1005,-260,1265,-209,-306,97,412.56410256410254,39,1,180,1439,WR,0
1,1,58,606,445,161,-210,-92,-118,85.90322580645162,31,0,23,198,WR,0
0,1,0,479,-775,1254,-116,-169,53,213.43283582089552,67,1,24,1288,TE,0
1,1,64,536,711,-175,-89,-5,-84,88.375,16,0,152,11,TE,0
1,1,29,191,1677,-1486,-653,-141,-512,308.29411764705884,51,0,1504,2,RB,0
1,1,40,790,1238,-448,-211,-33,-178,123.11111111111111,36,0,439,15,TE,0
1,1,36,692,2097,-1405,-122,-80,-42,317.1363636363636,44,0,1392,10,TE,0
0,1,10,1175,1188,-13,-175,-164,-11,45.5,2,0,9,1,WR,0
1,1,0,313,-548,861,-231,-89,-142,198.58333333333334,48,1,16,875,TE,0
1,1,33,931,588,343,-210,-137,-73,170.8095238095238,21,0,2,350,WR,0
0,1,60,294,-435,729,-234,-128,-106,270.57142857142856,28,1,10,739,TE,0
0,1,0,737,269,468,-171,-416,245,219.96296296296296,27,0,6,481,RB,0
1,1,7,447,-485,932,-228,-136,-92,216.56521739130434,46,1,15,960,TE,0
1,1,43,901,415,486,-188,-177,-11,177.26923076923077,26,0,4,498,WR,0
1,1,60,493,582,-89,-75,-163,88,52.111111111111114,36,0,173,75,TE,1
0,1,0,558,510,48,-141,-183,42,277.13978494623655,93,0,1241,1298,TE,1
0,1,29,149,1118,-969,-266,-125,-141,366.35714285714283,28,0,972,9,WR,0
0,1,0,37,22,15,-875,-805,-70,58.878787878787875,33,0,58,67,RB,1
0,1,0,587,522,65,-131,-169,38,72.94594594594595,74,0,160,183,TE,1
0,1,0,809,-391,1200,-206,-193,-13,213.23728813559322,59,1,71,1235,WR,0
0,1,0,476,480,-4,-212,-199,-13,56.48837209302326,43,0,97,106,TE,1
0,1,0,1255,-143,1398,-141,-266,125,460.16129032258067,31,1,2,1417,WR,0
0,1,1,243,212,31,-454,-248,-206,67.45238095238095,42,0,155,165,FB,1
0,1,0,479,502,-23,350,356,-6,46.4375,32,0,68,68,TE,1
0,1,21,1518,472,1046,-257,-220,-37,237.08695652173913,46,0,36,1094,TE,0
0,1,0,1607,663,944,-166,-86,-80,198.13725490196077,51,0,42,995,TE,0
0,1,3,37,70,-33,-822,-855,33,85.38461538461539,26,0,46,9,RB,1
0,1,0,1196,1158,38,-193,-179,-14,80.0,15,0,15,54,WR,1
0,1,1,838,-876,1714,-293,-252,-41,291.48275862068965,58,1,45,1744,WR,0
0,1,0,523,519,4,-106,-113,7,27.9375,32,0,30,52,TE,1
0,1,15,42,2,40,-729,-737,8,113.1590909090909,44,0,64,54,RB,1
0,1,3,773,788,-15,-195,-191,-4,26.533333333333335,15,0,70,45,WR,1
0,1,2,648,1246,-598,-319,-68,-251,186.0487804878049,41,0,694,61,WR,0
0,1,3,544,-476,1020,-393,-157,-236,174.59154929577466,71,1,68,1050,WR,0
0,1,5,1383,257,1126,-305,-532,227,225.7719298245614,57,0,50,1177,RB,0
0,1,0,448,565,-117,-253,-55,-198,192.6909090909091,55,0,560,481,TE,1
0,1,0,940,212,728,-163,-240,77,305.5416666666667,24,0,7,730,WR,0
0,1,0,1151,1169,-18,-99,-59,-40,38.0,14,0,55,36,WR,1
1,1,18,623,197,426,-155,-415,260,151.02564102564102,39,0,42,481,RB,0
0,1,0,912,423,489,-178,-257,79,307.75,16,0,20,500,WR,0
0,1,0,933,200,733,-201,-215,14,328.75,24,0,34,758,WR,0
0,1,2,515,472,43,-52,57,-109,61.8,5,0,8,28,TE,1
0,1,0,10,-38,48,-743,-709,-34,49.2,10,0,8,65,RB,0
0,1,0,1396,387,1009,-261,-510,249,188.82258064516128,62,0,97,1094,RB,0
0,1,0,663,686,-23,-180,-107,-73,36.6,15,0,69,35,TE,1
1,1,0,0,-16,16,-798,-726,-72,80.15625,32,0,58,78,RB,1
1,1,0,1146,824,322,-271,-171,-100,167.9,20,0,2,326,WR,0
0,1,0,315,375,-60,-636,-626,-10,61.43478260869565,46,0,101,36,RB,1
0,1,0,1229,1222,7,-282,-317,35,38.57692307692308,26,0,24,39,WR,1
0,1,0,181,189,-8,-514,-583,69,116.87323943661971,71,0,284,235,RB,1
0,1,0,344,385,-41,-543,-503,-40,55.1,10,0,76,51,RB,1
0,1,0,1294,1300,-6,-172,-87,-85,32.64705882352941,17,0,44,58,WR,1
0,1,0,885,586,299,-295,-155,-140,161.44827586206895,29,0,82,396,TE,1
0,1,0,286,-247,533,-566,-442,-124,153.25,40,1,50,574,RB,0
0,1,0,436,648,-212,-363,-215,-148,147.65,20,0,238,23,WR,0
0,1,0,857,-1143,2000,-173,-142,-31,314.5079365079365,63,1,3,1976,WR,0
0,1,0,23,22,1,-872,-763,-109,71.03846153846153,26,0,59,53,RB,1
0,1,0,778,988,-210,-235,-197,-38,145.8125,16,0,211,0,WR,0
0,1,3,442,-450,892,-139,-186,47,203.79591836734693,49,1,12,893,TE,0
0,1,0,7,-32,39,-564,-510,-54,123.66666666666667,3,0,2,56,FB,0
0,1,3,190,871,-681,-507,-149,-358,187.29545454545453,44,0,696,25,RB,0
0,1,0,1108,278,830,-169,-360,191,437.65,20,0,24,844,WR,0
1,1,92,217,-4,221,-510,-752,242,113.94642857142857,56,1,39,236,RB,0
0,1,0,701,-156,857,-127,-529,402,355.4642857142857,28,1,6,888,WR,0
0,1,48,63,-216,279,-582,-481,-101,143.8181818181818,22,1,13,274,RB,0
0,1,0,2053,1190,863,-306,-200,-106,323.51851851851853,27,0,0,859,TE,0
0,1,13,591,-1201,1792,-261,-153,-108,324.41818181818184,55,1,0,1782,WR,0
0,1,28,225,-229,454,-477,-461,-16,177.28571428571428,28,1,26,473,RB,0
0,1,26,584,-192,776,-185,-408,223,234.94285714285715,35,1,11,781,FB,0
0,1,8,599,-497,1096,260,167,93,364.5806451612903,31,1,14,1099,TE,0
0,1,0,348,-397,745,-208,-142,-66,231.44444444444446,36,1,32,778,TE,0
1,1,43,713,-1113,1826,-170,-121,-49,231.63291139240508,79,1,2,1829,WR,0
1,1,63,521,697,-176,-116,-112,-4,58.21212121212121,33,0,216,25,TE,0
1,1,50,545,-941,1486,-138,4,-142,219.79710144927537,69,1,6,1508,WR,0
0,1,2,924,1343,-419,-181,-15,-166,148.84,75,0,774,367,WR,1
1,1,54,161,-188,349,-458,-396,-62,97.97297297297297,37,1,41,362,RB,0
0,1,15,1415,1263,152,-155,-84,-71,104.25,16,0,6,193,WR,0
0,1,0,653,-798,1451,-242,-248,6,473.258064516129,31,1,15,1467,TE,0
0,1,52,76,2,74,-300,-522,222,104.3076923076923,26,0,15,88,RB,0
0,1,0,183,450,-267,-247,-212,-35,203.5625,16,0,303,37,TE,0
0,1,0,1033,338,695,-211,-291,80,351.2857142857143,21,0,20,713,WR,0
1,1,49,1421,425,996,-142,-98,-44,151.5142857142857,70,0,52,1033,TE,0
1,1,67,1587,-2,1589,-85,-453,368,241.11267605633802,71,1,25,1624,FB,0
0,1,45,1126,575,551,-414,-193,-221,138.58823529411765,51,0,78,631,RB,0
0,1,0,883,609,274,-298,-284,-14,239.83333333333334,12,0,19,273,WR,0
0,1,7,471,-377,848,-245,-203,-42,242.45714285714286,35,1,5,864,TE,0
0,1,0,645,154,491,-220,-320,100,361.92857142857144,14,0,13,489,WR,0
0,1,0,644,-614,1258,-285,-236,-49,289.06976744186045,43,1,0,1256,TE,0
0,1,24,1365,644,721,-311,-131,-180,183.390243902439,41,0,2,731,RB,0
0,1,3,358,-598,956,-271,-184,-87,278.1142857142857,35,1,6,950,TE,0
0,1,0,1486,772,714,-260,-183,-77,263.64285714285717,28,0,0,721,TE,0
0,1,0,1357,218,1139,-316,-508,192,285.9512195121951,41,0,30,1159,RB,0
0,1,72,1317,224,1093,-167,-493,326,245.0408163265306,49,0,60,1145,RB,0
0,1,0,352,-448,800,-279,-250,-29,226.5609756097561,41,1,19,824,TE,0
1,1,0,871,-247,1118,-186,-310,124,371.4032258064516,62,1,560,1682,WR,1
0,1,0,276,502,-226,-277,-220,-57,84.10344827586206,29,0,234,11,TE,0
0,1,10,870,-548,1418,-214,-244,30,335.8809523809524,42,1,8,1424,RB,0
1,1,64,243,-205,448,-542,-521,-21,185.29166666666666,24,1,17,483,RB,0
1,1,57,1205,711,494,-220,-147,-73,141.4047619047619,42,0,58,548,TE,0
1,1,76,727,1222,-495,-216,-196,-20,166.83333333333334,30,0,518,27,WR,0
0,1,0,1666,825,841,-158,-86,-72,283.0625,32,0,28,887,TE,0
0,1,0,1216,737,479,-150,-260,110,344.2,15,0,16,499,RB,0
1,1,33,238,238,0,-443,-453,10,84.1,40,0,142,148,RB,1
1,1,0,779,-1183,1962,-182,-175,-7,411.4583333333333,48,1,6,1973,WR,0
0,1,0,1096,612,484,-249,-308,59,382.84615384615387,13,0,6,485,RB,0
0,1,19,1912,1035,877,-164,-208,44,208.23809523809524,42,0,2,888,RB,0
0,1,0,826,-495,1321,-164,-276,112,346.8448275862069,58,1,329,1649,WR,1
0,1,0,1639,490,1149,-208,-55,-153,254.04651162790697,43,0,5,1143,TE,0
0,1,0,542,-467,1009,-227,-192,-35,268.2631578947368,38,1,16,1024,TE,0
0,1,0,616,-1277,1893,-211,-242,31,485.6666666666667,39,1,4,1896,WR,0
0,1,27,239,251,-12,-506,-371,-135,40.75,4,0,11,9,RB,1
0,1,36,204,-252,456,-575,-468,-107,169.5185185185185,27,1,13,469,RB,0
0,1,0,1586,614,972,-212,-55,-157,278.7142857142857,35,0,0,974,RB,0
0,1,0,588,651,-63,-175,-102,-73,256.97297297297297,37,0,491,429,TE,1
0,1,0,320,-996,1316,-277,-200,-77,409.6060606060606,33,1,0,1317,TE,0
0,1,0,1216,642,574,-271,-277,6,330.3888888888889,18,0,2,582,WR,0
0,1,19,480,-500,980,-225,-227,2,276.0,36,1,1,982,TE,0
0,1,0,495,491,4,-252,-131,-121,242.59259259259258,54,0,672,662,TE,1
0,1,0,524,-385,909,-131,-62,-69,231.94871794871796,39,1,0,920,TE,0
0,1,0,1548,654,894,-196,-98,-98,221.35714285714286,42,0,3,939,RB,0
0,1,0,336,-189,525,-490,-376,-114,159.5686274509804,51,1,101,646,RB,0
0,1,17,238,228,10,-495,-417,-78,41.0,2,0,5,15,RB,1
0,1,0,1894,1374,520,-250,-267,17,213.29166666666666,24,0,6,521,WR,0
0,1,13,0,-254,254,-729,-379,-350,92.25581395348837,43,0,10,274,RB,0
0,1,0,1081,251,830,-220,-202,-18,379.27272727272725,22,0,3,831,TE,0
0,1,0,496,-565,1061,-213,-212,-1,358.0,30,1,20,1073,TE,0
0,1,12,233,311,-78,-477,-404,-73,142.11111111111111,90,0,690,584,RB,1
0,1,0,1133,1211,-78,-219,-175,-44,341.9555555555556,45,0,830,730,WR,1
0,1,0,278,-1226,1504,-607,-749,142,548.3571428571429,28,1,9,1507,RB,0
0,1,0,1039,-683,1722,-261,-802,541,581.6875,32,1,11,1728,RB,0
0,1,42,118,254,-136,-518,-551,33,151.3,10,0,132,11,FB,0
0,1,21,19,226,-207,-728,-403,-325,147.71052631578948,38,0,345,151,RB,1
0,1,0,923,810,113,-393,-232,-161,132.64864864864865,37,0,176,275,WR,1
0,1,0,915,1317,-402,-542,-46,-496,224.70967741935485,93,0,1213,794,WR,1
0,1,0,1459,1422,37,-176,-113,-63,98.79166666666667,24,0,103,148,WR,1
1,1,0,549,-882,1431,-310,-151,-159,171.37962962962962,108,1,174,1611,WR,0
0,1,19,212,-214,426,-483,-392,-91,106.30508474576271,59,1,56,471,RB,0
0,1,19,595,223,372,-182,-403,221,181.86206896551724,29,0,43,404,FB,0
0,1,11,216,1272,-1056,-449,-6,-443,170.35,80,0,1173,124,WR,0
0,1,42,278,476,-198,-263,-91,-172,122.85507246376811,69,0,522,325,TE,1
0,1,0,988,-253,1241,-245,-325,80,504.56,25,1,2,1248,WR,0
0,1,0,405,-464,869,-222,-237,15,304.7,30,1,18,899,TE,0
0,1,0,1056,-179,1235,-207,-306,99,529.7916666666666,24,1,6,1246,WR,0
0,1,0,456,-479,935,-180,-233,53,222.8139534883721,43,1,21,955,TE,0
0,1,30,445,-851,1296,-276,-234,-42,404.6666666666667,33,1,6,1302,RB,0
0,1,0,577,-615,1192,-224,-196,-28,363.6969696969697,33,1,14,1198,FB,0
0,1,0,1511,686,825,-171,-276,105,269.44444444444446,36,0,61,888,RB,0
0,1,0,828,-1065,1893,-264,-142,-122,628.5,30,1,4,1887,WR,0
0,1,0,1027,-946,1973,-294,-372,78,565.4571428571429,35,1,7,1979,WR,0
0,1,0,597,-774,1371,-239,-187,-52,306.02222222222224,45,1,2,1371,WR,0
1,1,30,663,-1259,1922,-235,-81,-154,307.8095238095238,63,1,5,1948,WR,0
1,1,32,592,-1961,2553,-308,-33,-275,401.7846153846154,65,1,9,2588,WR,0
0,1,0,951,-442,1393,-176,-336,160,532.9629629629629,27,1,7,1405,WR,0
0,1,34,181,206,-25,-264,-485,221,219.23333333333332,30,0,301,286,TE,1
0,1,0,572,-1211,1783,-362,-199,-163,213.75,96,1,97,1881,WR,0
1,1,25,890,782,108,-197,-120,-77,69.25714285714285,35,0,71,170,WR,1
1,1,27,164,-1041,1205,-288,-39,-249,277.34090909090907,44,1,0,1220,WR,0
0,1,46,1271,-850,2121,-189,-221,32,406.0576923076923,52,1,6,2131,WR,0
0,1,0,741,-1299,2040,-264,-244,-20,387.47169811320754,53,1,0,2039,WR,0
0,1,0,588,-814,1402,-225,-170,-55,378.4864864864865,37,1,4,1410,WR,0
0,1,14,24,-236,260,-565,-468,-97,138.52380952380952,21,1,6,261,RB,0
0,1,0,925,-174,1099,-246,-317,71,508.40909090909093,22,1,2,1111,WR,0
0,1,27,251,231,20,-535,-464,-71,142.18867924528303,53,0,363,352,RB,1
0,1,0,647,-461,1108,-260,-274,14,448.32,25,1,4,1109,WR,0
0,1,0,814,491,323,-269,-320,51,274.0769230769231,13,0,14,331,WR,0
0,1,53,510,-586,1096,-215,-196,-19,187.81428571428572,70,1,85,1174,TE,0
0,1,81,185,1341,-1156,-658,-161,-497,323.525,40,0,1178,5,WR,0
1,1,8,205,-183,388,-483,-459,-24,175.95833333333334,24,1,30,418,RB,0
1,1,8,800,465,335,-65,-157,92,121.025,40,0,83,428,TE,1
0,1,38,1259,687,572,-159,-125,-34,168.02857142857144,35,0,9,588,RB,0
0,1,0,656,-850,1506,-222,-138,-84,306.14,50,1,0,1514,WR,0
0,1,0,1599,968,631,-132,-185,53,302.8181818181818,22,0,11,664,TE,0
0,1,26,814,-718,1532,-262,-158,-104,294.8269230769231,52,1,2,1530,WR,0
0,1,0,1241,260,981,-139,-253,114,356.86206896551727,29,0,21,1005,WR,0
0,1,31,277,-506,783,-270,-156,-114,255.0,32,1,12,780,TE,0
0,1,13,435,418,17,-254,-251,-3,31.0,1,0,1,13,WR,0
0,1,17,1056,454,602,-187,-134,-53,226.11111111111111,27,0,6,603,TE,0
0,1,37,885,1304,-419,-490,-83,-407,229.82608695652175,23,0,430,3,WR,0
0,1,10,270,-678,948,-300,-257,-43,291.8235294117647,34,1,8,960,WR,0
0,1,0,225,-157,382,-555,-565,10,319.5,12,1,2,383,RB,0
0,1,0,692,461,231,-282,-253,-29,224.8684210526316,38,0,313,552,WR,1
0,1,54,72,1293,-1221,-673,-188,-485,299.70454545454544,44,0,1222,4,WR,0
0,1,19,2154,-262,2416,-202,-563,361,390.25,64,1,58,2455,RB,0
0,1,36,1896,-203,2099,-350,-467,117,381.7857142857143,56,1,24,2119,RB,0
0,1,5,944,-1065,2009,-233,-238,5,274.22972972972974,74,1,9,2018,WR,0
1,1,23,1063,496,567,-236,-183,-53,255.41666666666666,24,0,28,585,TE,0
1,1,26,77,-1173,1250,-461,-164,-297,361.44444444444446,36,1,6,1251,WR,0
0,1,21,1655,-251,1906,-281,-479,198,356.875,56,1,26,1942,RB,0
0,1,4,1199,601,598,-148,-140,-8,176.27272727272728,33,0,0,591,WR,0
0,1,0,14,544,-530,-757,-261,-496,337.51724137931035,29,0,613,85,RB,0
0,1,19,155,-954,1109,-582,-309,-273,260.9183673469388,49,1,6,1128,TE,0
0,1,0,860,-252,1112,-174,-240,66,509.54545454545456,22,1,7,1109,WR,0
1,1,13,1,205,-204,-768,-566,-202,132.65,20,0,202,14,RB,0
1,1,11,648,-1146,1794,-247,-122,-125,271.04477611940297,67,1,7,1794,TE,0
0,1,0,186,-215,401,-508,-286,-222,285.1666666666667,18,1,9,408,RB,0
1,1,40,182,448,-266,-439,-232,-207,123.61538461538461,26,0,273,4,FB,0
1,1,38,249,421,-172,-410,-235,-175,109.08695652173913,23,0,185,26,TE,0
0,1,26,408,401,7,-197,-208,11,157.8421052631579,57,0,463,457,TE,1
0,1,28,1851,193,1658,-72,-242,170,292.3157894736842,57,0,14,1647,TE,0
0,1,16,869,480,389,350,-286,636,162.64,25,0,18,413,FB,0
0,1,0,424,-85,509,-211,-260,49,353.26666666666665,15,1,17,520,TE,0
0,1,14,1244,-212,1456,-256,-559,303,326.85714285714283,49,1,38,1504,WR,0
0,1,26,22,175,-153,-744,-525,-219,111.73913043478261,23,0,174,14,RB,0
0,1,27,441,216,225,-253,-417,164,131.0,24,0,23,246,FB,0
0,1,9,599,276,323,-190,-370,180,105.0,41,0,36,365,FB,0
0,1,0,1185,865,320,-217,-128,-89,299.75,12,0,0,328,WR,0
1,1,27,164,115,49,-719,-703,-16,107.62068965517241,29,0,6,24,RB,1
0,1,0,898,592,306,-235,-263,28,251.83333333333334,12,0,4,311,FB,0
0,1,0,755,801,-46,-299,-194,-105,96.66666666666667,9,0,73,0,TE,0
0,1,40,332,238,94,-469,-461,-8,97.58333333333333,12,0,14,138,RB,0
0,1,0,314,323,-9,-477,-486,9,66.56756756756756,37,0,140,142,RB,1
0,1,0,281,307,-26,-523,-518,-5,91.75,4,0,42,18,RB,1
0,1,0,1517,775,742,-184,-128,-56,199.47368421052633,38,0,14,748,WR,0
0,1,15,723,-907,1630,-227,-160,-67,356.5,46,1,6,1619,WR,0
0,1,0,515,-695,1210,-219,-144,-75,209.31578947368422,57,1,6,1218,TE,0
0,1,0,1005,347,658,-223,-325,102,334.1904761904762,21,0,20,668,WR,0
0,1,0,1841,566,1275,-226,-166,-60,354.1666666666667,36,0,0,1268,TE,0
0,1,0,952,740,212,-136,-192,56,308.125,8,0,4,219,WR,0
0,1,4,471,-466,937,-223,-160,-63,241.8421052631579,38,1,6,945,TE,0
0,1,2,169,-1518,1687,-490,-84,-406,340.06,50,1,0,1672,RB,0
0,1,26,470,-426,896,-190,-228,38,293.7741935483871,31,1,21,915,TE,0
0,1,0,978,-1029,2007,-292,-140,-152,448.0,45,1,0,2012,WR,0
0,1,0,1257,-1112,2369,-153,-67,-86,474.4,50,1,0,2376,WR,0
0,1,0,900,430,470,-159,-198,39,192.70833333333334,24,0,22,474,WR,0
0,1,0,1421,576,845,-206,-248,42,440.6,20,0,9,863,WR,0
0,1,0,1720,1163,557,-177,-141,-36,183.67741935483872,31,0,11,560,WR,0
0,1,0,252,19,233,-552,-716,164,114.41379310344827,29,0,29,274,RB,0
0,1,21,241,-446,687,-533,-169,-364,243.43333333333334,30,1,23,695,RB,0
0,1,5,195,-1613,1808,-471,-109,-362,377.125,48,1,2,1793,RB,0
0,1,3,448,-537,985,-235,-115,-120,276.8333333333333,36,1,0,988,TE,0
0,1,0,1059,536,523,-187,-268,81,353.3333333333333,15,0,0,507,WR,0
0,1,1,2050,1407,643,-143,-76,-67,201.375,32,0,0,645,WR,0
0,1,26,1728,740,988,-208,-195,-13,185.71698113207546,53,0,9,983,RB,0
0,1,0,515,-514,1029,-171,-63,-108,215.68627450980392,51,1,47,1056,TE,0
0,1,3,488,-587,1075,-193,-82,-111,237.95652173913044,46,1,16,1085,TE,0
0,1,0,867,-374,1241,-171,-202,31,321.70588235294116,51,1,194,1446,WR,0
0,1,21,890,-1014,1904,-156,-145,-11,389.7551020408163,49,1,4,1895,WR,0
0,1,0,298,-31,329,-495,-736,241,129.06666666666666,30,1,6,337,RB,0
0,1,0,215,-206,421,-490,-318,-172,122.76470588235294,34,1,8,426,RB,0
0,1,2,526,-537,1063,-213,-7,-206,216.78,50,1,11,1070,TE,0
0,1,53,1249,-479,1728,-280,-186,-94,341.6078431372549,51,1,23,1740,TE,0
0,1,46,8,-212,220,-793,-472,-321,133.63333333333333,30,1,23,224,RB,0
0,1,0,1567,1266,301,-166,-224,58,202.4,15,0,7,315,WR,0
0,1,0,1166,269,897,-194,-181,-13,276.6060606060606,33,0,12,915,WR,0
0,1,32,248,-801,1049,-673,-135,-538,269.94444444444446,54,1,38,1075,WR,0
0,1,0,917,619,298,-203,-253,50,276.27272727272725,11,0,8,301,WR,0
0,1,0,1955,1468,487,-156,-147,-9,226.95238095238096,21,0,3,486,WR,0
0,1,32,256,304,-48,-469,-468,-1,87.24,50,0,157,122,RB,1
0,1,0,1,-1440,1441,-646,-314,-332,401.2439024390244,41,1,10,1444,RB,0
0,1,22,1150,483,667,-198,-187,-11,177.6216216216216,37,0,5,672,TE,0
0,1,84,701,-1121,1822,-270,-185,-85,388.40425531914894,47,1,17,1834,WR,0
0,1,20,1272,1313,-41,-241,-157,-84,94.71428571428571,35,0,186,140,TE,1
0,1,0,557,-465,1022,-183,-220,37,249.85714285714286,42,1,3,1024,TE,0
0,1,10,1601,965,636,-189,-181,-8,157.0,40,0,11,643,WR,0
0,1,34,713,-791,1504,-161,-151,-10,272.4107142857143,56,1,4,1510,WR,0
0,1,72,249,-780,1029,-648,-163,-485,278.0,45,1,8,1044,WR,0
0,1,0,931,-475,1406,-226,-279,53,545.4230769230769,26,1,2,1413,WR,0
0,1,3,660,-1436,2096,-202,-190,-12,436.0888888888889,45,1,16,1972,WR,0
0,1,34,424,1554,-1130,-530,-135,-395,273.6521739130435,46,0,1125,5,WR,0
0,1,0,1809,823,986,-159,-163,4,352.60714285714283,28,0,0,976,WR,0
0,1,54,679,2281,-1602,-337,-195,-142,359.69565217391306,46,0,1628,12,RB,0
0,1,64,6,-606,612,-474,-174,-300,212.84375,32,1,31,622,TE,0
0,1,0,730,312,418,-229,-232,3,333.8333333333333,12,0,10,393,WR,0
0,1,54,192,1964,-1772,-513,-50,-463,351.9811320754717,53,0,1806,6,RB,0
0,1,42,33,215,-182,-792,-540,-252,108.51851851851852,27,0,233,30,RB,0
0,1,11,545,-436,981,-231,-305,74,284.14285714285717,35,1,33,999,TE,0
0,1,0,1451,365,1086,-261,-387,126,533.047619047619,21,0,7,1093,WR,0
0,1,5,497,490,7,-238,-242,4,147.47619047619048,42,0,319,328,TE,1
0,1,0,1743,1091,652,-174,-180,6,238.82142857142858,28,0,20,668,WR,0
0,1,17,251,-1482,1733,-476,-242,-234,337.9622641509434,53,1,2,1717,WR,0
0,1,6,627,-967,1594,-218,-207,-11,329.4583333333333,48,1,2,1602,WR,0
0,1,0,722,-515,1237,-189,-255,66,327.92105263157896,38,1,2,1232,WR,0
0,1,16,1567,496,1071,-145,-246,101,315.38235294117646,34,0,15,1079,RB,0
0,1,0,1479,702,777,-199,-177,-22,207.6216216216216,37,0,12,777,WR,0
0,1,9,1214,546,668,-98,-114,16,197.4,35,0,11,674,WR,0
0,1,29,429,-490,919,-285,-271,-14,253.69444444444446,36,1,2,938,TE,0
0,1,31,1417,230,1187,-247,-446,199,259.6530612244898,49,0,14,1221,RB,0
0,1,0,931,-532,1463,-283,-299,16,505.8965517241379,29,1,4,1473,WR,0
0,1,0,814,-744,1558,-224,-246,22,300.09615384615387,52,1,2,1559,WR,0
0,1,19,1294,955,339,-252,-203,-49,124.03703703703704,27,0,9,348,WR,0
0,1,0,383,-431,814,-262,-193,-69,288.0344827586207,29,1,11,835,TE,0
0,1,0,241,-2110,2351,-489,-128,-361,413.4310344827586,58,1,4,2364,RB,0
0,1,33,290,-545,835,-260,-175,-85,307.7857142857143,28,1,10,836,WR,0
0,1,0,249,-10,259,-573,-592,19,277.4,10,1,12,272,RB,0
0,1,2,923,-799,1722,-300,-87,-213,338.98,50,1,4,1700,WR,0
0,1,0,591,-363,954,-182,-285,103,348.92857142857144,28,1,3,968,WR,0
0,1,0,878,-91,969,-228,-586,358,503.1363636363636,22,1,2,980,WR,0
0,1,6,1163,440,723,-138,-215,77,123.85,60,0,3,697,WR,0
0,1,0,119,-455,574,-369,-146,-223,268.32307692307694,65,1,575,1162,TE,1
0,1,0,198,-201,399,-528,-482,-46,218.1,20,1,11,425,RB,0
0,1,22,370,-919,1289,-237,-214,-23,334.7692307692308,39,1,4,1288,WR,0
0,1,0,272,-223,495,-537,-516,-21,223.54545454545453,22,1,3,503,RB,0
0,1,0,1847,1180,667,-167,-151,-16,237.17241379310346,29,0,0,680,WR,0
0,1,0,623,10,613,-260,-626,366,296.21276595744683,47,0,346,971,WR,1
0,1,0,739,571,168,-224,-290,66,236.375,8,0,16,170,WR,0
0,1,0,741,659,82,-141,-324,183,125.125,16,0,21,141,WR,0
0,1,51,233,-564,797,-284,-257,-27,282.62068965517244,29,1,10,819,WR,0
0,1,58,254,1307,-1053,-475,-255,-220,270.225,40,0,1060,16,RB,0
0,1,23,2,-8,10,-522,-495,-27,18.0,2,0,14,4,WR,1
0,1,43,1927,2059,-132,-184,-138,-46,80.1875,16,0,141,2,WR,0
1,1,29,1860,524,1336,-233,-186,-47,286.8541666666667,48,0,24,1365,TE,0
0,1,0,1045,-512,1557,-223,-329,106,529.1666666666666,30,1,0,1557,WR,0
0,1,19,310,276,34,-512,-529,17,92.77142857142857,35,0,110,164,RB,1
0,1,12,220,255,-35,-526,-382,-144,170.0701754385965,57,0,492,474,RB,1
1,1,37,177,-203,380,-538,-514,-24,104.25581395348837,43,1,48,404,RB,0
0,1,0,1354,1442,-88,-201,-78,-123,131.0,8,0,79,0,WR,0
0,1,34,640,-512,1152,-210,-151,-59,312.7837837837838,37,1,16,1177,FB,0
0,1,0,435,28,407,-183,-221,38,252.8421052631579,19,0,18,437,TE,0
0,1,28,392,-559,951,-175,-96,-79,338.48275862068965,29,1,4,958,TE,0
0,1,0,273,-605,878,-553,-517,-36,426.09090909090907,22,1,2,912,RB,0
0,1,28,1553,480,1073,-112,-131,19,218.63934426229508,61,0,133,1215,TE,0
0,1,17,500,447,53,-157,-185,28,68.42105263157895,57,0,186,219,TE,1
0,1,0,797,794,3,-33,-44,11,77.04545454545455,66,0,252,234,WR,1
1,1,7,853,-1649,2502,-57,-100,43,380.0882352941176,68,1,0,2514,WR,0
1,1,0,463,-503,966,-98,-89,-9,218.68085106382978,47,1,6,962,TE,0
1,1,27,830,937,-107,-249,-33,-216,61.5,40,0,116,8,WR,0
1,1,30,0,-884,884,-477,-225,-252,212.3409090909091,44,0,13,887,TE,0
0,1,29,687,-927,1614,-138,-130,-8,353.65909090909093,44,1,2,1558,WR,0
0,1,15,10,-242,252,-736,-405,-331,120.5111111111111,45,1,109,342,RB,1
1,1,19,1515,1375,140,-142,25,-167,77.5,24,0,11,162,WR,0
1,1,18,219,-78,297,-448,-75,-373,122.36666666666666,30,1,2,300,RB,0
0,1,56,764,2104,-1340,-156,21,-177,351.92105263157896,38,0,1342,2,WR,0
0,1,0,1528,544,984,-202,-73,-129,260.3076923076923,39,0,16,1013,TE,0
0,1,0,996,451,545,-113,-237,124,328.94444444444446,18,0,7,549,WR,0
0,1,47,559,-794,1353,-193,-123,-70,322.3095238095238,42,1,9,1340,TE,0
0,1,8,725,482,243,-132,47,-179,69.56521739130434,46,0,23,255,TE,0
0,1,0,772,2054,-1282,-251,-119,-132,315.0243902439024,41,0,1281,4,WR,0
0,1,13,229,65,164,-465,-179,-286,70.6734693877551,49,0,21,185,RB,0
0,1,0,766,-159,925,-195,-245,50,235.1219512195122,41,1,15,934,WR,0
0,1,58,7,-15,22,-757,-731,-26,111.87912087912088,91,0,155,197,RB,1
0,1,29,1,6,-5,-735,-640,-95,135.67164179104478,67,0,116,87,RB,1
0,1,2,8,16,-8,-734,-715,-19,93.1919191919192,99,0,164,123,RB,1
0,1,31,20,20,0,-695,-678,-17,91.03947368421052,76,0,53,84,RB,1
0,1,0,210,-585,795,-518,-274,-244,305.52830188679246,53,1,364,1169,RB,1
0,1,22,236,-86,322,-398,-73,-325,106.94444444444444,36,1,4,309,RB,0
0,1,0,562,-1105,1667,-254,-195,-59,352.55102040816325,49,1,8,1678,WR,0
0,1,21,104,-797,901,-320,-129,-191,286.5151515151515,33,1,24,931,WR,0
0,1,0,292,-428,720,-522,-537,15,245.03125,32,1,62,780,RB,0
0,1,0,1517,1034,483,-30,-33,3,188.6,25,0,19,481,WR,0
0,1,0,699,-725,1424,-198,-337,139,398.72222222222223,36,1,7,1435,WR,0
0,1,31,717,-1242,1959,-295,-183,-112,356.2037037037037,54,1,5,1955,WR,0
0,1,4,194,-558,752,-222,-153,-69,273.0,28,1,10,745,TE,0
0,1,0,230,-312,542,-564,-450,-114,151.83333333333334,36,1,16,549,RB,0
0,1,0,3,64,-61,-762,-764,2,46.0,14,0,86,22,RB,1
0,1,3,682,-969,1651,-242,106,-348,247.35714285714286,70,1,60,1702,WR,0
0,1,0,1831,1838,-7,-162,-1,-161,52.0,5,0,8,2,WR,1
0,1,56,575,-1099,1674,-232,-139,-93,308.54545454545456,55,1,13,1705,WR,0
0,1,34,426,-581,1007,-212,-163,-49,189.8,75,1,205,1223,TE,0
1,1,56,895,-891,1786,-184,-165,-19,298.21875,64,1,40,1838,WR,0
0,1,0,768,143,625,-165,-386,221,397.2352941176471,17,0,5,624,WR,0
0,1,33,255,-165,420,-559,-478,-81,171.46153846153845,26,1,18,435,RB,0
0,1,0,640,650,-10,-246,-223,-23,218.9047619047619,42,0,457,445,WR,1
0,1,0,28,153,-125,-501,-482,-19,162.11111111111111,9,0,145,1,FB,0
0,1,18,1139,1868,-729,-141,-18,-123,265.44444444444446,27,0,717,4,WR,0
0,1,0,954,-1142,2096,-175,-60,-115,452.0851063829787,47,1,6,2103,WR,0
0,1,6,1497,695,802,-228,-132,-96,255.27272727272728,33,0,13,827,TE,0
0,1,0,277,-47,324,-489,-509,20,283.8333333333333,12,1,4,347,RB,0
0,1,0,284,-56,340,-539,-546,7,248.71428571428572,14,1,5,338,RB,0
0,1,24,200,-218,418,-500,-473,-27,146.5625,32,1,13,447,RB,0
0,1,30,948,460,488,-300,-220,-80,192.28,25,0,12,488,FB,0
0,1,60,480,185,295,-188,-407,219,165.39473684210526,38,0,148,437,TE,1
0,1,3,251,-220,471,-567,-579,12,184.77777777777777,27,1,26,492,RB,0
0,1,33,856,-319,1175,-183,-430,247,282.6744186046512,43,1,11,1189,WR,0
0,1,0,537,-621,1158,-225,-200,-25,345.0,34,1,14,1165,TE,0
0,1,0,712,-499,1211,-202,-177,-25,273.468085106383,47,1,10,1220,FB,0
0,1,0,1158,742,416,-196,-425,229,328.6666666666667,15,0,14,410,RB,0
0,1,31,2,-257,259,-757,-475,-282,129.95744680851064,47,1,86,362,RB,1
0,1,32,745,-1045,1790,-186,-213,27,317.64516129032256,62,1,39,1818,WR,0
0,1,17,1134,-778,1912,-288,-158,-130,469.3414634146341,41,1,6,1931,WR,0
0,1,0,1500,570,930,-247,-178,-69,234.68421052631578,38,0,20,893,TE,0
0,1,0,10,-37,47,-666,-495,-171,87.17021276595744,47,0,72,91,RB,1
0,1,0,527,566,-39,-211,-243,32,188.64864864864865,37,0,369,328,WR,1
0,1,15,6,170,-164,-748,-556,-192,76.28125,32,0,181,2,RB,0
0,1,0,865,716,149,-213,-279,66,161.0,13,0,7,174,WR,0
0,1,73,1650,1459,191,-141,-185,44,126.73684210526316,19,0,37,235,WR,0
0,1,3,224,-1291,1515,-461,-200,-261,374.7906976744186,43,1,8,1537,WR,0
1,1,54,177,-13,190,-385,-719,334,105.0952380952381,42,1,9,181,RB,0
0,1,0,1749,1241,508,-239,-256,17,239.36363636363637,22,0,14,518,WR,0
0,1,3,1439,468,971,-212,-210,-2,206.1875,48,0,28,987,TE,0
0,1,0,896,-375,1271,-178,-214,36,348.6190476190476,42,1,86,1359,WR,0
1,1,1,1961,2111,-150,-82,-52,-30,68.68181818181819,22,0,155,11,WR,0
1,1,26,447,683,-236,-266,-194,-72,137.77777777777777,18,0,244,18,TE,0
0,1,91,596,1004,-408,-415,-136,-279,217.5,24,0,441,10,RB,0
0,1,36,699,-1125,1824,-187,-161,-26,334.08620689655174,58,1,9,1821,WR,0
0,1,0,1277,264,1013,-269,-310,41,415.04,25,0,4,1013,WR,0
0,1,0,630,-367,997,-337,-343,6,315.59375,32,1,2,1005,TE,0
0,1,0,1189,575,614,-155,-239,84,152.96,50,0,73,683,WR,0
0,1,4,498,648,-150,-227,-78,-149,98.625,24,0,199,39,TE,1
0,1,0,568,-857,1425,-264,-215,-49,301.4166666666667,48,1,6,1430,WR,0
0,1,13,1256,1073,183,-28,-27,-1,93.94444444444444,18,0,25,189,WR,0
1,1,45,1591,519,1072,-246,-211,-35,256.92857142857144,42,0,6,1085,TE,0
1,1,21,1707,523,1184,-157,-191,34,255.9787234042553,47,0,37,1208,TE,0
0,1,0,1067,606,461,-183,-379,196,336.6470588235294,17,0,7,483,RB,0
1,1,25,299,3,296,-553,-765,212,109.90243902439025,41,0,15,316,RB,0
0,1,0,1045,607,438,-195,-470,275,264.7,20,0,3,424,RB,0
0,1,0,872,216,656,-228,-698,470,332.34090909090907,44,0,314,972,RB,1
0,1,4,641,-528,1169,-259,-262,3,252.06382978723406,47,1,10,1177,WR,0
0,1,0,211,458,-247,-469,-478,9,308.22222222222223,9,0,275,4,RB,0
0,1,4,141,579,-438,-544,-283,-261,201.65384615384616,26,0,437,0,RB,0
1,1,23,251,-184,435,-471,-490,19,113.65,40,1,21,436,RB,0
1,1,13,486,917,-431,-113,-62,-51,151.07407407407408,27,0,426,27,TE,0
0,1,0,914,-352,1266,-219,-337,118,515.08,25,1,9,1258,WR,0
0,1,61,2027,2002,25,-151,-127,-24,50.6,5,0,8,26,TE,1
0,1,2,331,-1306,1637,-261,-62,-199,380.1521739130435,46,1,16,1676,WR,0
0,1,0,1046,-360,1406,-266,-331,65,475.0,30,1,7,1406,FB,0
0,1,37,265,421,-156,-459,-136,-323,134.6551724137931,29,0,212,45,WR,1
0,1,33,275,440,-165,-483,-279,-204,135.83333333333334,36,0,284,108,WR,1
0,1,13,285,-238,523,-482,-506,24,208.03703703703704,27,1,23,542,WR,0
0,1,32,232,-491,723,-229,-163,-66,303.52,25,1,4,732,TE,0
0,1,0,1033,745,288,-225,-288,63,169.69565217391303,46,0,220,517,WR,1
1,1,26,516,-610,1126,-182,-186,4,299.5,38,1,9,1144,TE,0
0,1,0,169,-776,945,-309,-261,-48,329.1,30,1,10,939,WR,0
0,1,0,1169,419,750,271,139,132,167.17021276595744,47,0,0,744,WR,0
0,1,32,909,364,545,-188,-181,-7,171.58064516129033,31,0,17,552,WR,0
0,1,2,424,-644,1068,-204,-157,-47,255.92857142857142,42,1,17,1092,TE,0
0,1,23,1305,469,836,-294,-81,-213,251.6,35,0,2,843,TE,0
0,1,0,787,-92,879,-292,-308,16,460.1,20,1,4,894,WR,0
0,1,6,508,-885,1393,-296,-233,-63,312.8636363636364,44,1,7,1393,WR,0
0,1,45,1131,391,740,-257,-261,4,260.17241379310343,29,0,16,740,TE,0
0,1,0,750,-393,1143,-221,-338,117,463.16,25,1,14,1147,WR,0
0,1,11,235,-612,847,-525,-218,-307,185.4313725490196,51,1,16,859,RB,0
0,1,0,279,-1263,1542,-523,-658,135,578.925925925926,27,1,5,1539,RB,0
0,1,39,200,-466,666,-261,-214,-47,317.39130434782606,23,1,2,692,TE,0
0,1,0,760,274,486,-206,-325,119,358.5,14,0,9,474,WR,0
0,1,0,978,-81,1059,-177,-315,138,463.82608695652175,23,1,13,1053,WR,0
0,1,38,1042,-236,1278,-330,-537,207,300.1111111111111,45,1,11,1278,RB,0
0,1,0,895,-710,1605,-189,-130,-59,320.8979591836735,49,1,5,1562,WR,0
0,1,35,844,945,-101,-230,-167,-63,123.0,9,0,97,3,RB,0
0,1,0,770,678,92,-179,-250,71,165.66666666666666,6,0,17,91,WR,1
0,1,26,478,-446,924,-222,-194,-28,293.3030303030303,33,1,4,943,TE,0
0,1,0,840,667,173,-246,-273,27,185.2,10,0,21,176,WR,0
0,1,42,264,1757,-1493,-280,-192,-88,421.5,36,0,1496,6,RB,0
0,1,14,297,-241,538,-447,-496,49,207.2962962962963,27,1,20,551,WR,0
0,1,38,231,-270,501,-475,-458,-17,181.14285714285714,28,1,6,534,RB,0
0,1,0,453,-15,468,-228,-480,252,220.86363636363637,44,1,212,688,TE,1
0,1,0,904,-445,1349,-232,-324,92,501.8888888888889,27,1,2,1364,WR,0
0,1,16,472,-450,922,-204,-175,-29,295.1875,32,1,11,930,TE,0
0,1,37,136,-438,574,-260,-156,-104,283.6521739130435,23,1,27,600,TE,0
0,1,30,324,490,-166,-248,-174,-74,187.1818181818182,11,0,173,15,TE,0
0,1,11,32,253,-221,-725,-432,-293,97.62857142857143,35,0,237,21,RB,0
0,1,10,746,-1255,2001,-193,-197,4,358.43636363636364,55,1,4,1997,WR,0
0,1,2,544,-959,1503,-294,-98,-196,381.35,40,1,1,1526,WR,0
0,1,47,14,19,-5,-860,-782,-78,119.09433962264151,53,0,49,68,RB,1
0,1,0,1434,-359,1793,-176,-417,241,326.5689655172414,58,1,3,1819,WR,0
1,1,0,942,-927,1869,-216,-2,-214,319.95,60,1,0,1886,WR,0
1,1,0,641,432,209,-205,-81,-124,86.34782608695652,23,0,9,223,WR,0
0,1,20,376,557,-181,-483,-197,-286,115.93548387096774,31,0,211,20,RB,0
0,1,33,846,794,52,-155,-154,-1,102.28888888888889,45,0,208,223,WR,1
1,1,28,1235,927,308,-36,-39,3,107.82222222222222,45,0,60,419,WR,0
0,1,15,1330,1297,33,-96,-116,20,89.12222222222222,90,0,415,421,WR,1
0,1,11,918,236,682,-401,-368,-33,264.6666666666667,27,0,3,665,RB,0
0,1,30,11,-2,13,-820,-778,-42,111.68888888888888,45,0,13,52,RB,1
0,1,11,129,214,-85,-252,-486,234,77.09433962264151,53,0,158,85,RB,1
0,1,0,769,-1170,1939,-137,-199,62,350.5892857142857,56,1,2,1935,WR,0
0,1,14,1544,270,1274,-224,-428,204,305.1666666666667,42,0,4,1283,RB,0
0,1,54,1486,443,1043,-173,-206,33,308.97058823529414,34,0,15,1050,TE,0
0,1,14,1322,686,636,-131,-144,13,196.57575757575756,33,0,3,641,TE,0
0,1,29,1345,276,1069,-293,-367,74,310.5,36,0,13,1091,RB,0
0,1,0,826,-975,1801,-164,-153,-11,341.5925925925926,54,1,4,1801,WR,0
0,1,0,10,2,8,-661,-629,-32,60.76470588235294,34,0,134,150,RB,1
1,1,34,1541,491,1050,-169,-147,-22,218.56,50,0,60,1061,TE,0
0,1,3,586,-488,1074,-214,-242,28,308.6857142857143,35,1,7,1090,TE,0
0,1,14,1222,448,774,-177,-135,-42,201.42105263157896,38,0,7,762,TE,0
0,1,0,1198,702,496,-317,-350,33,393.84615384615387,13,0,4,498,WR,0
0,1,12,943,862,81,-106,-125,19,114.8395061728395,81,0,371,447,WR,1
1,1,37,10,-2,12,-829,-799,-30,100.8936170212766,47,0,76,37,RB,1
0,1,16,245,-305,550,-555,-472,-83,179.56666666666666,30,1,17,539,RB,0
0,1,0,630,-544,1174,-247,-230,-17,339.96153846153845,52,1,283,1463,WR,1
0,1,5,668,-1154,1822,-204,-223,19,386.51063829787233,47,1,6,1830,WR,0
0,1,0,595,-297,892,-222,-259,37,349.1551724137931,58,1,562,1456,TE,1
0,1,39,258,-1697,1955,-448,-125,-323,328.9830508474576,59,1,2,1955,RB,0
1,1,11,472,-504,976,-230,-55,-175,176.31666666666666,60,1,27,1011,TE,0
1,1,13,783,-957,1740,-213,-101,-112,282.9846153846154,65,1,24,1770,TE,0
1,1,13,311,241,70,-490,-456,-34,113.90243902439025,41,0,180,265,RB,1
0,1,0,490,-445,935,-225,-200,-25,171.31147540983608,61,1,15,958,TE,0
1,1,87,12,173,-161,-751,-471,-280,121.44,25,0,176,23,RB,0
1,1,56,770,-766,1536,-239,-234,-5,290.5660377358491,53,1,10,1537,FB,0
0,1,0,938,-165,1103,-188,-309,121,397.67857142857144,28,1,4,1117,TE,0
0,1,15,890,1087,-197,-172,-196,24,89.27272727272727,22,0,201,2,TE,0
0,1,0,854,-1294,2148,-187,-188,1,337.359375,64,1,14,2166,WR,0
0,1,35,231,1033,-802,-500,-255,-245,192.0,42,0,793,13,RB,0
1,1,24,481,-495,976,-238,-80,-158,215.72549019607843,51,1,30,1026,TE,0
0,1,0,274,-87,361,-483,-572,89,326.3333333333333,12,1,4,391,RB,0
0,1,0,453,507,-54,-254,-83,-171,73.0,29,0,103,45,TE,1
0,1,0,915,-591,1506,-101,-207,106,355.3720930232558,43,1,4,1527,WR,0
1,1,45,1529,1544,-15,-171,-42,-129,39.4,5,0,13,15,WR,1
1,1,14,779,247,532,-434,-372,-62,253.2608695652174,23,0,18,559,RB,0
1,1,1,293,-495,788,-235,-104,-131,180.01960784313727,51,1,51,836,TE,0
1,1,50,1060,469,591,-219,-164,-55,185.4375,32,0,15,597,WR,0
0,1,0,564,223,341,-126,-491,365,179.7058823529412,51,0,266,593,FB,1
0,1,0,801,-701,1502,-179,-133,-46,302.5,66,1,216,1739,TE,0
1,1,31,1728,2069,-341,-267,-85,-182,197.31578947368422,19,0,344,7,RB,0
1,1,10,1410,1498,-88,-172,-29,-143,86.71428571428571,14,0,103,9,TE,0
1,1,44,1242,1219,23,-149,-52,-97,33.0,1,0,2,32,TE,0
1,1,41,1024,214,810,-387,-361,-26,294.4642857142857,28,0,13,799,RB,0
0,1,3,270,-511,781,-482,-89,-393,195.6590909090909,44,1,16,806,RB,0
0,1,26,274,-491,765,-484,-161,-323,230.16216216216216,37,1,16,797,RB,0
0,1,70,1397,575,822,-177,-53,-124,225.0,36,0,16,808,TE,0
0,1,0,437,-492,929,-99,18,-117,176.87301587301587,63,1,48,954,TE,0
0,1,29,429,-466,895,-137,-17,-120,212.51063829787233,47,1,14,941,TE,0
0,1,56,1420,207,1213,-180,-457,277,281.8636363636364,44,0,19,1211,RB,0
0,1,73,449,-468,917,-175,-114,-61,239.55,40,1,22,948,TE,0
1,1,21,499,-616,1115,-191,-111,-80,213.13793103448276,58,1,40,1151,TE,0
0,1,8,638,616,22,-165,-111,-54,59.09090909090909,11,0,10,29,TE,1
0,1,0,1512,1062,450,-211,-221,10,340.42857142857144,14,0,0,450,WR,0
1,1,45,917,1309,-392,-145,-108,-37,83.02083333333333,48,0,414,8,WR,0
0,1,16,1106,1039,67,-117,-178,61,94.35064935064935,77,0,321,407,WR,1
1,1,48,13,312,-299,-662,-483,-179,95.22222222222223,54,0,350,28,RB,0
0,1,29,1964,878,1086,-62,-91,29,191.57894736842104,57,0,6,1117,WR,0
0,1,9,1580,667,913,-109,-224,115,248.80232558139534,86,0,595,1484,TE,1
0,1,31,296,451,-155,-271,-264,-7,156.8181818181818,11,0,169,6,FB,0
0,1,13,1968,1266,702,-204,-207,3,168.26190476190476,42,0,1,699,TE,0
0,1,5,206,-468,674,-464,-156,-308,168.24444444444444,45,1,22,693,TE,0
0,1,0,1810,911,899,-252,-141,-111,270.61764705882354,34,0,0,898,WR,0
0,1,0,539,355,184,-239,-254,15,340.5625,48,0,729,914,TE,1
0,1,10,173,-604,777,-522,-237,-285,210.0487804878049,41,1,9,777,RB,0
0,1,0,853,827,26,-75,73,-148,59.916666666666664,24,0,51,60,TE,1
0,1,10,633,-687,1320,-164,-198,34,284.2340425531915,47,1,2,1331,WR,0
0,1,0,512,477,35,-273,-175,-98,60.44444444444444,9,0,10,61,FB,0
0,1,0,446,461,-15,-187,-131,-56,23.0,2,0,26,17,TE,1
0,1,0,759,-1216,1975,-152,-196,44,355.7837837837838,74,1,324,2298,WR,0
0,1,0,2025,378,1647,-225,-323,98,508.6363636363636,33,0,2,1645,WR,0
0,1,1,556,-486,1042,-234,-11,-223,210.68,50,1,15,1044,FB,0
0,1,0,587,288,299,-266,-266,0,316.0,10,0,9,314,FB,0
0,1,0,1,-181,182,-725,-396,-329,109.22222222222223,27,1,13,243,RB,0
0,1,10,307,-1017,1324,-454,-125,-329,302.1363636363636,44,1,5,1309,RB,0
0,1,0,1519,915,604,-209,-144,-65,204.16666666666666,30,0,0,604,WR,0
0,1,19,1009,-1036,2045,-137,-173,36,355.9824561403509,57,1,13,2049,WR,0
0,1,0,1454,821,633,-129,-192,63,277.0,23,0,3,626,RB,0
0,1,0,191,591,-400,-546,-249,-297,181.05555555555554,36,0,504,93,WR,1
0,1,54,278,-616,894,-237,-221,-16,316.3666666666667,30,1,9,927,TE,0
0,1,0,454,446,8,-104,-44,-60,56.7,20,0,25,28,TE,1
0,1,43,315,-722,1037,-570,-197,-373,246.37777777777777,45,1,30,1063,RB,0
0,1,0,461,-509,970,-209,-404,195,364.4642857142857,56,1,499,1467,WR,1
0,1,42,890,1202,-312,-322,-266,-56,209.0,17,0,343,26,RB,0
0,1,17,231,-258,489,-533,-520,-13,150.625,32,1,1,485,RB,0
0,1,4,1964,1456,508,-235,-158,-77,191.37037037037038,27,0,2,530,WR,0
0,1,0,669,-897,1566,-249,-232,-17,360.77272727272725,44,1,0,1567,WR,0
0,1,10,381,451,-70,-307,-210,-97,228.78571428571428,42,0,516,453,TE,1
0,1,4,215,-205,420,-546,-471,-75,183.14285714285714,21,1,4,397,RB,0
0,1,17,297,-225,522,-502,-423,-79,134.5,40,1,6,543,RB,0
0,1,0,524,952,-428,-198,-220,22,182.4,25,0,452,2,WR,0
0,1,10,835,-969,1804,-188,-209,21,320.30357142857144,56,1,8,1829,WR,0
0,1,0,825,-767,1592,-218,-282,64,333.8125,48,1,2,1610,WR,0
0,1,0,1338,-217,1555,-187,-593,406,507.3636363636364,33,1,6,1584,RB,0
0,1,19,472,-363,835,-236,-119,-117,295.85714285714283,28,1,17,849,TE,0
0,1,4,418,-449,867,-222,-219,-3,325.3333333333333,27,1,2,905,TE,0
0,1,0,979,607,372,-143,-174,31,146.1153846153846,26,0,3,383,WR,0
0,1,14,29,441,-412,-401,-58,-343,164.66666666666666,33,0,438,21,TE,0
0,1,0,719,-855,1574,-171,-295,124,371.51162790697674,43,1,2,1565,WR,0
0,1,0,1040,564,476,-297,-254,-43,233.5151515151515,33,0,151,630,TE,1
0,1,0,865,-513,1378,-146,-297,151,437.72727272727275,33,1,9,1378,WR,0
0,1,65,610,628,-18,-84,-7,-77,81.4074074074074,27,0,115,65,TE,1
0,1,0,540,-432,972,-142,-170,28,311.2903225806452,31,1,0,968,TE,0
0,1,27,182,1006,-824,-450,-122,-328,246.40540540540542,37,0,833,15,RB,0
0,1,0,603,-284,887,-530,-545,15,240.51282051282053,39,1,18,889,RB,0
0,1,9,790,-514,1304,-193,-132,-61,332.6923076923077,39,1,15,1299,WR,0
0,1,0,985,1222,-237,-277,-88,-189,119.8,20,0,193,4,WR,0
0,1,36,200,-1109,1309,-459,-65,-394,346.4102564102564,39,1,16,1318,TE,0
0,1,0,1115,-197,1312,-152,-1,-151,486.82142857142856,28,1,19,1345,WR,0
0,1,7,1165,243,922,-240,-455,215,198.06,50,0,9,898,RB,0
0,1,0,532,-326,858,-292,-186,-106,318.25925925925924,27,1,30,874,WR,0
0,1,0,571,466,105,-226,-234,8,232.93939393939394,33,0,328,428,TE,1
0,1,0,515,-291,806,-251,-49,-202,363.3636363636364,22,1,8,802,WR,0
0,1,16,1327,744,583,-215,-230,15,177.36363636363637,33,0,26,596,WR,0
1,1,45,8,-2,10,-740,-698,-42,90.30864197530865,81,0,156,141,RB,1
1,1,54,4,266,-262,-804,-398,-406,101.32352941176471,34,0,264,9,RB,0
1,1,40,299,1981,-1682,-491,-28,-463,372.17021276595744,47,0,1661,2,TE,0
1,1,45,270,1334,-1064,-566,-114,-452,287.28205128205127,39,0,1094,11,TE,0
0,1,0,877,286,591,-127,-222,95,407.0,15,0,3,602,WR,0
0,1,27,855,938,-83,-237,-211,-26,116.25,8,0,82,6,WR,0
0,1,97,1328,311,1017,-314,-532,218,256.875,40,0,8,1035,WR,0
0,1,45,732,-952,1684,-275,-166,-109,310.25925925925924,54,1,22,1693,WR,0
0,1,26,409,-525,934,-202,-61,-141,252.5897435897436,39,1,16,937,TE,0
0,1,0,1206,229,977,-197,-199,2,520.8421052631579,19,0,13,970,WR,0
0,1,0,229,-274,503,-365,-286,-79,344.42105263157896,57,1,718,1225,RB,1
0,1,0,957,220,737,-165,-318,153,456.0,17,0,7,747,WR,0
0,1,3,1995,1232,763,-180,-107,-73,203.75,36,0,1,738,WR,0
0,1,0,1403,877,526,-182,-47,-135,186.58620689655172,29,0,1,529,WR,0
1,1,18,423,1143,-720,-120,-65,-55,186.35135135135135,37,0,719,4,TE,0
1,1,16,864,-1021,1885,-178,-234,56,412.78723404255317,47,1,3,1890,WR,0
0,1,49,179,549,-370,-307,-216,-91,178.8181818181818,22,0,370,2,TE,0
0,1,0,870,495,375,-185,-299,114,298.42857142857144,14,0,25,385,WR,0
0,1,32,117,-267,384,-438,-401,-37,131.06666666666666,45,1,133,520,RB,1
0,1,12,908,-589,1497,-202,-121,-81,282.4736842105263,76,1,317,1817,WR,0
0,1,0,1701,1228,473,-182,-107,-75,353.35714285714283,14,0,11,484,WR,0
0,1,0,884,-391,1275,-268,-323,55,563.3913043478261,23,1,12,1286,WR,0
0,1,0,1379,916,463,-208,-128,-80,189.36,25,0,0,466,WR,0
0,1,0,532,540,-8,-203,-186,-17,25.0,3,0,16,2,TE,0
1,1,5,1299,200,1099,-255,-439,184,259.22727272727275,44,0,11,1104,RB,0
0,1,49,239,255,-16,-451,-474,23,101.41025641025641,39,0,182,159,RB,1
0,1,58,1622,-184,1806,-362,-352,-10,286.88235294117646,68,1,23,1817,RB,0
0,1,21,101,-1594,1695,-414,-212,-202,436.675,40,1,16,1717,RB,0
0,1,36,191,211,-20,-500,-479,-21,88.484375,64,0,178,161,RB,1
1,1,0,25,13,12,-649,-626,-23,162.3684210526316,57,0,83,70,RB,1
0,1,0,1905,1574,331,-198,-86,-112,288.6666666666667,12,0,0,331,WR,0
0,1,0,827,-866,1693,-193,-122,-71,318.0925925925926,54,1,9,1696,WR,0
1,1,107,661,828,-167,-194,-83,-111,87.04166666666667,24,0,180,18,WR,0
0,1,41,566,492,74,-209,-187,-22,120.53846153846153,65,0,356,433,WR,1
0,1,79,247,217,30,-502,-368,-134,34.0,1,0,6,17,RB,1
0,1,12,23,567,-544,-286,-64,-222,224.19230769230768,26,0,552,4,TE,0
0,1,0,1736,1302,434,-163,-12,-151,295.6666666666667,15,0,6,432,WR,0
0,1,0,385,-551,936,-264,-50,-214,222.5581395348837,43,1,18,950,TE,0
0,1,19,195,-205,400,-527,-469,-58,183.08333333333334,24,1,17,425,RB,0
0,1,9,566,-529,1095,-187,-113,-74,320.77142857142854,35,1,19,1111,TE,0
0,1,46,16,270,-254,-695,-404,-291,114.03225806451613,31,0,252,1,RB,0
0,1,22,1830,953,877,-327,-230,-97,248.6,35,0,14,882,WR,0
0,1,0,984,764,220,-231,-269,38,194.08333333333334,12,0,12,225,WR,0
0,1,49,199,230,-31,-553,-403,-150,82.42857142857143,7,0,26,15,RB,1
0,1,0,743,-802,1545,-239,-307,68,455.8529411764706,34,1,0,1545,WR,0
0,1,14,222,488,-266,-517,-178,-339,140.57142857142858,28,0,264,3,RB,0
0,1,0,855,-721,1576,-347,-273,-74,342.10869565217394,46,1,9,1582,WR,0
0,1,0,736,-495,1231,-231,-246,15,321.13157894736844,38,1,15,1237,TE,0
0,1,12,504,-535,1039,-177,-191,14,320.3030303030303,33,1,15,1048,TE,0
0,1,0,630,1,629,-183,-519,336,434.8888888888889,18,0,15,622,TE,0
0,1,0,217,210,7,-560,-413,-147,70.3125,32,0,82,100,RB,1
0,1,0,853,-807,1660,-174,-303,129,488.015625,64,1,716,2378,WR,1
0,1,67,479,-596,1075,-177,-239,62,329.09090909090907,33,1,11,1074,TE,0
0,1,0,932,227,705,-289,-325,36,396.8888888888889,18,0,3,692,WR,0
0,1,27,561,-823,1384,-299,-201,-98,262.59615384615387,52,1,4,1383,WR,0
0,1,0,1104,1143,-39,-128,24,-152,79.0,4,0,9,9,WR,1
0,1,0,393,361,32,-278,-75,-203,83.3125,16,0,38,32,TE,1
0,1,0,259,1700,-1441,-520,-238,-282,320.9782608695652,46,0,1439,0,RB,0
0,1,0,551,-1166,1717,-334,-250,-84,350.0,48,1,11,1698,WR,0
0,1,14,240,518,-278,-533,-191,-342,182.91666666666666,24,0,290,3,RB,0
0,1,39,205,-704,909,-517,-189,-328,214.53333333333333,45,1,2,925,RB,0
0,1,16,141,247,-106,-562,-510,-52,116.53846153846153,13,0,114,8,RB,0
0,1,7,213,-234,447,-492,-490,-2,181.875,24,1,2,438,RB,0
0,1,0,678,-1009,1687,-293,-199,-94,356.6595744680851,47,1,1,1673,WR,0
0,1,18,603,-432,1035,-216,-189,-27,263.5,38,1,7,1018,TE,0
0,1,39,496,-483,979,-241,-185,-56,251.3421052631579,38,1,18,969,TE,0
0,1,18,784,-812,1596,-221,-106,-115,324.2448979591837,49,1,6,1607,WR,0
0,1,0,418,216,202,-299,-373,74,197.11627906976744,43,0,330,530,TE,1
0,1,2,1095,950,145,-180,-185,5,267.3269230769231,52,0,623,769,RB,1
0,1,47,1111,5,1106,-184,-740,556,331.0263157894737,38,0,34,1121,RB,0
0,1,0,930,-561,1491,-257,-157,-100,289.38461538461536,52,1,0,1492,WR,0
0,1,0,525,-184,709,-219,-426,207,255.36666666666667,30,1,19,727,TE,0
0,1,0,2056,1321,735,-127,-101,-26,208.22857142857143,35,0,9,739,RB,0
0,1,0,1105,710,395,-223,-247,24,347.0769230769231,13,0,9,423,RB,0
0,1,9,769,510,259,-220,-223,3,255.11627906976744,43,0,438,694,WR,1
0,1,0,926,-1240,2166,-168,-64,-104,325.5217391304348,69,1,2,2263,WR,0
0,1,0,447,577,-130,-129,21,-150,102.66666666666667,3,0,34,2,TE,0
0,1,0,823,186,637,-178,-329,151,395.70588235294116,17,0,4,644,WR,0
0,1,43,459,445,14,-187,-180,-7,218.82692307692307,52,0,569,580,TE,1
0,1,49,592,1313,-721,-347,-223,-124,291.2692307692308,26,0,732,10,WR,0
0,1,71,445,-456,901,-265,-193,-72,242.97368421052633,38,1,21,951,TE,0
0,1,0,1606,1179,427,-230,-214,-16,214.33333333333334,21,0,25,445,WR,0
0,1,3,644,-770,1414,-168,-205,37,329.51162790697674,43,1,2,1422,WR,0
0,1,18,1211,532,679,-103,-26,-77,203.96875,32,0,4,667,WR,0
0,1,22,398,675,-277,-260,-188,-72,154.3684210526316,19,0,286,4,TE,0
0,1,0,479,489,-10,-74,-80,6,30.9,10,0,41,61,TE,1
0,1,0,839,-984,1823,-164,-123,-41,350.3090909090909,55,1,6,1863,WR,0
0,1,0,512,467,45,-117,-96,-21,27.692307692307693,26,0,69,109,TE,1
0,1,80,8,12,-4,-735,-740,5,121.08333333333333,36,0,4,47,RB,0
0,1,0,454,-415,869,-241,-193,-48,260.3235294117647,34,1,2,878,TE,0
0,1,11,263,486,-223,-407,-127,-280,170.33333333333334,18,0,223,8,FB,0
0,1,17,1821,254,1567,-175,-367,192,343.8695652173913,46,0,3,1568,TE,0
0,1,0,1985,1393,592,-198,-85,-113,258.125,24,0,8,624,WR,0
0,1,10,1695,262,1433,-216,-341,125,363.475,40,0,4,1441,TE,0
1,1,48,149,-28,177,-528,-732,204,108.76923076923077,26,1,36,188,RB,1
0,1,8,923,-804,1727,-151,-183,32,391.34090909090907,44,1,9,1726,WR,0
0,1,7,254,-234,488,-529,-507,-22,184.2962962962963,27,1,31,508,RB,0
0,1,0,230,44,186,-535,-602,67,242.77777777777777,9,0,11,202,RB,0
0,1,0,492,468,24,-191,-154,-37,50.57142857142857,49,0,66,104,TE,1
0,1,0,244,237,7,-554,-534,-20,88.93333333333334,15,0,52,66,RB,1
0,1,21,606,-1178,1784,-193,-105,-88,394.0869565217391,46,1,7,1793,WR,0
0,1,0,415,-35,450,-241,-285,44,294.5882352941176,17,1,34,484,TE,0
0,1,3,909,251,658,-244,-444,200,200.91666666666666,36,0,26,674,RB,0
0,1,0,223,496,-273,-481,-377,-104,249.2941176470588,51,0,718,441,WR,1
1,1,0,432,435,-3,-291,-328,37,65.58536585365853,41,0,121,113,TE,1
0,1,10,17,-1639,1656,-385,-191,-194,329.54901960784315,51,1,0,1657,RB,0
0,1,0,799,813,-14,-97,-36,-61,43.78260869565217,23,0,61,54,WR,1
0,1,22,577,538,39,-231,-196,-35,42.666666666666664,9,0,16,40,TE,1
0,1,1,990,-805,1795,-248,-300,52,330.0,54,1,6,1789,RB,0
0,1,0,1544,376,1168,-159,-676,517,469.82142857142856,28,0,10,1178,TE,0
0,1,8,493,-393,886,-222,-249,27,297.8709677419355,31,1,6,891,TE,0
0,1,0,887,-292,1179,-257,-521,264,266.0416666666667,48,1,4,1166,WR,0
0,1,2,263,-211,474,-503,-487,-16,122.4047619047619,42,1,25,516,RB,0
0,1,6,435,-483,918,-214,-250,36,230.66666666666666,39,1,0,903,TE,0
0,1,0,188,181,7,-555,-530,-25,59.054054054054056,37,0,50,50,RB,1
0,1,0,480,483,-3,-243,-153,-90,78.875,32,0,80,70,TE,1
0,1,0,1123,1116,7,-165,-145,-20,44.6,5,0,6,15,WR,1
0,1,50,1192,189,1003,-373,-486,113,341.3125,32,0,40,1031,RB,0
0,1,23,1223,-44,1267,-175,-736,561,331.0238095238095,42,1,15,1287,RB,0
0,1,13,205,-1084,1289,-495,-198,-297,288.8695652173913,46,1,2,1291,RB,0
0,1,6,177,-195,372,-509,-453,-56,182.42857142857142,21,1,2,385,RB,0
0,1,8,1098,477,621,-228,-191,-37,230.88888888888889,27,0,16,633,TE,0
0,1,23,157,-239,396,-512,-425,-87,184.5909090909091,22,1,14,406,RB,0
0,1,0,1356,363,993,-188,-255,67,311.125,32,0,11,1010,WR,0
0,1,0,478,548,-70,-220,-150,-70,173.58139534883722,43,0,407,326,TE,1
0,1,0,889,455,434,-182,-200,18,172.84,25,0,24,449,TE,0
0,1,16,1260,659,601,-244,-148,-96,195.41935483870967,31,0,2,601,TE,0
0,1,11,1251,639,612,-158,-133,-25,198.43333333333334,30,0,2,607,RB,0
0,1,0,1324,665,659,-98,-406,308,386.6842105263158,19,0,10,649,WR,0
0,1,31,186,-227,413,-548,-495,-53,143.61290322580646,31,1,6,426,RB,0
0,1,0,801,720,81,-218,-168,-50,272.1875,48,0,626,688,WR,1
0,1,0,221,144,77,-537,-149,-388,61.8,5,0,5,35,RB,0
0,1,0,1520,855,665,-354,-281,-73,211.48387096774192,31,0,5,660,WR,0
0,1,18,731,1809,-1078,-188,-140,-48,249.23809523809524,42,0,1075,10,WR,0
0,1,0,387,553,-166,-291,-221,-70,100.0,15,0,144,2,TE,0
0,1,36,923,-490,1413,-191,-159,-32,297.7450980392157,51,1,78,1487,TE,0
0,1,12,225,-533,758,-461,-139,-322,214.07894736842104,38,1,2,770,RB,0
0,1,0,1172,1223,-51,-210,-303,93,359.9655172413793,58,0,1062,1013,WR,1
0,1,0,1649,1005,644,-182,-171,-11,226.41379310344828,29,0,3,648,WR,0
0,1,0,914,445,469,-215,-262,47,348.07142857142856,14,0,18,484,WR,0
0,1,0,922,437,485,-218,-276,58,335.8,15,0,10,481,WR,0
0,1,0,695,166,529,-256,-269,13,419.38461538461536,13,0,5,541,WR,0
0,1,0,471,-293,764,-222,-146,-76,224.52777777777777,36,1,38,810,TE,0
0,1,0,11,420,-409,-238,-93,-145,169.32142857142858,28,0,417,15,TE,0
0,1,7,177,600,-423,-270,-139,-131,221.65,20,0,415,2,RB,0
0,1,0,571,-616,1187,-296,-130,-166,334.8918918918919,37,1,0,1192,TE,0
0,1,40,458,445,13,-241,-216,-25,81.12121212121212,66,0,274,257,TE,1
0,1,53,1208,1135,73,-222,-194,-28,83.3,40,0,164,204,WR,1
1,1,44,1502,1421,81,-140,-140,0,88.04761904761905,21,0,55,166,WR,1
1,1,0,1082,-212,1294,-217,-528,311,262.9423076923077,52,1,6,1296,RB,0
0,1,13,839,1673,-834,-297,-206,-91,375.2173913043478,23,0,820,2,WR,0
0,1,0,733,-623,1356,-244,-228,-16,465.82758620689657,29,1,6,1350,WR,0
0,1,10,525,-530,1055,-265,-177,-88,255.6829268292683,41,1,2,1059,TE,0
0,1,0,790,-1052,1842,-163,-78,-85,376.18367346938777,49,1,7,1838,WR,0
0,1,5,2040,1288,752,-234,-198,-36,240.06451612903226,31,0,5,758,WR,0
0,1,29,1252,483,769,-252,-169,-83,241.6969696969697,33,0,13,786,TE,0
0,1,0,878,-238,1116,-219,-255,36,526.7142857142857,21,1,9,1109,WR,0
0,1,0,386,-537,923,-235,-218,-17,308.258064516129,31,1,10,926,TE,0
0,1,19,1550,511,1039,-226,-128,-98,220.6,50,0,12,1089,TE,0
0,1,29,454,-467,921,-204,-132,-72,227.45238095238096,42,1,2,935,TE,0
0,1,0,678,-609,1287,-208,-106,-102,282.02272727272725,44,1,0,1264,TE,0
0,1,32,424,-524,948,-228,-171,-57,290.45454545454544,33,1,11,944,TE,0
0,1,0,601,-555,1156,-195,-147,-48,226.62745098039215,51,1,4,1164,WR,0
1,1,0,1285,616,669,-188,-199,11,138.38,50,0,38,698,WR,0
1,1,15,1245,1973,-728,-203,-146,-57,231.8125,32,0,741,23,WR,0
0,1,0,1453,-530,1983,-245,-301,56,537.5405405405405,37,1,2,1994,WR,0
0,1,0,397,-537,934,-207,-189,-18,243.89743589743588,39,1,5,938,TE,0
0,1,0,825,-880,1705,-176,-157,-19,358.27659574468083,47,1,0,1683,WR,0
0,1,0,744,-520,1264,-166,-302,136,372.8235294117647,34,1,7,1270,WR,0
0,1,0,449,-445,894,-159,-165,6,273.27272727272725,33,1,3,893,TE,0
0,1,0,829,541,288,-204,-237,33,332.77777777777777,9,0,8,288,WR,0
0,1,28,646,631,15,-245,-228,-17,278.06,50,0,703,706,TE,1
0,1,0,1447,-265,1712,-250,-393,143,314.33898305084745,59,1,48,1783,RB,0
0,1,0,1602,1283,319,-142,-157,15,130.38709677419354,31,0,39,340,TE,0
1,1,0,749,644,105,-237,-256,19,157.90322580645162,31,0,185,288,WR,1
0,1,0,275,-266,541,-491,-443,-48,170.4848484848485,33,1,13,536,RB,0
0,1,0,1565,1325,240,-228,-129,-99,113.94736842105263,19,0,6,233,TE,0
0,1,0,672,-559,1231,-197,-225,28,274.0701754385965,57,1,179,1400,TE,0
0,1,0,186,-330,516,-522,-465,-57,276.7142857142857,21,1,0,517,RB,0
1,1,0,514,533,-19,-207,-220,13,169.4,50,0,428,407,TE,1
0,1,2,1513,795,718,-250,-162,-88,157.7111111111111,45,0,7,716,TE,0
0,1,26,232,189,43,-457,-312,-145,109.1063829787234,47,0,94,119,RB,1
0,1,1,611,-958,1569,-228,-79,-149,307.98039215686276,51,1,5,1589,WR,0
0,1,0,755,-910,1665,-210,-224,14,338.3265306122449,49,1,2,1671,WR,0
0,1,0,1380,581,799,-161,-217,56,306.5357142857143,28,0,26,834,TE,0
0,1,0,1455,418,1037,-285,-245,-40,279.81081081081084,37,0,7,1047,TE,0
0,1,2,192,-312,504,-536,-455,-81,169.79310344827587,29,1,6,533,RB,0
0,1,0,451,1019,-568,-292,-219,-73,174.22857142857143,35,0,603,27,WR,0
0,1,0,29,263,-234,-772,-465,-307,95.02564102564102,39,0,250,34,RB,0
0,1,0,1374,948,426,-284,-161,-123,124.0,34,0,32,423,TE,0
0,1,0,693,496,197,-402,-264,-138,142.6875,32,0,185,274,TE,1
0,1,0,427,-349,776,-217,-240,23,297.34615384615387,26,1,1,776,TE,0
0,1,0,384,-1062,1446,-253,-127,-126,311.1666666666667,48,1,34,1477,WR,0
0,1,32,911,1418,-507,-102,-98,-4,153.33333333333334,33,0,557,32,WR,0
0,1,8,700,-860,1560,-267,-183,-84,246.890625,64,1,77,1619,WR,0
0,1,127,703,-937,1640,-217,-164,-53,252.88888888888889,63,1,15,1685,WR,0
0,1,0,1466,409,1057,-230,-254,24,290.1388888888889,36,0,1,1056,TE,0
0,1,0,116,245,-129,-582,-528,-54,186.11111111111111,9,0,127,0,RB,0
0,1,13,1112,1362,-250,-56,-18,-38,130.95238095238096,21,0,282,15,TE,0
0,1,0,1218,847,371,-268,-187,-81,162.0909090909091,22,0,13,370,TE,0
0,1,6,1321,264,1057,-344,-472,128,307.4054054054054,37,0,24,1084,RB,0
0,1,0,439,-949,1388,-275,-184,-91,326.9767441860465,43,1,0,1389,TE,0
0,1,0,1436,1128,308,-264,-234,-30,100.44444444444444,27,0,1,308,TE,0
0,1,0,1701,967,734,-203,-343,140,314.7083333333333,24,0,10,729,RB,0
0,1,0,1451,988,463,-452,-55,-397,202.0,13,0,11,262,TE,0
0,1,0,223,85,138,-477,-532,55,130.7,10,0,17,143,RB,0
1,1,25,810,1482,-672,-85,-141,56,164.975,40,0,686,2,WR,0
0,1,0,1807,835,972,-214,-456,242,341.06451612903226,31,0,38,1004,RB,0
0,1,0,177,382,-205,-254,-62,-192,139.33333333333334,66,0,587,370,TE,1
0,1,0,1633,1016,617,-222,-299,77,294.2608695652174,23,0,4,644,RB,0
0,1,0,661,546,115,-212,-268,56,277.7368421052632,38,0,474,593,WR,1
0,1,32,249,-219,468,-475,-455,-20,170.6,30,1,13,491,RB,0
0,1,0,729,777,-48,-228,-217,-11,118.3,20,0,154,100,WR,1
0,1,0,566,515,51,-254,-221,-33,268.1951219512195,41,0,523,582,TE,1
0,1,0,1435,1067,368,-303,-237,-66,145.79166666666666,24,0,0,365,TE,0
0,1,4,60,1013,-953,-285,-97,-188,249.925,40,0,958,3,WR,0
0,1,0,37,-20,57,-622,-652,30,38.375,16,0,42,86,RB,1
0,1,0,437,532,-95,-103,-86,-17,64.85714285714286,21,0,150,47,TE,1
0,1,0,963,-230,1193,-223,-234,11,496.75,24,1,3,1182,FB,0
1,1,23,12,259,-247,-821,-553,-268,112.38888888888889,36,0,260,37,WR,0
0,1,0,152,686,-534,-313,-125,-188,243.56521739130434,23,0,529,0,WR,0
0,1,0,1137,-881,2018,-180,-238,58,405.32,50,1,0,2010,WR,0
0,1,54,259,-669,928,-520,-275,-245,279.8,35,1,35,934,FB,0
0,1,0,510,470,40,-247,-248,1,64.64285714285714,14,0,39,113,TE,1
0,1,22,238,-222,460,-559,-557,-2,197.625,24,1,4,480,RB,0
0,1,0,423,385,38,-93,-114,21,61.0,11,0,27,55,TE,1
0,1,2,840,-484,1324,-262,-208,-54,333.85714285714283,42,1,23,1346,TE,0
0,1,0,959,570,389,-277,-360,83,286.7857142857143,14,0,5,404,WR,0
0,1,0,1093,-415,1508,-221,-335,114,543.1785714285714,28,1,10,1507,WR,0
0,1,9,334,2087,-1753,-270,-135,-135,474.10526315789474,38,0,1763,5,FB,0
0,1,8,467,-489,956,-253,-169,-84,245.3658536585366,41,1,10,965,TE,0
0,1,6,836,-715,1551,-253,-182,-71,342.0652173913044,46,1,5,1559,FB,0
0,1,0,372,-471,843,-236,-484,248,222.70731707317074,41,1,6,855,WR,0
0,1,17,1031,1846,-815,-563,-205,-358,342.0357142857143,28,0,846,5,WR,0
0,1,23,245,-185,430,-552,-442,-110,174.6,25,1,18,451,RB,0
1,1,1,153,459,-306,-237,-144,-93,188.3684210526316,19,0,339,16,TE,0
0,1,0,451,-608,1059,-197,-22,-175,273.7435897435897,39,1,0,1032,TE,0
0,1,0,447,503,-56,-199,-197,-2,80.375,8,0,68,4,TE,0
0,1,36,123,513,-390,-300,-181,-119,175.03846153846155,26,0,408,28,TE,0
0,1,54,339,-547,886,-248,-206,-42,243.18421052631578,38,1,5,901,TE,0
0,1,0,452,339,113,-191,-209,18,64.39285714285714,28,0,29,161,TE,1
1,1,10,466,-484,950,-184,-197,13,288.42424242424244,33,1,19,966,TE,0
1,1,4,315,12,303,-246,-495,249,162.6530612244898,49,0,212,516,TE,1
0,1,25,213,217,-4,-511,-507,-4,123.64285714285714,42,0,147,132,RB,1
0,1,17,196,185,11,-393,-564,171,109.8051948051948,77,0,108,118,RB,1
0,1,0,952,60,892,-214,-289,75,458.4,20,0,11,909,WR,0
0,1,10,344,-223,567,-452,-395,-57,160.85294117647058,34,1,31,572,RB,0
0,1,20,453,-512,965,-233,-217,-16,267.44444444444446,36,1,9,975,TE,0
1,1,23,679,-441,1120,-236,-233,-3,301.55263157894734,38,1,29,1156,WR,0
1,1,37,200,1718,-1518,-310,-58,-252,348.53333333333336,45,0,1511,5,WR,0
0,1,15,792,-1080,1872,-221,-113,-108,295.6231884057971,69,1,6,1882,WR,0
0,1,0,537,543,-6,-169,-163,-6,49.27777777777778,18,0,35,24,TE,1
0,1,11,929,-1006,1935,-194,-170,-24,331.85,60,1,1,1936,WR,0
0,1,0,902,-1234,2136,-206,-236,30,434.3673469387755,49,1,3,2130,WR,0
0,1,0,581,-531,1112,-221,-197,-24,289.10526315789474,38,1,0,1107,TE,0
0,1,0,1183,991,192,-203,-183,-20,158.0,13,0,1,201,WR,0
0,1,3,760,-836,1596,-209,-192,-17,316.01960784313724,51,1,0,1595,WR,0
0,1,21,164,252,-88,-452,-506,54,68.02,50,0,138,60,RB,1
0,1,0,1023,-334,1357,-197,-330,133,381.0689655172414,58,1,399,1762,WR,1
0,1,0,992,-247,1239,-236,-341,105,471.4074074074074,27,1,11,1242,WR,0
0,1,15,730,-775,1505,-252,-169,-83,333.7173913043478,46,1,12,1520,WR,0
0,1,0,793,265,528,-125,-217,92,379.35714285714283,14,0,3,517,WR,0
0,1,13,651,377,274,-123,-125,2,114.91666666666667,24,0,2,280,WR,0
1,1,45,751,1449,-698,-96,-13,-83,226.6,30,0,684,6,WR,0
1,1,46,1211,313,898,-226,-422,196,249.75675675675674,37,0,7,917,RB,0
0,1,0,949,639,310,-278,-204,-74,173.61111111111111,18,0,2,320,WR,0
0,1,23,29,461,-432,-278,-269,-9,262.47058823529414,17,0,430,4,TE,0
0,1,11,196,-179,375,-433,-447,14,170.57142857142858,21,1,2,382,RB,0
0,1,10,100,206,-106,-181,-473,292,155.0,27,0,112,5,RB,0
0,1,3,217,-186,403,-485,-437,-48,140.72413793103448,29,1,5,406,RB,0
0,1,0,687,136,551,-203,-293,90,330.4117647058824,17,0,11,569,TE,0
0,1,22,3,71,-68,-754,-678,-76,129.22784810126583,79,0,162,180,RB,1
0,1,18,658,-896,1554,-186,-102,-84,359.44444444444446,45,1,17,1597,WR,0
0,1,0,1322,554,768,-189,-131,-58,208.6216216216216,37,0,20,783,WR,0
0,1,43,978,-1159,2137,-183,-208,25,378.63157894736844,57,1,4,2153,WR,0
0,1,49,149,197,-48,-416,-517,101,109.92857142857143,28,0,88,56,RB,1
0,1,0,869,570,299,-166,-185,19,104.21428571428571,28,0,10,314,WR,0
0,1,18,1052,-869,1921,-203,-188,-15,379.74,50,1,19,1920,WR,0
0,1,17,462,-355,817,-196,-97,-99,209.46666666666667,45,1,56,897,WR,0
0,1,28,765,-891,1656,-143,-144,1,312.74074074074076,54,1,7,1676,WR,0
0,1,67,222,259,-37,-548,-516,-32,62.2,15,0,99,41,RB,1
0,1,0,531,499,32,-94,-217,123,193.06153846153848,65,0,587,611,TE,1
0,1,0,315,-1296,1611,-496,-289,-207,434.28205128205127,39,1,2,1617,RB,0
0,1,8,897,237,660,-256,-532,276,281.9074074074074,54,0,427,1078,RB,1
0,1,27,626,-818,1444,-243,-77,-166,305.4791666666667,48,1,14,1468,WR,0
0,1,0,26,-168,194,-407,-378,-29,233.88888888888889,9,1,25,204,TE,0
0,1,2,1340,-726,2066,-197,-168,-29,435.9148936170213,47,1,21,2078,WR,0
0,1,45,899,169,730,-410,-524,114,288.2692307692308,26,0,28,727,RB,0
0,1,0,173,-1145,1318,-554,-326,-228,340.7631578947368,38,1,10,1285,RB,0
0,1,27,1045,-737,1782,-195,-81,-114,436.9,40,1,13,1765,WR,0
1,1,29,0,-159,159,-687,-417,-270,144.2941176470588,17,0,8,190,RB,0
0,1,11,938,576,362,-65,-105,40,131.2962962962963,27,0,4,366,TE,0
0,1,0,1033,-1426,2459,-214,-234,20,468.29824561403507,57,1,97,2564,WR,0
0,1,0,1505,452,1053,-222,-268,46,279.3157894736842,38,0,17,1086,TE,0
0,1,50,20,1,19,-667,-686,19,119.68333333333334,60,0,63,43,RB,1
0,1,79,1706,1572,134,363,-62,425,78.5,16,0,23,148,TE,0
0,1,0,24,140,-116,-462,-437,-25,184.57142857142858,7,0,137,5,TE,0
0,1,15,981,-1054,2035,-212,-180,-32,421.7291666666667,48,1,6,2045,WR,0
0,1,8,1598,529,1069,-167,-207,40,245.67391304347825,46,0,28,1099,TE,0
0,1,62,514,-494,1008,-205,-209,4,276.92105263157896,38,1,17,1050,TE,0
0,1,0,1131,281,850,-194,-316,122,457.63157894736844,19,0,7,852,WR,0
0,1,52,172,225,-53,-552,-505,-47,278.9529411764706,85,0,1177,1183,RB,1
0,1,4,1752,531,1221,-219,-143,-76,260.4130434782609,46,0,2,1207,TE,0
0,1,0,769,-214,983,-249,-334,85,441.5098039215686,51,1,639,1613,WR,1
0,1,5,1167,777,390,-178,-136,-42,136.53571428571428,28,0,0,387,WR,0
0,1,0,1313,901,412,-149,-96,-53,148.62962962962962,27,0,0,412,WR,0
0,1,11,1023,-867,1890,-204,-216,12,408.67391304347825,46,1,5,1909,TE,0
0,1,0,500,468,32,-201,-182,-19,211.6326530612245,49,0,512,537,TE,1
1,1,0,1123,1074,49,-99,79,-178,37.333333333333336,18,0,21,57,WR,1
0,1,0,1633,682,951,-217,-274,57,360.0,45,0,327,1278,WR,1
0,1,13,837,327,510,-342,-511,169,228.92,25,0,27,532,RB,0
0,1,0,579,-420,999,-184,-250,66,212.6875,48,1,21,1015,FB,0
0,1,14,746,-1222,1968,-193,-154,-39,402.44897959183675,49,1,2,1962,WR,0
0,1,0,988,-576,1564,-265,-366,101,400.725,40,1,16,1579,WR,0
0,1,0,191,-236,427,-572,-491,-81,201.0,22,1,30,444,RB,0
0,1,16,411,-459,870,-284,-202,-82,233.22222222222223,36,1,2,868,TE,0
0,1,0,77,242,-165,-545,-498,-47,130.1875,16,0,194,30,RB,0
0,1,0,2006,1601,405,-232,-257,25,251.5,16,0,9,402,WR,0
0,1,20,511,-679,1190,-181,-31,-150,252.70833333333334,48,1,8,1190,WR,0
0,1,0,648,-528,1176,-167,-211,44,437.9259259259259,27,1,6,1189,TE,0
0,1,0,561,537,24,-49,-36,-13,52.2,20,0,58,87,TE,1
0,1,21,219,-217,436,-559,-498,-61,183.95833333333334,24,1,16,455,RB,0
0,1,3,1176,442,734,-264,-91,-173,199.76923076923077,39,0,0,746,TE,0
0,1,12,411,493,-82,-244,-198,-46,163.85,40,0,343,274,TE,1
0,1,16,101,208,-107,-515,-453,-62,133.0,11,0,127,17,RB,0
0,1,0,1539,915,624,-260,-258,-2,241.6,25,0,2,618,WR,0
0,1,0,1934,1397,537,-233,-240,7,227.52173913043478,23,0,2,537,WR,0
0,1,0,496,522,-26,-176,-173,-3,180.975,40,0,365,358,TE,1
1,1,0,655,-309,964,-200,-327,127,228.38636363636363,44,1,25,1011,TE,0
0,1,0,475,-535,1010,-238,-172,-66,220.95555555555555,45,1,16,1018,TE,0
0,1,0,365,-512,877,-187,-97,-90,199.6122448979592,49,1,46,914,TE,0
0,1,0,996,1142,-146,-71,-215,144,74.5625,48,0,219,61,WR,1
0,1,32,1064,965,99,-147,-74,-73,73.14285714285714,28,0,56,150,TE,1
0,1,0,445,-548,993,-214,-175,-39,209.3404255319149,47,1,9,1000,TE,0
0,1,0,202,-237,439,-506,-463,-43,191.16666666666666,24,1,12,447,RB,0
0,1,1,471,245,226,-264,-438,174,152.96153846153845,26,0,44,253,TE,0
0,1,6,378,171,207,-225,-327,102,173.23809523809524,21,0,37,244,TE,0
0,1,6,511,665,-154,-194,-133,-61,192.3181818181818,44,0,504,351,TE,1
0,1,0,497,551,-54,-254,-217,-37,172.85714285714286,42,0,393,342,TE,1
0,1,0,816,-26,842,-205,-506,301,164.92592592592592,54,1,13,847,RB,0
0,1,0,858,-334,1192,-238,-337,99,497.25,24,1,5,1181,WR,0
0,1,0,676,25,651,-198,-282,84,370.44444444444446,18,0,5,652,TE,0
1,1,0,629,-981,1610,-182,-236,54,338.4468085106383,47,1,0,1609,TE,0
0,1,0,777,1344,-567,-242,-94,-148,229.40740740740742,27,0,592,3,WR,0
0,1,0,268,2085,-1817,-473,-99,-374,343.9259259259259,54,0,1833,14,WR,0
0,1,7,1041,2039,-998,-204,-165,-39,281.7837837837838,37,0,1008,16,WR,0
0,1,0,1963,798,1165,-180,-194,14,268.35,40,0,5,1071,WR,0
0,1,0,922,576,346,-247,-283,36,277.46153846153845,13,0,1,345,WR,0
0,1,0,626,659,-33,-148,-99,-49,53.78378378378378,37,0,136,99,TE,1
0,1,7,776,-1077,1853,-225,-192,-33,370.78,50,1,6,1857,WR,0
0,1,0,696,-372,1068,-175,-223,48,447.4166666666667,24,1,2,1064,WR,0
0,1,0,908,-332,1240,-186,-246,60,358.46153846153845,52,1,317,1550,WR,1
0,1,4,72,-260,332,-549,-390,-159,155.65217391304347,23,1,0,325,RB,0
0,1,0,257,211,46,-491,-447,-44,98.75,32,0,108,160,RB,1
0,1,0,284,-2092,2376,-427,-119,-308,368.125,64,1,5,2375,RB,0
0,1,0,800,-1103,1903,-322,-356,34,409.7826086956522,46,1,10,1895,WR,0
1,1,6,189,-535,724,-273,-98,-175,174.5744680851064,47,1,37,759,TE,0
0,1,0,975,512,463,-158,-98,-60,222.14285714285714,21,0,7,465,WR,0
0,1,0,1966,1012,954,-265,-215,-50,297.80645161290323,31,0,0,933,WR,0
0,1,22,230,438,-208,-457,-193,-264,156.76190476190476,21,0,206,17,RB,0
0,1,13,390,-612,1002,-261,-192,-69,272.05405405405406,37,1,6,998,TE,0
0,1,4,467,-495,962,-90,-219,129,197.33333333333334,54,1,4,986,TE,0
0,1,6,485,-1185,1670,-282,-74,-208,310.4727272727273,55,1,6,1674,WR,0
0,1,0,767,-435,1202,-151,-302,151,347.77358490566036,53,1,297,1500,WR,1
1,1,1,216,227,-11,-580,-477,-103,40.333333333333336,6,0,14,11,RB,1
0,1,0,1793,1309,484,-123,-145,22,249.10526315789474,19,0,5,490,WR,0
0,1,54,218,11,207,-517,-723,206,133.0408163265306,49,0,27,193,RB,0
0,1,0,573,-494,1067,-180,-168,-12,250.85714285714286,42,1,17,1070,TE,0
0,1,0,968,571,397,-270,-243,-27,315.9230769230769,13,0,4,402,RB,0
0,1,0,751,-162,913,-179,-576,397,309.5531914893617,47,1,192,1117,WR,0
0,1,0,330,-392,722,-241,-206,-35,181.95744680851064,47,1,61,794,TE,0
0,1,0,759,-73,832,-227,-298,71,447.1578947368421,19,1,15,828,WR,0
0,1,17,1544,2154,-610,-348,-286,-62,270.0,26,0,634,26,RB,0
0,1,0,519,-544,1063,-267,-218,-49,265.7073170731707,41,1,26,1083,TE,0
0,1,0,510,-635,1145,-164,-134,-30,281.6190476190476,42,1,7,1159,TE,0
0,1,0,465,-562,1027,-229,-135,-94,242.4047619047619,42,1,4,1039,TE,0
0,1,0,416,-387,803,-246,-274,28,227.8918918918919,37,1,26,830,TE,0
0,1,84,550,-744,1294,-169,-211,42,295.65909090909093,44,1,23,1299,WR,0
0,1,0,1238,754,484,-217,-397,180,362.2142857142857,14,0,2,471,RB,0
0,1,0,690,1652,-962,-244,-99,-145,267.10526315789474,38,0,963,4,TE,0
0,1,18,607,-276,883,-222,-399,177,223.275,40,1,9,878,FB,0
0,1,0,954,-59,1013,-67,-285,218,286.45,40,1,16,1018,WR,0
0,1,22,584,-382,966,-226,-80,-146,221.625,48,1,15,988,TE,0
0,1,2,469,-589,1058,-254,-182,-72,279.57894736842104,38,1,2,1064,TE,0
0,1,0,767,-666,1433,-220,-194,-26,449.46875,32,1,4,1440,WR,0
0,1,0,519,957,-438,216,-255,471,287.70454545454544,44,0,847,428,TE,1
0,1,0,1779,1360,419,-258,-214,-44,133.2888888888889,45,0,108,526,WR,1
0,1,5,565,-1081,1646,-309,-182,-127,297.7142857142857,56,1,2,1657,WR,0
0,1,0,887,548,339,-221,-220,-1,143.6,25,0,12,349,WR,0
0,1,0,840,840,0,-149,-192,43,92.10126582278481,79,0,379,353,WR,1
0,1,59,7,283,-276,-472,-460,-12,82.3157894736842,38,0,313,8,FB,0
0,1,50,1205,1064,141,-67,-80,13,88.3132530120482,83,0,248,423,WR,1
0,1,35,1433,623,810,-166,-5,-161,245.58823529411765,34,0,12,829,TE,0
0,1,85,410,-466,876,-125,-52,-73,322.48275862068965,29,1,9,918,TE,0
0,1,6,925,-529,1454,-115,-56,-59,332.32608695652175,46,1,4,1474,TE,0
0,1,15,559,-1470,2029,-228,25,-253,374.7142857142857,56,1,31,2070,WR,0
0,1,54,214,1582,-1368,-469,-102,-367,305.4347826086956,46,0,1376,4,RB,0
0,1,27,1022,-833,1855,-240,-160,-80,297.984126984127,63,1,7,1863,WR,0
0,1,0,1978,1351,627,-173,-101,-72,289.95652173913044,23,0,1,667,WR,0
0,1,35,426,-503,929,-214,-160,-54,252.97297297297297,37,1,4,938,TE,0
0,1,34,973,-450,1423,-203,-142,-61,341.9761904761905,42,1,6,1424,TE,0
0,1,5,220,-259,479,-494,-453,-41,237.1,20,1,2,480,RB,0
0,1,30,645,-514,1159,-210,-185,-25,306.63157894736844,38,1,4,1171,TE,0
0,1,8,754,-973,1727,-155,-149,-6,370.1276595744681,47,1,0,1723,WR,0
0,1,17,429,-559,988,-197,-130,-67,281.5945945945946,37,1,7,1008,TE,0
0,1,0,34,36,-2,-725,-678,-47,75.75675675675676,37,0,44,59,RB,1
0,1,24,1150,1158,-8,-145,-113,-32,32.0,1,0,4,2,WR,1
1,1,14,1893,449,1444,-293,-256,-37,350.4390243902439,41,0,2,1451,TE,0
1,1,19,1190,276,914,-294,-485,191,251.89473684210526,38,0,11,919,RB,0
0,1,22,1022,282,740,-379,-300,-79,316.68,25,0,21,764,RB,0
0,1,20,268,-214,482,-498,-420,-78,207.95652173913044,23,1,11,496,RB,0
0,1,39,5,15,-10,-773,-738,-35,107.9245283018868,53,0,28,67,RB,1
1,1,89,208,-11,219,-534,-795,261,153.36363636363637,22,1,16,250,RB,0
1,1,25,1361,-20,1381,-235,-785,550,323.9130434782609,46,1,15,1389,RB,0
1,1,23,1926,499,1427,-213,-180,-33,341.7142857142857,42,0,17,1453,TE,0
0,1,0,286,34,252,-552,-690,138,347.55555555555554,9,0,8,249,WR,0
0,1,34,1975,300,1675,-342,-507,165,306.8448275862069,58,0,35,1725,RB,0
0,1,0,1006,-1220,2226,-190,-118,-72,384.0,58,1,6,2238,WR,0
0,1,38,1539,6,1533,-236,-782,546,320.72549019607845,51,0,21,1544,RB,0
0,1,23,982,-1091,2073,-213,-136,-77,423.5833333333333,48,1,2,2055,WR,0
0,1,0,216,-142,358,-571,-550,-21,288.0,12,1,10,347,RB,0
1,1,27,177,-200,377,-507,-487,-20,119.15625,32,1,6,391,RB,0
0,1,56,386,-486,872,-189,-189,0,243.68421052631578,38,1,38,897,TE,0
1,1,48,196,-31,227,-533,-796,263,112.54838709677419,31,1,13,224,RB,0
1,1,42,145,4,141,-580,-773,193,130.45454545454547,22,0,11,145,RB,0
0,1,0,2170,1699,471,-191,-218,27,228.0952380952381,21,0,0,468,WR,0
0,1,0,1306,2098,-792,-127,-123,-4,225.8,35,0,793,24,WR,0
0,1,14,188,-232,420,-534,-529,-5,100.40425531914893,47,1,75,480,RB,0
1,1,24,245,10,235,-467,-622,155,144.04347826086956,23,0,7,255,RB,0
1,1,0,847,557,290,-82,-21,-61,92.09375,32,0,16,296,TE,0
0,1,0,1390,487,903,-196,-112,-84,254.0,39,0,59,952,TE,0
0,1,0,778,-749,1527,-197,-169,-28,360.9047619047619,42,1,3,1516,WR,0
0,1,15,1154,-1070,2224,-296,-82,-214,366.08196721311475,61,1,2,2219,TE,0
0,1,0,135,2175,-2040,-516,-64,-452,337.9193548387097,62,0,2013,2,RB,0
0,1,0,1016,-1147,2163,-198,-97,-101,400.8703703703704,54,1,5,2180,WR,0
0,1,0,864,417,447,-220,-321,101,283.4117647058824,17,0,9,468,WR,0
0,1,0,2176,1971,205,-239,-183,-56,229.88888888888889,9,0,7,200,TE,0
0,1,0,1098,-357,1455,-266,-215,-51,558.7307692307693,26,1,4,1448,WR,0
0,1,18,989,-871,1860,-220,-189,-31,323.1186440677966,59,1,11,1871,WR,0
1,1,0,470,506,-36,-171,-187,16,55.35,20,0,57,21,TE,1
0,1,27,673,-1150,1823,-204,-121,-83,344.0769230769231,52,1,10,1802,WR,0
0,1,12,1405,646,759,-218,-156,-62,240.52941176470588,34,0,2,799,TE,0
0,1,0,2,-1,3,-711,-566,-145,86.75,4,0,3,27,RB,0
1,1,11,280,683,-403,-509,-187,-322,142.6216216216216,37,0,395,0,TE,0
0,1,0,2079,1392,687,-203,-171,-32,193.05714285714285,35,0,3,680,WR,0
0,1,0,1249,488,761,-201,-148,-53,214.72222222222223,36,0,28,782,TE,0
0,1,0,255,161,94,-494,-304,-190,97.0,27,0,36,166,RB,1
0,1,19,278,250,28,-512,-491,-21,107.375,32,0,154,206,RB,1
1,1,20,582,633,-51,-271,-196,-75,83.77777777777777,9,0,47,1,TE,0
0,1,132,1422,1602,-180,-249,-51,-198,83.86206896551724,29,0,189,3,WR,0
0,1,31,226,-213,439,-467,-466,-1,127.60606060606061,33,1,8,445,RB,0
1,1,42,45,-482,527,-397,-181,-216,270.90909090909093,22,1,11,532,TE,0
0,1,0,403,-164,567,-424,-317,-107,333.6857142857143,35,1,242,809,TE,1
0,1,56,1358,590,768,-171,-149,-22,242.65625,32,0,8,772,RB,0
0,1,36,1223,226,997,-274,-409,135,181.421875,64,0,44,1050,RB,0
0,1,0,956,-320,1276,-356,-342,-14,478.22222222222223,27,1,2,1291,TE,0
1,1,10,994,-1059,2053,-213,-117,-96,207.23,100,1,4,2058,WR,0
0,1,25,462,484,-22,-144,-135,-9,96.25,40,0,222,185,TE,1
0,1,0,441,431,10,-175,-187,12,94.33333333333333,51,0,219,241,TE,1
0,1,31,885,956,-71,-62,-89,27,105.71794871794872,39,0,235,175,WR,1
0,1,11,2,-9,11,-721,-713,-8,127.984375,64,0,62,89,RB,1
0,1,28,1238,1699,-461,-228,-166,-62,224.76190476190476,21,0,455,3,RB,0
0,1,0,1329,974,355,-141,-126,-15,356.8918918918919,37,0,479,834,WR,1
0,1,0,954,-1311,2265,-219,-181,-38,418.18518518518516,54,1,2,2248,WR,0
0,1,0,608,-526,1134,-177,-265,88,483.5833333333333,24,1,4,1137,FB,0
0,1,0,1283,478,805,-178,-13,-165,178.4,45,0,9,826,TE,0
0,1,0,986,-71,1057,-179,-294,115,475.2608695652174,23,1,18,1061,WR,0
0,1,0,739,37,702,-220,-228,8,458.11764705882354,17,0,13,756,WR,0
0,1,30,253,165,88,-521,-559,38,223.53846153846155,65,0,585,663,RB,1
0,1,0,450,-438,888,-111,-126,15,204.08333333333334,48,1,32,920,TE,0
0,1,0,1056,-553,1609,-168,-228,60,539.1333333333333,30,1,3,1588,WR,0
0,1,0,1623,1047,576,-153,-187,34,192.96666666666667,30,0,4,570,RB,0
0,1,0,320,-142,462,-576,-569,-7,157.91176470588235,34,1,31,524,RB,0
0,1,0,1477,602,875,-168,-59,-109,171.59016393442624,61,0,85,954,TE,0
0,1,0,799,-924,1723,-288,-62,-226,457.3157894736842,38,1,11,1733,WR,0
0,1,45,1132,-225,1357,-245,-648,403,283.921568627451,51,1,28,1354,RB,0
0,1,0,652,-225,877,-278,-118,-160,574.125,16,1,0,877,WR,0
0,1,0,485,660,-175,-182,115,-297,108.9,20,0,205,11,TE,0
0,1,0,645,-402,1047,-306,-147,-159,501.04761904761904,21,1,19,1049,WR,0
0,1,0,872,-1165,2037,-208,-162,-46,311.5151515151515,66,1,0,2033,WR,0
0,1,0,1111,1988,-877,-192,-141,-51,182.72916666666666,48,0,883,1,WR,0
0,1,0,869,619,250,-146,-230,84,229.0,12,0,16,273,WR,0
0,1,0,381,418,-37,-190,-48,-142,78.91666666666667,12,0,69,43,TE,1
0,1,0,1075,138,937,-223,-336,113,508.10526315789474,19,0,4,951,WR,0
0,1,0,195,-1994,2189,-527,-51,-476,319.77142857142854,70,1,6,2218,RB,0
0,1,29,1083,398,685,-203,-224,21,183.91666666666666,36,0,16,687,WR,0
0,1,0,1114,726,388,-180,-160,-20,168.30434782608697,23,0,2,398,WR,0
0,1,0,1026,-216,1242,-164,-343,179,497.34615384615387,26,1,2,1254,WR,0
0,1,28,516,-759,1275,-263,-204,-59,351.05555555555554,36,1,4,1219,WR,0
0,1,0,897,-636,1533,-170,-296,126,391.525,40,1,9,1542,WR,0
0,1,5,1506,995,511,-179,-167,-12,142.05882352941177,34,0,0,506,WR,0
0,1,0,1509,1463,46,-105,17,-122,33.625,8,0,28,41,WR,1
0,1,0,591,-763,1354,-239,-97,-142,270.54,50,1,4,1317,WR,0
0,1,0,595,575,20,-164,83,-247,42.75,8,0,33,38,TE,1
0,1,0,1931,1520,411,-207,-9,-198,198.0,22,0,18,434,WR,0
1,1,40,1955,1351,604,-148,15,-163,176.0,37,0,25,631,WR,0
1,1,0,673,494,179,-129,-33,-96,109.1304347826087,23,0,43,229,TE,1
1,1,16,1330,2059,-729,-189,94,-283,175.33333333333334,45,0,774,44,RB,0
1,1,45,781,1415,-634,-96,64,-160,204.51612903225808,31,0,641,7,WR,0
1,1,0,1369,-6,1375,-232,-662,430,300.6,50,1,22,1400,RB,0
0,1,1,1322,832,490,-174,-76,-98,217.0,24,0,32,518,WR,0
1,1,85,1208,403,805,-146,-141,-5,168.67441860465115,43,0,20,767,FB,0
1,1,0,844,1471,-627,-104,61,-165,196.1,30,0,611,34,WR,0
0,1,0,619,-47,666,-79,-374,295,166.710843373494,83,1,287,907,TE,1
1,1,0,1887,616,1271,-135,44,-179,245.94230769230768,52,0,32,1254,TE,0
1,1,0,1364,24,1340,-214,-668,454,301.6530612244898,49,0,12,1404,RB,0
0,1,0,730,-867,1597,-212,-111,-101,313.5098039215686,51,1,17,1610,WR,0
0,1,0,443,463,-20,-98,-66,-32,73.0,3,0,23,6,TE,1
0,1,11,1226,220,1006,-290,-438,148,180.40298507462686,67,0,114,1118,RB,0
0,1,0,881,-841,1722,-191,-280,89,427.2926829268293,41,1,37,1756,WR,0
0,1,0,217,265,-48,-485,-377,-108,56.22222222222222,18,0,71,43,RB,1
0,1,0,276,1364,-1088,-539,-284,-255,286.2682926829268,41,0,1103,14,RB,0
0,1,0,70,748,-678,-305,-209,-96,238.03225806451613,31,0,699,22,WR,0
1,1,0,459,446,13,-111,-98,-13,77.87096774193549,31,0,115,132,TE,1
0,1,0,260,286,-26,-568,-494,-74,69.42857142857143,7,0,30,0,RB,0
1,1,5,1414,-10,1424,-108,-716,608,228.0142857142857,70,1,65,1487,RB,0
1,1,43,29,1473,-1444,-758,-186,-572,316.2916666666667,48,0,1450,12,RB,0
0,1,15,621,-1081,1702,-209,-117,-92,339.6862745098039,51,1,2,1710,WR,0
0,1,0,705,566,139,-217,-231,14,159.77272727272728,22,0,108,246,WR,1
0,1,0,588,655,-67,-150,-117,-33,60.65,20,0,105,38,TE,1
0,1,12,1358,465,893,-206,-211,5,224.0731707317073,41,0,37,936,RB,0
0,1,0,1080,1114,-34,-125,-120,-5,38.785714285714285,14,0,70,57,WR,1
0,1,0,876,59,817,-178,-583,405,399.0,23,0,4,819,WR,0
0,1,0,386,385,1,-96,-87,-9,71.625,24,0,101,94,TE,1
0,1,16,1475,1180,295,-257,-265,8,83.6923076923077,39,0,48,336,WR,0
0,1,4,766,-1405,2171,-281,-159,-122,322.95588235294116,68,1,8,2174,WR,0
1,1,0,554,-415,969,-200,-175,-25,220.95744680851064,47,1,21,990,TE,0
0,1,0,380,441,-61,-144,-39,-105,88.2,55,0,264,203,TE,1
0,1,0,285,276,9,-423,-362,-61,72.6,40,0,183,190,TE,1
0,1,0,1526,496,1030,-154,-110,-44,260.780487804878,41,0,40,1073,TE,0
0,1,7,752,-377,1129,-174,-78,-96,273.77777777777777,45,1,35,1195,TE,0
0,1,18,12,-22,34,-768,-746,-22,85.0,53,0,56,35,RB,1
0,1,0,796,-550,1346,-250,-272,22,369.6111111111111,36,1,7,1341,WR,0
0,1,9,912,-474,1386,-259,-193,-66,308.5,46,1,16,1387,WR,0
0,1,0,1478,-2,1480,-183,-624,441,546.3571428571429,28,1,1,1453,RB,0
0,1,0,503,-416,919,-300,-190,-110,354.07142857142856,28,1,21,947,TE,0
0,1,32,1594,-1020,2614,-310,-227,-83,444.03389830508473,59,1,12,2628,WR,0
0,1,13,1053,427,626,-228,-258,30,193.71875,32,0,14,627,WR,0
0,1,7,470,-336,806,-213,-389,176,272.46666666666664,30,1,4,815,TE,0
0,1,53,132,-19,151,-542,-749,207,107.73913043478261,23,1,19,158,RB,0
1,1,0,463,673,-210,-115,-38,-77,65.85714285714286,28,0,226,2,TE,0
1,1,27,20,856,-836,-533,-108,-425,220.7906976744186,43,0,853,2,TE,0
1,1,7,622,1735,-1113,-185,-125,-60,253.51111111111112,45,0,1146,21,TE,0
0,1,26,1420,942,478,-196,-187,-9,172.26923076923077,26,0,2,491,RB,0
0,1,23,453,-272,725,-284,-286,2,277.2307692307692,26,1,21,732,TE,0
0,1,10,577,-515,1092,-203,-132,-71,296.35135135135135,37,1,13,1101,TE,0
0,1,23,1170,269,901,-170,-489,319,253.42105263157896,38,0,17,921,RB,0
0,1,9,642,-802,1444,-209,-228,19,308.7608695652174,46,1,13,1447,WR,0
0,1,18,460,-253,713,-187,-303,116,287.5769230769231,26,1,20,749,TE,0
0,1,10,607,-540,1147,-69,-137,68,280.57142857142856,42,1,23,1159,TE,0
0,1,30,1864,1025,839,-177,-135,-42,267.0967741935484,31,0,12,840,WR,0
0,1,0,1149,62,1087,-236,-398,162,482.95652173913044,23,0,6,1092,WR,0
0,1,16,297,1295,-998,-415,-114,-301,263.275,40,0,1015,2,RB,0
0,1,19,252,1241,-989,-480,-68,-412,291.9189189189189,37,0,990,2,RB,0
0,1,7,773,-944,1717,-208,-90,-118,316.0566037735849,53,1,2,1710,WR,0
0,1,0,704,-732,1436,-174,-251,77,357.85,40,1,6,1445,WR,0
0,1,0,1011,-914,1925,-263,-171,-92,493.175,40,1,0,1942,WR,0
0,1,2,13,22,-9,-750,-806,56,54.3,10,0,18,2,RB,0
0,1,45,446,434,12,-89,-157,68,202.11904761904762,42,0,441,426,TE,1
0,1,2,300,-246,546,-503,-502,-1,144.53846153846155,39,1,15,559,RB,0
0,1,0,245,-294,539,-575,-545,-30,142.70454545454547,44,1,38,594,RB,0
0,1,2,440,740,-300,-321,-243,-78,165.05,20,0,312,8,RB,0
0,1,0,456,-635,1091,-166,-171,5,246.61363636363637,44,1,8,1078,TE,0
0,1,8,204,-273,477,-637,-574,-63,210.08,25,1,12,495,RB,0
0,1,0,913,-299,1212,-202,-260,58,430.3333333333333,30,1,2,1295,WR,0
0,1,0,1465,1130,335,-147,-160,13,183.94444444444446,18,0,8,341,RB,0
1,1,0,439,684,-245,-355,-241,-114,116.36111111111111,36,0,301,56,RB,1
0,1,0,590,468,122,-124,-232,108,132.36111111111111,36,0,25,147,TE,0
0,1,0,1487,1263,224,-131,-113,-18,106.52380952380952,21,0,26,236,WR,0
0,1,0,1049,-115,1164,-278,-496,218,272.77272727272725,44,1,6,1171,FB,0
1,1,0,108,456,-348,-267,-175,-92,161.66666666666666,30,0,409,66,TE,0
0,1,3,428,1323,-895,-276,-129,-147,320.48275862068965,29,0,894,0,RB,0
0,1,2,471,-420,891,-239,-151,-88,241.87179487179486,39,1,28,917,TE,0
0,1,0,313,-385,698,-237,-193,-44,243.0,35,1,71,774,TE,0
0,1,35,1200,-713,1913,-219,-125,-94,389.7450980392157,51,1,18,1931,TE,0
0,1,39,1406,581,825,-226,-212,-14,258.0625,32,0,2,836,TE,0
0,1,0,1187,893,294,-300,-175,-125,131.4516129032258,31,0,26,430,WR,0
0,1,12,301,186,115,-542,-437,-105,86.55263157894737,38,0,171,179,RB,1
0,1,24,481,184,297,-289,-570,281,133.72222222222223,36,0,41,342,RB,0
0,1,0,889,-354,1243,-200,-592,392,315.4761904761905,42,1,6,1246,WR,0
0,1,79,1457,979,478,-217,-189,-28,163.85714285714286,28,0,29,470,WR,0
0,1,4,714,-381,1095,-219,-331,112,289.3243243243243,37,1,5,1088,TE,0
0,1,0,847,-1114,1961,-181,-274,93,569.4,35,1,0,1960,WR,0
0,1,0,204,-267,471,-453,-450,-3,149.79545454545453,44,1,61,516,RB,0
0,1,95,223,235,-12,-549,-579,30,85.53846153846153,65,0,198,171,RB,1
0,1,5,17,185,-168,-701,-531,-170,123.0,23,0,198,22,RB,0
0,1,22,172,-212,384,-523,-567,44,96.54166666666667,72,1,27,418,RB,0
1,1,29,1145,1144,1,-103,-125,22,70.0,51,0,132,130,WR,1
0,1,47,395,368,27,-468,-569,101,118.09803921568627,51,0,114,185,RB,1
0,1,0,1896,1318,578,-236,-228,-8,253.1304347826087,23,0,0,576,WR,0
0,1,18,168,-1885,2053,-473,-362,-111,377.76363636363635,55,1,8,2063,RB,0
0,1,63,1187,213,974,-254,-549,295,233.53703703703704,54,0,110,1094,RB,0
0,1,57,295,176,119,-457,-498,41,103.8,15,0,23,118,WR,1
0,1,0,291,355,-64,-515,-443,-72,186.88524590163934,61,0,581,524,WR,1
0,1,0,457,-739,1196,-207,-215,8,357.93939393939394,33,1,2,1191,TE,0
1,1,48,17,-192,209,-733,-421,-312,161.05555555555554,18,1,12,238,RB,0
1,1,48,52,843,-791,-318,-118,-200,162.46153846153845,52,0,831,26,WR,0
0,1,0,432,-348,780,-214,-176,-38,304.15384615384613,26,1,3,789,TE,0
1,1,70,236,2026,-1790,-629,-112,-517,388.52,50,0,1840,13,RB,0
1,1,107,473,507,-34,-84,-26,-58,90.0,13,0,88,19,TE,1
1,1,94,690,1182,-492,-191,-83,-108,216.15384615384616,26,0,542,13,TE,0
0,1,0,65,615,-550,-101,-148,47,276.89130434782606,46,0,903,333,WR,1
0,1,16,626,-1188,1814,-189,-204,15,344.66037735849056,53,1,8,1833,WR,0
0,1,0,1515,1012,503,-164,-247,83,153.02857142857144,35,0,25,518,WR,0
0,1,0,430,-593,1023,-236,-177,-59,332.3666666666667,30,1,2,1013,TE,0
0,1,9,659,-1100,1759,-254,-215,-39,355.02,50,1,7,1763,WR,0
0,1,12,1,43,-42,-575,-662,87,122.43478260869566,46,0,50,21,RB,1
0,1,0,395,-606,1001,-237,-303,66,307.53125,32,1,9,992,TE,0
0,1,0,504,-563,1067,-196,-233,37,331.6363636363636,33,1,9,1084,TE,0
0,1,110,708,856,-148,-278,-205,-73,122.125,16,0,156,11,WR,0
0,1,12,1,-8,9,-739,-748,9,160.26829268292684,41,0,64,84,RB,1
0,1,26,5,-6,11,-793,-739,-54,189.98076923076923,52,0,35,12,RB,1
0,1,0,1128,212,916,-205,-324,119,477.2,20,0,18,924,WR,0
0,1,55,681,-1555,2236,-157,-142,-15,301.5769230769231,78,1,38,2268,WR,0
0,1,21,0,-166,166,-752,-691,-61,106.30357142857143,56,0,35,87,RB,1
0,1,31,1149,237,912,-253,-338,85,305.125,32,0,32,934,TE,0
0,1,21,1478,886,592,-164,-192,28,184.38709677419354,31,0,8,593,WR,0
0,1,46,1122,-893,2015,-252,-201,-51,354.8070175438597,57,1,8,2011,WR,0
0,1,0,598,-230,828,-168,-336,168,390.8181818181818,22,1,8,845,TE,0
0,1,11,157,-601,758,-426,-162,-264,225.83333333333334,36,1,1,753,FB,0
0,1,0,184,-384,568,-463,-250,-213,264.96153846153845,26,1,21,609,RB,0
0,1,15,1215,-295,1510,-101,-494,393,354.54545454545456,44,1,21,1522,WR,0
0,1,0,567,368,199,-195,-261,66,181.0,14,0,21,211,FB,0
0,1,0,942,-398,1340,-238,-317,79,538.68,25,1,6,1360,WR,0
0,1,0,956,-575,1531,-245,-275,30,372.2295081967213,61,1,359,1892,WR,1
0,1,6,418,-516,934,-213,-187,-26,233.325,40,1,17,952,FB,0
1,1,42,1206,1459,-253,-302,-128,-174,145.91304347826087,23,0,258,10,WR,0
1,1,43,1504,1125,379,-124,-64,-60,178.0,21,0,2,388,WR,0
0,1,0,1732,1029,703,-210,-74,-136,215.45454545454547,33,0,8,697,WR,0
0,1,33,195,-248,443,-594,-565,-29,213.38095238095238,21,1,19,484,RB,0
0,1,6,259,-229,488,-523,-525,2,144.5142857142857,35,1,19,512,RB,0
0,1,30,290,291,-1,-498,-486,-12,43.0,1,0,7,12,RB,1
0,1,24,1154,265,889,-405,-466,61,308.06666666666666,30,0,2,902,RB,0
0,1,0,666,495,171,-219,-137,-82,171.60526315789474,38,0,255,409,TE,1
0,1,0,884,-852,1736,-246,-206,-40,381.6,45,1,3,1739,WR,0
0,1,24,944,706,238,-174,-156,-18,110.05555555555556,18,0,18,229,WR,0
0,1,45,1368,-5,1373,-300,-677,377,307.9791666666667,48,1,4,1389,RB,0
0,1,0,661,-769,1430,-211,-71,-140,318.2888888888889,45,1,9,1424,TE,0
0,1,38,569,208,361,-240,-454,214,152.0,28,0,23,369,FB,0
0,1,0,713,-680,1393,-203,-261,58,374.6216216216216,37,1,1,1389,WR,0
0,1,32,385,250,135,-482,-446,-36,95.5111111111111,45,0,97,233,RB,1
0,1,0,336,-309,645,-492,-375,-117,281.28,25,1,2,671,RB,0
0,1,0,790,-597,1387,-166,-224,58,301.8636363636364,66,1,300,1671,WR,1
0,1,35,248,265,-17,-488,-445,-43,82.625,64,0,172,159,RB,1
0,1,0,1477,1431,46,-196,-211,15,93.72727272727273,11,0,46,94,WR,1
0,1,17,1273,597,676,-119,20,-139,274.72,25,0,22,691,WR,0
0,1,74,265,304,-39,-450,-484,34,68.40186915887851,107,0,310,213,RB,1
0,1,0,504,-1117,1621,-228,-179,-49,299.85185185185185,54,1,0,1620,TE,0
1,1,40,911,697,214,-96,-28,-68,105.85,20,0,13,224,TE,0
1,1,6,810,785,25,-188,-108,-80,295.4259259259259,54,0,778,802,WR,1
0,1,0,587,-637,1224,-305,-162,-143,270.5111111111111,45,1,0,1217,TE,0
0,1,0,575,-583,1158,-234,-166,-68,226.9,50,1,9,1161,TE,0
0,1,33,748,1118,-370,-140,11,-151,208.47368421052633,19,0,381,20,WR,0
0,1,0,1243,1045,198,-99,-196,97,330.8269230769231,52,0,757,950,WR,1
0,1,0,651,-942,1593,-206,-158,-48,348.73333333333335,45,1,4,1576,WR,0
0,1,0,1898,1288,610,-237,-217,-20,170.4857142857143,35,0,9,613,WR,0
0,1,0,2106,1416,690,-321,-327,6,396.0,18,0,2,681,RB,0
0,1,45,247,305,-58,-442,-458,16,141.7941176470588,34,0,192,124,RB,1
0,1,0,749,-581,1330,-174,-233,59,358.02702702702703,37,1,7,1329,WR,0
0,1,0,550,-478,1028,-233,-315,82,371.67857142857144,28,1,2,1042,WR,0
0,1,31,299,244,55,-473,-431,-42,112.73913043478261,23,0,74,137,RB,1
0,1,71,849,-980,1829,-172,-173,1,320.32758620689657,58,1,27,1854,WR,0
0,1,0,746,-847,1593,-171,-191,20,372.04651162790697,43,1,4,1609,WR,0
0,1,54,40,176,-136,-598,-440,-158,103.66666666666667,21,0,152,4,RB,0
0,1,0,242,-120,362,-490,-556,66,347.27272727272725,11,1,2,368,RB,0
0,1,11,319,-489,808,-270,-205,-65,276.56666666666666,30,1,2,812,TE,0
0,1,37,399,-553,952,-260,-174,-86,296.2830188679245,53,1,314,1257,WR,1
0,1,0,859,-584,1443,-194,-175,-19,286.58,50,1,2,1441,WR,0
0,1,0,1148,374,774,-219,-358,139,445.5,18,0,2,774,WR,0
0,1,3,834,-418,1252,-218,-231,13,279.22222222222223,45,1,0,1259,WR,0
0,1,0,961,405,556,-178,-230,52,208.6734693877551,49,0,235,791,WR,1
0,1,39,246,991,-745,-417,-133,-284,237.57575757575756,33,0,719,2,RB,0
0,1,0,522,-1021,1543,-268,-156,-112,321.4375,48,1,0,1543,WR,0
0,1,55,454,-749,1203,-265,-218,-47,299.0731707317073,41,1,17,1215,TE,0
0,1,0,229,18,211,-484,-550,66,234.5,10,0,3,209,RB,0
0,1,0,421,-260,681,-282,-281,-1,310.1363636363636,22,1,2,679,FB,0
0,1,0,1488,1070,418,-173,-180,7,156.53846153846155,26,0,0,412,WR,0
0,1,11,313,-763,1076,-378,-198,-180,189.9516129032258,62,1,37,1118,RB,0
0,1,3,564,-532,1096,-224,-264,40,292.0810810810811,37,1,3,1099,TE,0
0,1,0,728,480,248,-250,-308,58,231.45454545454547,11,0,7,252,WR,0
0,1,16,464,-576,1040,-233,-175,-58,268.825,40,1,25,1074,TE,0
1,1,63,882,892,-10,-117,-105,-12,39.0,2,0,22,9,WR,1
1,1,15,510,-489,999,-249,-212,-37,276.55555555555554,36,1,11,1007,TE,0
0,1,20,738,1781,-1043,-190,-120,-70,236.33333333333334,45,0,1053,9,WR,0
0,1,0,838,-628,1466,-218,-237,19,512.3103448275862,29,1,19,1466,WR,0
0,1,19,757,223,534,-147,-444,297,259.35555555555555,45,0,300,846,TE,1
0,1,20,32,410,-378,-364,-142,-222,317.0,51,0,1008,600,FB,1
0,1,0,882,-396,1278,-133,-243,110,466.0357142857143,28,1,13,1284,WR,0
0,1,0,294,1058,-764,-503,-10,-493,236.21621621621622,37,0,766,7,FB,0
0,1,2,112,-786,898,-280,-265,-15,252.07894736842104,38,1,10,917,TE,0
0,1,0,181,835,-654,-284,-62,-222,303.5217391304348,23,0,655,4,RB,0
1,1,39,888,-921,1809,-131,-21,-110,255.72602739726028,73,1,6,1820,WR,0
1,1,29,821,1145,-324,-75,-160,85,89.28571428571429,49,0,401,62,WR,0
0,1,9,444,651,-207,-214,-142,-72,94.18181818181819,22,0,216,4,TE,0
0,1,35,928,-223,1151,-249,-482,233,205.93203883495147,103,1,431,1567,RB,1
1,1,46,784,1377,-593,-73,-75,2,208.15254237288136,59,0,891,310,WR,1
1,1,37,276,-287,563,-485,-453,-32,142.0,41,1,13,593,FB,0
1,1,0,475,-502,977,-181,-170,-11,238.5121951219512,41,1,11,1002,TE,0
0,1,17,816,-1172,1988,-143,-130,-13,368.5740740740741,54,1,17,1985,WR,0
0,1,74,12,-671,683,-216,-105,-111,262.0740740740741,27,1,8,667,TE,0
0,1,58,449,-441,890,-128,-157,29,213.40425531914894,47,1,20,938,TE,0
0,1,125,51,203,-152,-627,-533,-94,109.0,16,0,156,23,RB,0
0,1,0,936,-267,1203,-163,-274,111,505.0416666666667,24,1,7,1201,WR,0
0,1,24,465,-493,958,-178,-164,-14,280.62857142857143,35,1,15,981,TE,0
0,1,15,573,7,566,-174,-488,314,205.3095238095238,42,0,87,652,FB,0
0,1,35,472,-240,712,-190,-410,220,245.28125,32,1,2,713,TE,0
0,1,0,688,-322,1010,-164,-208,44,466.04545454545456,22,1,16,998,WR,0
0,1,9,690,1663,-973,-293,-195,-98,363.35714285714283,28,0,981,9,RB,0
0,1,8,282,-2022,2304,-428,-122,-306,458.6666666666667,51,1,13,2326,FB,0
0,1,20,440,-496,936,-86,-129,43,204.35849056603774,53,1,29,984,TE,0
0,1,0,504,-322,826,-192,-206,14,423.45,20,1,12,850,WR,0
0,1,0,627,456,171,-283,-282,-1,191.4,10,0,4,193,TE,0
0,1,29,3,181,-178,-554,-537,-17,168.53846153846155,13,0,204,28,RB,0
0,1,0,2069,1885,184,-206,-189,-17,212.11111111111111,9,0,4,194,WR,0
1,1,45,1011,513,498,-193,-160,-33,128.775,40,0,37,511,TE,0
1,1,44,1450,369,1081,-235,-391,156,233.91666666666666,48,0,15,1120,RB,0
1,1,1,1901,837,1064,-174,-83,-91,182.6949152542373,59,0,6,1046,TE,0
0,1,42,1342,247,1095,-332,-485,153,268.04545454545456,44,0,14,1158,RB,0
0,1,3,143,-208,351,-532,-463,-69,126.5,28,1,3,359,RB,0
0,1,31,40,1141,-1101,-448,-156,-292,282.1951219512195,41,0,1111,6,WR,0
0,1,0,829,-804,1633,-286,-209,-77,425.02564102564105,39,1,9,1669,WR,0
0,1,0,215,-92,307,-535,-567,32,282.54545454545456,11,1,4,317,RB,0
0,1,31,924,-914,1838,-240,-233,-7,383.51063829787233,47,1,20,1854,WR,0
0,1,14,200,-541,741,-292,-156,-136,240.0625,32,1,25,761,TE,0
0,1,0,1873,1562,311,-259,-216,-43,236.64285714285714,14,0,8,324,WR,0
1,1,60,508,504,4,-251,-229,-22,51.333333333333336,3,0,24,2,TE,0
1,1,0,486,1930,-1444,-323,-109,-214,365.075,40,0,1428,6,WR,0
1,1,0,622,-609,1231,-201,-185,-16,247.18,50,1,7,1242,TE,0
0,1,0,919,-250,1169,-203,-264,61,515.8695652173913,23,1,0,1167,WR,0
1,1,39,280,-1699,1979,-452,-131,-321,339.5762711864407,59,1,29,1980,RB,0
1,1,72,979,2129,-1150,-185,-145,-40,285.1904761904762,42,0,1199,19,WR,0
0,1,66,191,-234,425,-483,-426,-57,183.8,25,1,9,450,RB,0
1,1,51,1333,274,1059,-207,-432,225,279.7,40,0,6,1101,RB,0
0,1,5,264,-260,524,-533,-427,-106,196.19230769230768,26,1,9,508,RB,0
0,1,0,1014,-404,1418,-237,-209,-28,537.4814814814815,27,1,4,1455,WR,0
0,1,37,1070,-521,1591,-289,-123,-166,278.36842105263156,57,1,17,1584,TE,0
0,1,0,1092,-954,2046,-312,-282,-30,454.6666666666667,45,1,11,2063,WR,0
0,1,0,112,530,-418,-239,-67,-172,130.05,40,0,446,17,TE,0
0,1,0,1239,1897,-658,-257,-231,-26,303.0,26,0,794,0,WR,0
0,1,14,794,534,260,-69,-221,152,95.43243243243244,37,0,35,317,TE,0
0,1,82,251,-2201,2452,-444,-133,-311,379.46153846153845,65,1,25,2459,RB,0
0,1,15,1594,560,1034,-314,-190,-124,261.25,40,0,13,1042,TE,0
0,1,0,692,-359,1051,-190,-241,51,332.6875,32,1,0,1051,TE,0
0,1,25,229,214,15,-498,-472,-26,36.75,4,0,14,26,RB,1
0,1,0,442,-661,1103,-232,-36,-196,232.77551020408163,49,1,2,1113,TE,0
0,1,7,228,-261,489,-475,-382,-93,211.75,24,1,5,486,RB,0
0,1,0,1402,643,759,-123,-194,71,259.7586206896552,29,0,2,763,RB,0
0,1,0,1078,574,504,-269,-204,-65,397.1333333333333,15,0,15,586,WR,0
0,1,29,3,390,-387,-545,-495,-50,167.84,25,0,412,2,RB,0
0,1,54,547,601,-54,-222,-161,-61,77.57142857142857,7,0,53,2,RB,0
0,1,21,162,-766,928,-522,-143,-379,287.6,35,1,7,942,RB,0
0,1,13,510,-533,1043,-214,-171,-43,281.7837837837838,37,1,0,1049,TE,0
0,1,0,513,154,359,-175,-260,85,360.2,10,0,2,368,TE,0
0,1,0,618,272,346,-189,-264,75,332.72727272727275,11,0,4,348,TE,0
0,1,0,945,-118,1063,-190,-315,125,537.15,20,1,16,1061,WR,0
0,1,0,175,-1455,1630,-410,-343,-67,486.2647058823529,34,1,0,1630,RB,0
0,1,0,1235,-388,1623,-157,-209,52,337.46938775510205,49,1,17,1662,WR,0
0,1,0,636,286,350,-238,-306,68,261.0625,16,0,43,379,WR,0
0,1,0,476,-475,951,-244,-202,-42,277.62857142857143,35,1,5,965,TE,0
0,1,0,852,275,577,-199,-340,141,359.2352941176471,17,0,15,585,RB,0
0,1,0,1307,1240,67,-174,-201,27,77.1,10,0,16,77,WR,1
0,1,0,1013,-816,1829,-241,-235,-6,521.8285714285714,35,1,6,1828,WR,0
0,1,0,571,-145,716,-377,-574,197,231.0,34,1,6,730,RB,0
0,1,9,510,-1410,1920,-214,-163,-51,373.0192307692308,52,1,0,1931,TE,0
0,1,0,292,-184,476,-535,-577,42,324.4,15,1,4,472,RB,0
0,1,0,905,-703,1608,-197,-193,-4,425.0,38,1,10,1629,WR,0
0,1,13,936,390,546,-190,-167,-23,220.76,25,0,6,558,WR,0
0,1,0,961,-669,1630,-245,-293,48,368.188679245283,53,1,149,1783,WR,0
0,1,2,311,698,-387,-494,-196,-298,180.84615384615384,26,0,383,5,RB,0
0,1,0,1161,-1060,2221,-282,-178,-104,436.3529411764706,51,1,1,2215,WR,0
0,1,14,706,-1461,2167,-182,-95,-87,366.77966101694915,59,1,0,2163,WR,0
0,1,63,273,2131,-1858,-531,-185,-346,388.85714285714283,49,0,1845,20,RB,0
0,1,35,226,-1987,2213,-512,-92,-420,404.2037037037037,54,1,5,2194,RB,0
1,1,24,572,-462,1034,-181,-180,-1,220.94,50,1,45,1044,TE,0
1,1,29,451,-577,1028,-105,-235,130,229.93478260869566,46,1,32,1024,TE,0
0,1,3,692,-847,1539,-94,-165,71,310.719298245614,57,1,17,1606,WR,0
0,1,19,47,10,37,-717,-734,17,161.8,50,0,67,36,RB,1
0,1,0,1814,1051,763,-193,-117,-76,272.32142857142856,28,0,0,764,WR,0
0,1,1,160,-225,385,-546,-479,-67,152.58064516129033,31,1,42,430,RB,0
1,1,30,232,-230,462,-536,-473,-63,110.19148936170212,47,1,30,465,RB,0
1,1,35,1591,1756,-165,-79,-29,-50,92.28571428571429,21,0,181,2,WR,0
0,1,17,205,-188,393,-505,-459,-46,136.7741935483871,31,1,19,416,RB,0
0,1,60,551,745,-194,-201,-221,20,107.0625,16,0,216,2,WR,0
0,1,24,288,-432,720,-273,-230,-43,310.7083333333333,24,1,10,735,TE,0
0,1,0,224,-249,473,-502,-539,37,138.34375,32,1,2,460,RB,0
0,1,30,1177,566,611,-189,-90,-99,209.75757575757575,33,0,44,674,TE,0
0,1,0,231,-204,435,-552,-510,-42,185.34782608695653,23,1,4,436,RB,0
0,1,47,414,1019,-605,-193,-139,-54,206.3448275862069,29,0,618,17,TE,0
0,1,13,39,249,-210,-598,-523,-75,95.66666666666667,27,0,236,10,RB,0
0,1,0,246,246,0,-524,-467,-57,88.5,4,0,3,35,RB,0
0,1,1,214,-263,477,-520,-496,-24,154.16129032258064,31,1,10,474,RB,0
0,1,0,514,849,-335,-53,-73,20,176.16666666666666,18,0,342,2,TE,0
0,1,9,1217,439,778,-201,-224,23,250.96666666666667,30,0,4,766,WR,0
0,1,10,1013,-283,1296,-232,-514,282,274.7551020408163,49,1,3,1300,WR,0
0,1,0,7,692,-685,-714,179,-893,188.9056603773585,53,0,701,56,RB,0
0,1,0,842,855,-13,-76,350,-426,123.75,4,0,13,31,WR,1
0,1,0,986,1036,-50,-175,254,-429,87.57142857142857,7,0,28,8,TE,1
0,1,0,509,507,2,-270,130,-400,115.25,4,0,47,15,FB,1
0,1,0,865,832,33,-90,318,-408,86.33333333333333,3,0,13,18,WR,1
0,1,0,2020,1984,36,-167,226,-393,106.0,3,0,9,6,WR,1
0,1,0,446,481,-35,-79,309,-388,109.66666666666667,3,0,15,18,TE,1
0,1,0,530,-791,1321,-264,186,-450,263.66,50,1,1,1286,FB,0
0,1,0,1135,1090,45,-136,266,-402,117.25,4,0,14,13,WR,1
0,1,0,778,-570,1348,-174,-12,-162,553.9583333333334,24,1,2,1320,WR,0
0,1,0,253,319,-66,-469,-229,-240,102.33333333333333,3,0,40,2,FB,0
0,1,0,665,-453,1118,-266,-307,41,469.0833333333333,24,1,4,1122,RB,0
0,1,0,1180,-451,1631,-199,-641,442,430.02127659574467,47,1,97,1728,RB,0
0,1,0,1258,1000,258,-196,-150,-46,99.37037037037037,27,0,4,267,WR,0
1,1,1,997,1126,-129,-66,-75,9,116.09375,64,0,350,229,WR,1
0,1,40,2017,567,1450,-238,-150,-88,193.0721649484536,97,0,199,1656,TE,0
0,1,30,2,-36,38,-721,-700,-21,114.75471698113208,53,0,71,116,RB,1
0,1,17,826,855,-29,-94,-32,-62,106.82608695652173,69,0,306,274,WR,1
0,1,0,186,-3,189,-326,-382,56,150.10526315789474,19,1,28,239,FB,0
0,1,0,1229,-1146,2375,-205,-272,67,510.531914893617,47,1,7,2389,WR,0
0,1,28,960,1174,-214,-148,-184,36,125.32,100,0,738,538,WR,1
0,1,45,297,311,-14,-432,-427,-5,131.8452380952381,84,0,582,576,FB,1
1,1,52,21,11,10,-806,-754,-52,89.78787878787878,66,0,70,91,RB,1
0,1,0,0,-185,185,-449,-492,43,150.75,12,0,4,181,FB,0
0,1,9,161,-1629,1790,-468,-182,-286,357.9230769230769,52,1,8,1795,RB,0
0,1,0,875,-438,1313,-276,-367,91,458.6896551724138,29,1,9,1321,TE,0
0,1,0,541,400,141,-323,-305,-18,197.83333333333334,6,0,2,127,FB,0
0,1,0,1085,1366,-281,-108,-143,35,146.0,63,0,609,328,WR,1
0,1,0,1416,1056,360,-167,-173,6,148.66666666666666,24,0,0,356,WR,0
0,1,0,273,-408,681,-631,-660,29,433.8125,16,1,4,690,RB,0
0,1,0,990,573,417,-174,-193,19,293.85714285714283,14,0,2,412,WR,0
0,1,2,8,532,-524,-289,-231,-58,273.85,20,0,524,0,FB,0
0,1,1,1036,-709,1745,-260,-185,-75,328.92452830188677,53,1,11,1752,WR,0
0,1,0,1522,942,580,-142,-149,7,202.24137931034483,29,0,3,583,WR,0
0,1,22,570,578,-8,-218,-229,11,41.0,1,0,13,2,RB,0
0,1,5,590,-475,1065,-206,-137,-69,301.8611111111111,36,1,10,1081,TE,0
0,1,19,424,-512,936,-263,-197,-66,309.38709677419354,31,1,2,940,FB,0
0,1,0,1182,-1003,2185,-245,-55,-190,348.80882352941177,68,1,66,2269,WR,0
0,1,0,1173,248,925,-221,-225,4,243.82926829268294,41,0,26,975,TE,0
0,1,0,1644,594,1050,-154,-159,5,185.24590163934425,61,0,28,1090,TE,0
0,1,0,1340,450,890,-146,-118,-28,234.1315789473684,38,0,6,902,TE,0
0,1,2,1158,21,1137,-314,-562,248,264.54347826086956,46,0,59,1190,RB,0
0,1,0,1015,194,821,-185,-249,64,405.55,20,0,8,818,WR,0
0,1,0,823,606,217,-293,-315,22,274.125,8,0,2,229,WR,0
0,1,0,1070,-265,1335,-278,-519,241,250.135593220339,59,1,46,1380,WR,0
0,1,0,866,380,486,-207,-169,-38,184.89285714285714,28,0,3,495,WR,0
1,1,25,268,226,42,-487,-394,-93,66.6969696969697,33,0,86,140,RB,1
1,1,49,1010,619,391,-213,-72,-141,193.79166666666666,24,0,16,420,TE,0
0,1,0,743,-284,1027,-300,-335,35,524.35,20,1,12,1029,WR,0
0,1,39,687,537,150,-164,-224,60,97.57142857142857,14,0,11,165,WR,0
0,1,0,708,667,41,-62,304,-366,59.5,6,0,23,30,TE,1
0,1,4,636,-962,1598,-264,-308,44,377.95348837209303,43,1,4,1603,RB,0
0,1,0,241,-280,521,-503,-498,-5,190.71428571428572,28,1,9,525,RB,0
0,1,7,1581,979,602,-197,-187,-10,188.21875,32,0,8,619,QB,0
0,1,0,885,538,347,-213,-274,61,316.6666666666667,12,0,12,371,WR,0
0,1,24,209,-785,994,-322,-144,-178,357.3333333333333,30,1,4,1007,WR,0
1,1,25,1504,207,1297,-171,-518,347,270.45283018867923,53,0,58,1345,RB,0
1,1,37,864,1368,-504,-41,-48,7,131.30769230769232,39,0,516,3,WR,0
0,1,0,12,4,8,-707,-647,-60,105.0,3,0,2,27,RB,0
0,1,23,198,897,-699,-280,-187,-93,279.5925925925926,27,0,715,5,WR,0
0,1,0,478,-498,976,-195,86,-281,273.18918918918916,37,1,14,1027,TE,0
0,1,0,7,15,-8,-687,-516,-171,133.75,4,0,0,44,RB,0
0,1,0,1070,-320,1390,-242,-265,23,439.25,32,1,5,1389,WR,0
0,1,0,2,371,-369,-774,-814,40,332.1666666666667,12,0,382,19,RB,0
0,1,0,991,-451,1442,-281,-355,74,520.7142857142857,28,1,5,1455,WR,0
0,1,49,1394,408,986,-191,-277,86,245.925,40,0,14,987,WR,0
0,1,12,619,-988,1607,-179,-121,-58,265.03333333333336,60,1,7,1599,WR,0
0,1,46,1,-157,158,-685,-532,-153,79.96,25,1,14,187,RB,0
0,1,21,249,227,22,-565,-464,-101,111.89855072463769,69,0,172,213,RB,1
1,1,0,15,-274,289,-860,-551,-309,89.71698113207547,53,1,55,353,RB,0
0,1,39,177,-486,663,-464,-246,-218,208.9090909090909,33,1,12,684,FB,0
0,1,5,778,162,616,-218,-408,190,200.06451612903226,31,0,19,615,FB,0
0,1,48,184,-429,613,-452,-226,-226,184.0,36,1,15,647,FB,0
0,1,41,1588,679,909,-165,-131,-34,248.63888888888889,36,0,7,903,TE,0
0,1,0,596,-506,1102,-223,-276,53,400.44444444444446,27,1,6,1110,FB,0
0,1,53,150,-481,631,-445,-218,-227,166.12820512820514,39,1,12,650,FB,0
0,1,0,634,373,261,-269,-270,1,238.72727272727272,11,0,6,265,FB,0
0,1,0,1001,-572,1573,-308,-293,-15,411.175,40,1,54,1598,RB,0
0,1,67,830,-900,1730,-169,-177,8,380.53333333333336,45,1,2,1745,WR,0
0,1,28,497,232,265,-293,-269,-24,85.51612903225806,31,0,17,303,TE,0
1,1,0,474,-193,667,-275,-515,240,197.55,40,1,41,726,RB,0
1,1,0,21,237,-216,-563,-478,-85,88.21428571428571,28,0,224,30,RB,0
1,1,26,503,951,-448,-91,-56,-35,152.59259259259258,27,0,441,15,TE,0
1,1,26,466,-20,486,-265,-708,443,230.3793103448276,29,1,18,485,RB,0
1,1,8,470,1149,-679,-99,-29,-70,214.72727272727272,33,0,710,11,TE,0
0,1,0,16,-253,269,-511,-507,-4,137.57894736842104,19,1,12,276,TE,0
0,1,0,462,-766,1228,-204,-206,2,364.42857142857144,35,1,15,1243,WR,0
0,1,0,472,488,-16,-98,-76,-22,53.68421052631579,19,0,132,95,TE,1
0,1,6,7,-259,266,-844,-534,-310,148.41666666666666,24,1,12,286,RB,0
0,1,55,1501,1243,258,-177,-203,26,161.1764705882353,17,0,18,265,WR,0
0,1,7,4,302,-298,-789,-547,-242,165.45454545454547,22,0,313,6,RB,0
0,1,29,651,-911,1562,-191,-169,-22,307.2692307692308,52,1,9,1566,TE,0
1,1,40,917,1066,-149,-198,-141,-57,95.0,16,0,138,22,WR,0
1,1,28,807,1974,-1167,-74,-38,-36,288.390243902439,41,0,1175,37,WR,0
1,1,34,836,1310,-474,-66,-93,27,160.96428571428572,28,0,489,12,WR,0
0,1,8,740,-680,1420,-251,-142,-109,281.34615384615387,52,1,11,1429,TE,0
1,1,45,216,226,-10,-500,-394,-106,90.4,35,0,46,51,RB,1
0,1,0,181,-542,723,-458,-73,-385,190.46341463414635,41,1,13,724,FB,0
0,1,0,965,488,477,-215,-223,8,333.46666666666664,15,0,11,492,WR,0
0,1,0,33,-731,764,-281,-88,-193,253.75,36,1,2,819,TE,0
0,1,8,359,319,40,-459,-463,4,234.68333333333334,60,0,660,728,RB,1
0,1,0,1245,967,278,-69,36,-105,141.58490566037736,53,0,231,534,WR,1
0,1,33,26,179,-153,-682,-583,-99,84.65384615384616,26,0,179,37,RB,1
0,1,0,617,354,263,-229,-280,51,130.27777777777777,18,0,2,267,FB,0
0,1,0,2032,667,1365,-284,-374,90,442.7741935483871,31,0,0,1366,RB,0
0,1,59,188,996,-808,-502,-260,-242,223.65,40,0,816,10,RB,0
0,1,0,1502,623,879,-193,-35,-158,241.9,40,0,37,940,TE,0
0,1,0,1575,913,662,-224,-242,18,260.84615384615387,26,0,0,666,WR,0
0,1,0,461,-512,973,-195,-221,26,345.42857142857144,28,1,4,966,TE,0
0,1,0,649,-845,1494,-255,-209,-46,412.9166666666667,36,1,4,1505,WR,0
1,1,34,197,3,194,-634,-765,131,104.39285714285714,28,0,28,219,RB,0
0,1,0,624,-803,1427,-224,-123,-101,386.35135135135135,37,1,2,1440,WR,0
0,1,0,799,780,19,-225,-219,-6,145.91666666666666,24,0,163,170,WR,1
0,1,0,692,-960,1652,-224,-138,-86,278.34285714285716,70,1,147,1799,WR,0
0,1,0,992,300,692,-157,-126,-31,297.34615384615387,26,0,13,707,WR,0
0,1,0,926,-1054,1980,-228,-43,-185,399.2,50,1,0,1973,WR,0
0,1,31,166,259,-93,-570,-436,-134,192.51162790697674,43,0,446,360,RB,1
0,1,0,430,491,-61,-227,-79,-148,180.75,40,0,382,326,TE,1
0,1,0,205,-159,364,-526,-365,-161,136.74074074074073,27,1,12,349,RB,0
0,1,57,995,1007,-12,-77,-13,-64,44.0,2,0,20,8,WR,1
0,1,0,597,-657,1254,-282,-152,-130,376.06060606060606,33,1,10,1246,WR,0
0,1,4,515,-465,980,-204,-143,-61,268.8333333333333,36,1,11,974,TE,0
0,1,0,605,-1119,1724,-198,-81,-117,258.59090909090907,66,1,5,1728,WR,0
0,1,0,1150,-445,1595,-197,-318,121,395.20454545454544,44,1,70,1666,WR,0
0,1,8,231,-232,463,-537,-523,-14,172.51724137931035,29,1,22,493,RB,0
0,1,5,1141,758,383,-233,-177,-56,214.1578947368421,19,0,0,381,TE,0
0,1,0,455,490,-35,-135,-82,-53,37.054054054054056,37,0,147,124,TE,1
0,1,15,569,1179,-610,-227,-182,-45,160.0,45,0,669,44,WR,0
1,1,32,218,-191,409,-530,-460,-70,186.33333333333334,24,1,19,442,RB,0
0,1,52,810,1592,-782,-226,-141,-85,329.08,25,0,789,11,RB,0
1,1,59,1579,627,952,-143,-151,8,251.28947368421052,38,0,11,969,RB,0
1,1,55,2187,536,1651,-259,-214,-45,359.2,45,0,9,1652,TE,0
0,1,0,830,546,284,-68,-269,201,162.84615384615384,26,0,23,297,WR,0
0,1,44,100,761,-661,-303,-271,-32,241.89285714285714,28,0,673,8,WR,0
0,1,22,262,-251,513,-482,-405,-77,175.28571428571428,28,1,6,473,RB,0
0,1,0,732,422,310,-147,-286,139,336.8,10,0,22,316,WR,0
0,1,55,767,-277,1044,-171,-424,253,256.7111111111111,45,1,13,1078,WR,0
0,1,0,151,297,-146,-449,-420,-29,171.66666666666666,6,0,131,4,RB,0
0,1,0,846,-394,1240,-224,-391,167,274.51063829787233,47,1,9,1241,WR,0
0,1,0,409,438,-29,-67,-62,-5,44.28846153846154,52,0,165,124,TE,1
1,1,48,1103,566,537,-139,-151,12,154.0,36,0,2,548,WR,0
1,1,0,557,-502,1059,-231,-164,-67,233.4313725490196,51,1,68,1137,WR,0
0,1,8,161,-249,410,-605,-594,-11,192.8095238095238,21,1,7,415,RB,0
0,1,19,263,-87,350,-483,-117,-366,203.42857142857142,21,1,14,287,RB,0
0,1,0,446,-421,867,-228,-217,-11,308.67857142857144,28,1,8,876,TE,0
0,1,0,88,-410,498,-275,-418,143,182.59375,32,1,11,483,WR,0
0,1,0,1115,416,699,-244,-364,120,424.0,17,0,3,703,WR,0
0,1,0,722,-379,1101,-245,-293,48,358.4,35,1,71,1178,WR,0
0,1,0,755,309,446,-171,-366,195,318.1875,16,0,18,457,WR,0
0,1,28,185,170,15,-491,-484,-7,22.0,2,0,22,39,WR,1
0,1,0,953,550,403,-160,-286,126,231.4,20,0,6,405,WR,0
0,1,0,1070,-134,1204,-193,-629,436,480.4074074074074,27,1,10,1210,WR,0
0,1,48,197,-202,399,-519,-566,47,182.42857142857142,21,1,2,413,RB,0
0,1,77,183,-1407,1590,-554,-89,-465,314.18518518518516,54,1,11,1587,RB,0
0,1,4,1650,1061,589,-209,-161,-48,173.5,34,0,0,589,WR,0
0,1,40,966,-817,1783,-181,-182,1,324.3818181818182,55,1,8,1790,WR,0
0,1,2,234,-263,497,-585,-374,-211,190.35714285714286,28,1,4,507,RB,0
0,1,0,1599,850,749,-214,-120,-94,210.19444444444446,36,0,17,754,WR,0
0,1,0,904,940,-36,-112,-4,-108,79.97297297297297,37,0,139,112,WR,1
0,1,14,155,-206,361,-570,-531,-39,148.375,24,1,4,369,RB,0
0,1,0,161,-448,609,-501,-144,-357,241.43333333333334,30,1,33,640,TE,0
0,1,0,0,1183,-1183,-791,-259,-532,314.86,50,0,1255,64,RB,0
0,1,0,1018,635,383,-226,-388,162,265.3,20,0,53,431,WR,0
0,1,34,650,1432,-782,-404,-53,-351,289.0,30,0,798,4,RB,0
1,1,19,461,-1093,1554,-223,-72,-151,313.29411764705884,51,1,18,1592,WR,0
1,1,28,440,-424,864,-234,-88,-146,201.64285714285714,42,1,6,848,TE,0
1,1,37,587,870,-283,-94,20,-114,98.82142857142857,28,0,307,11,WR,0
0,1,37,75,-239,314,-564,-404,-160,141.63636363636363,22,1,4,301,RB,0
0,1,26,27,13,14,-778,-739,-39,120.50980392156863,51,0,52,76,RB,1
0,1,0,1248,-1166,2414,-176,-179,3,545.7727272727273,44,1,14,2410,WR,0
0,1,0,1666,1327,339,-210,-165,-45,186.26315789473685,19,0,2,351,WR,0
0,1,0,530,415,115,-232,-193,-39,201.57894736842104,38,0,326,448,TE,1
0,1,0,848,758,90,-178,-148,-30,244.4468085106383,47,0,530,611,WR,1
0,1,0,845,-109,954,-283,-280,-3,377.3,70,1,824,1789,WR,1
0,1,0,278,-244,522,-477,-458,-19,317.11764705882354,17,1,2,521,RB,0
0,1,36,3,-492,495,-216,-84,-132,219.69230769230768,26,1,14,504,TE,0
0,1,0,541,-1211,1752,-221,-241,20,400.1818181818182,44,1,2,1756,WR,0
0,1,0,441,-213,654,-253,-343,90,219.0,30,1,11,666,TE,0
0,1,22,819,271,548,-349,-348,-1,226.16666666666666,30,0,47,608,RB,0
1,1,35,119,-250,369,-568,-521,-47,193.14285714285714,21,1,21,395,RB,0
0,1,0,729,-1119,1848,-204,-158,-46,335.8735632183908,87,1,544,2391,WR,1
0,1,17,800,-833,1633,-268,-239,-29,375.09090909090907,44,1,3,1627,TE,0
0,1,0,674,-1044,1718,-219,-175,-44,318.67469879518075,83,1,474,2193,WR,1
0,1,38,50,-236,286,-578,-389,-189,258.825,120,1,1326,1617,RB,1
0,1,82,287,1008,-721,-459,-259,-200,248.2,30,0,737,8,RB,0
0,1,53,212,217,-5,-341,-338,-3,44.0,2,0,17,2,TE,0
0,1,0,504,406,98,-200,-212,12,302.05405405405406,37,0,511,579,TE,1
0,1,0,1430,762,668,-286,-212,-74,244.03703703703704,27,0,0,660,TE,0
0,1,13,274,284,-10,-465,-456,-9,37.0,1,0,3,0,RB,0
0,1,18,437,-786,1223,-233,-59,-174,365.3529411764706,34,1,4,1227,WR,0
0,1,0,1504,951,553,-246,-146,-100,236.1818181818182,22,0,2,529,WR,0
0,1,10,1296,-253,1549,-372,-418,46,407.2,40,1,6,1567,RB,0
0,1,0,1636,1089,547,-268,-144,-124,208.44444444444446,27,0,6,573,TE,0
0,1,0,501,407,94,-241,-191,-50,234.4857142857143,35,0,366,452,TE,1
0,1,0,1007,-754,1761,-231,-224,-7,528.4117647058823,34,1,0,1760,WR,0
0,1,0,949,133,816,-241,-266,25,393.3378378378378,74,0,1027,1840,WR,1
1,1,24,759,1393,-634,-161,-155,-6,206.3,30,0,641,4,WR,0
1,1,21,28,240,-212,-701,-456,-245,138.0952380952381,21,0,228,6,RB,0
1,1,5,346,539,-193,-187,-74,-113,125.21052631578948,19,0,211,21,TE,0
1,1,13,49,471,-422,-439,-128,-311,194.82758620689654,29,0,439,13,TE,0
1,1,40,97,-235,332,-548,-484,-64,151.375,24,1,2,338,RB,0
1,1,26,822,655,167,-224,-76,-148,114.5625,16,0,3,154,TE,0
0,1,0,994,-674,1668,-172,-280,108,364.0652173913044,46,1,2,1680,WR,0
0,1,21,139,256,-117,-356,-461,105,123.4090909090909,22,0,151,34,RB,1
0,1,0,558,604,-46,-203,-193,-10,177.8,45,0,425,367,TE,1
0,1,0,1318,914,404,-236,-207,-29,135.35714285714286,28,0,0,402,TE,0
1,1,61,457,618,-161,-402,-230,-172,133.94444444444446,18,0,165,7,RB,0
1,1,57,258,474,-216,-315,-163,-152,126.81818181818181,22,0,225,8,TE,0
0,1,3,738,-1393,2131,-211,-100,-111,288.6164383561644,73,1,0,2125,WR,0
0,1,0,691,-761,1452,-223,-264,41,396.13513513513516,37,1,5,1455,WR,0
0,1,0,853,-112,965,-185,-297,112,235.52380952380952,42,1,6,966,WR,0
0,1,64,475,603,-128,-274,-136,-138,128.33333333333334,15,0,124,17,TE,0
0,1,0,640,-567,1207,-176,-252,76,306.27450980392155,51,1,146,1347,WR,0
1,1,72,465,558,-93,-281,-206,-75,78.41176470588235,17,0,95,11,RB,0
1,1,73,461,600,-139,-199,-180,-19,95.8125,16,0,158,4,TE,0
0,1,0,2033,1517,516,-148,-172,24,196.48,25,0,0,512,WR,0
0,1,41,226,-303,529,-532,-477,-55,156.46875,32,1,17,524,RB,0
0,1,0,16,212,-196,-794,-566,-228,155.05555555555554,18,0,224,4,RB,0
1,1,4,259,-177,436,-551,-518,-33,176.4,25,1,10,454,RB,0
0,1,5,894,-2147,3041,-171,-133,-38,409.51190476190476,84,1,189,3235,WR,0
0,1,7,872,-648,1520,-222,-192,-30,319.6875,48,1,4,1533,TE,0
0,1,16,906,-1119,2025,-197,-172,-25,366.8,55,1,1,1994,WR,0
0,1,3,705,308,397,-170,-291,121,241.2941176470588,51,0,411,808,WR,1
0,1,11,756,356,400,-211,-269,58,263.14,50,0,465,866,WR,1
0,1,44,193,243,-50,-552,-455,-97,95.18181818181819,11,0,53,2,RB,0
1,1,19,4,6,-2,-671,-746,75,156.76190476190476,63,0,81,99,RB,1
0,1,50,3,-203,206,-754,-531,-223,162.8421052631579,19,1,10,226,RB,0
0,1,3,824,385,439,-190,-222,32,199.625,24,0,2,485,WR,0
0,1,0,593,-899,1492,-267,-189,-78,385.61538461538464,39,1,2,1492,WR,0
0,1,10,258,-225,483,-539,-514,-25,190.80769230769232,26,1,4,501,RB,0
0,1,1,240,-316,556,-527,-537,10,217.8846153846154,26,1,15,571,RB,0
0,1,18,260,566,-306,-495,-188,-307,200.05,20,0,284,7,RB,0
0,1,0,8,114,-106,-477,-475,-2,112.25,8,0,106,6,FB,0
0,1,0,469,99,370,-268,-285,17,161.84,25,0,10,397,FB,0
0,1,0,252,-268,520,-523,-414,-109,195.86206896551724,29,1,18,558,RB,0
0,1,15,174,-315,489,-545,-431,-114,236.5,22,1,15,486,RB,0
0,1,32,169,229,-60,-556,-471,-85,87.8695652173913,23,0,134,75,RB,1
0,1,58,213,451,-238,-381,-68,-313,200.52380952380952,21,0,255,32,TE,0
0,1,0,482,-36,518,-216,-251,35,317.7647058823529,17,1,17,529,TE,0
0,1,0,556,-1160,1716,-257,-338,81,428.125,40,1,3,1729,QB,0
0,1,36,217,-836,1053,-542,-182,-360,261.6744186046512,43,1,2,1053,RB,0
0,1,8,928,-1487,2415,-257,-214,-43,381.5967741935484,62,1,4,2393,WR,0
0,1,0,1162,-314,1476,-182,-264,82,523.6071428571429,28,1,5,1465,WR,0
0,1,32,255,251,4,-498,-498,0,38.0,1,0,10,2,RB,1
1,1,25,219,265,-46,-406,-498,92,96.27906976744185,43,0,132,72,RB,1
1,1,41,629,493,136,-81,-116,35,62.1578947368421,19,0,11,125,TE,0
0,1,2,678,-1247,1925,-239,-193,-46,368.21153846153845,52,1,2,1933,WR,0
0,1,0,2101,1245,856,-173,20,-193,233.61764705882354,34,0,2,825,WR,0
0,1,7,1654,1177,477,-294,-240,-54,177.88888888888889,27,0,9,483,TE,0
0,1,0,1924,1115,809,-252,-154,-98,153.42592592592592,54,0,0,824,WR,0
0,1,23,116,289,-173,-473,-534,61,65.18181818181819,22,0,156,5,RB,0
0,1,0,1794,1975,-181,-112,-14,-98,79.66666666666667,33,0,206,49,WR,1
0,1,0,505,64,441,-244,-459,215,221.72727272727272,44,0,235,684,QB,1
0,1,71,186,636,-450,-523,-150,-373,235.20833333333334,24,0,438,2,RB,0
0,1,0,1030,-1063,2093,-186,-279,93,459.1333333333333,45,1,4,2082,WR,0
0,1,13,214,227,-13,-482,-505,23,138.6451612903226,31,0,121,85,RB,1
0,1,0,384,-1017,1401,-356,-256,-100,338.8780487804878,41,1,4,1399,TE,0
0,1,0,547,-1179,1726,-236,-211,-25,376.2608695652174,46,1,6,1736,WR,0
0,1,0,148,-199,347,-567,-444,-123,143.1153846153846,26,1,10,358,RB,0
0,1,0,952,-734,1686,-246,-340,94,467.52777777777777,36,1,1,1688,WR,0
0,1,0,256,-721,977,-428,-213,-215,271.5,36,1,9,964,RB,0
0,1,10,68,-1790,1858,-361,-143,-218,301.03225806451616,62,1,22,1857,RB,0
0,1,0,391,-753,1144,-210,-56,-154,296.0,39,1,2,1122,TE,0
1,1,47,4,-536,540,-448,-64,-384,155.275,40,1,14,560,TE,0
1,1,45,518,-483,1001,-204,-119,-85,237.78571428571428,42,1,13,1014,TE,0
0,1,0,458,397,61,-215,-219,4,103.25,8,0,27,75,FB,1
0,1,0,8,-194,202,-788,-414,-374,136.1304347826087,23,1,17,194,RB,0
0,1,6,169,253,-84,-592,-512,-80,147.175,40,0,259,188,RB,1
0,1,0,460,-417,877,-248,-321,73,279.84615384615387,39,1,110,998,FB,0
0,1,44,1354,205,1149,-291,-390,99,336.57142857142856,35,0,20,1140,RB,0
0,1,0,250,-201,451,-582,-322,-260,308.6111111111111,18,1,4,456,RB,0
0,1,29,382,-508,890,-231,-232,1,247.47368421052633,38,1,18,911,FB,0
0,1,24,445,-741,1186,-240,-79,-161,267.6666666666667,45,1,8,1179,TE,0
0,1,0,605,145,460,-190,-469,279,162.14285714285714,35,0,9,462,TE,0
0,1,27,695,-976,1671,-162,-164,2,348.4166666666667,48,1,4,1681,WR,0
0,1,0,581,427,154,-184,-206,22,200.5,8,0,4,164,FB,0
0,1,0,628,-845,1473,-218,-220,2,419.6857142857143,35,1,8,1484,WR,0
0,1,0,459,476,-17,-161,-110,-51,55.06521739130435,46,0,135,115,TE,1
0,1,0,1178,547,631,-232,-526,294,403.7647058823529,17,0,2,637,RB,0
0,1,8,209,-948,1157,-517,2,-519,283.31111111111113,45,1,23,1199,WR,0
1,1,0,711,-560,1271,-199,-209,10,305.27272727272725,44,1,31,1308,TE,0
1,1,0,441,475,-34,-148,-102,-46,52.875,40,0,146,116,TE,1
0,1,71,8,-217,225,-786,-468,-318,87.55102040816327,49,1,36,291,RB,0
0,1,0,811,-754,1565,-292,-213,-79,286.3090909090909,55,1,18,1591,WR,0
0,1,77,184,-249,433,-508,-510,2,142.03333333333333,30,1,19,439,RB,0
0,1,0,756,-831,1587,-227,-144,-83,375.13953488372096,43,1,9,1593,WR,0
0,1,0,934,511,423,-217,-275,58,249.38888888888889,18,0,6,425,WR,0
0,1,0,595,583,12,-196,-186,-10,42.32142857142857,28,0,58,68,TE,1
0,1,0,477,471,6,-97,-102,5,45.666666666666664,24,0,44,56,TE,1
0,1,87,697,-1071,1768,-336,-173,-163,277.609375,64,1,24,1778,WR,0
0,1,0,481,495,-14,-112,-27,-85,53.833333333333336,12,0,47,18,TE,1
0,1,0,2062,1525,537,-217,-138,-79,277.95,20,0,0,553,WR,0
0,1,0,1228,414,814,-246,-129,-117,193.92857142857142,42,0,11,806,WR,0
0,1,0,581,358,223,-230,-212,-18,195.0,11,0,17,230,WR,0
0,1,0,731,763,-32,-200,27,-227,83.42857142857143,7,0,50,11,RB,1
0,1,0,680,-2025,2705,-179,-134,-45,403.0149253731343,67,1,1,2705,WR,0
0,1,0,2008,1591,417,-271,-240,-31,249.11764705882354,17,0,7,413,WR,0
0,1,65,180,-19,199,-590,-700,110,90.84615384615384,26,1,10,199,RB,0
0,1,42,316,666,-350,-498,-188,-310,190.45833333333334,24,0,373,24,RB,0
0,1,0,987,-1027,2014,-276,-225,-51,504.75,40,1,7,2007,WR,0
0,1,0,516,-800,1316,-270,-213,-57,385.20588235294116,34,1,10,1325,WR,0
0,1,0,1728,1503,225,-243,-251,8,141.0,17,0,16,229,WR,0
0,1,3,447,823,-376,-128,-108,-20,91.88095238095238,42,0,432,71,TE,0
0,1,0,804,-961,1765,-246,-143,-103,319.7818181818182,55,1,3,1763,WR,0
0,1,56,537,-2036,2573,-300,-235,-65,456.0175438596491,57,1,11,2593,WR,0
0,1,0,947,-1109,2056,-239,-249,10,406.54901960784315,51,1,27,2098,WR,0
0,1,0,825,-517,1342,-187,-339,152,363.8918918918919,37,1,4,1345,WR,0
0,1,0,1745,1226,519,-226,-195,-31,140.2826086956522,46,0,23,563,WR,0
0,1,24,797,-894,1691,-195,-133,-62,332.3137254901961,51,1,16,1694,WR,0
0,1,16,1245,509,736,-228,-143,-85,240.5483870967742,31,0,28,747,TE,0
0,1,28,534,-897,1431,-273,-224,-49,294.2040816326531,49,1,20,1422,WR,0
0,1,2,261,2023,-1762,-515,-127,-388,332.5272727272727,55,0,1767,16,RB,0
0,1,0,1171,854,317,-163,-141,-22,185.2941176470588,17,0,0,324,WR,0
0,1,0,833,-634,1467,-248,-228,-20,285.28846153846155,52,1,11,1498,WR,0
0,1,0,463,411,52,-82,-75,-7,84.8,5,0,6,50,TE,0
0,1,0,14,198,-184,-486,-478,-8,142.0,13,0,191,27,TE,0
0,1,3,267,264,3,-525,-517,-8,15.75,4,0,17,17,RB,1
0,1,23,276,-196,472,-539,-481,-58,166.42857142857142,28,1,18,468,RB,0
1,1,15,1504,1045,459,-47,-49,2,131.37777777777777,45,0,24,490,WR,0
1,1,26,1973,477,1496,-164,-205,41,295.3333333333333,51,0,23,1516,TE,0
0,1,30,1462,219,1243,-103,-383,280,237.3272727272727,55,0,11,1249,RB,0
0,1,27,600,230,370,-177,-417,240,118.34883720930233,43,0,10,365,RB,0
0,1,0,1182,928,254,-209,-185,-24,144.1904761904762,21,0,18,317,WR,0
0,1,22,187,-200,387,-456,-392,-64,115.6,35,1,7,395,RB,0
1,1,0,1554,1067,487,-178,-94,-84,248.65,20,0,4,493,WR,0
1,1,10,235,-209,444,-468,-490,22,159.93103448275863,29,1,4,439,RB,0
0,1,0,227,-287,514,-474,-467,-7,156.24242424242425,33,1,31,528,RB,0
0,1,34,240,-198,438,-548,-495,-53,102.12,50,1,11,453,RB,0
1,1,22,702,715,-13,-134,-78,-56,176.27450980392157,51,0,464,463,WR,1
1,1,39,1055,936,119,-170,-102,-68,97.85714285714286,14,0,35,140,TE,1
1,1,44,1405,1420,-15,-82,-27,-55,65.62162162162163,37,0,122,131,WR,1
1,1,33,234,-209,443,-544,-449,-95,109.86,50,1,6,477,RB,0
0,1,2,878,26,852,-172,-675,503,160.52631578947367,76,0,40,879,RB,0
0,1,25,193,229,-36,-544,-520,-24,105.27118644067797,59,0,168,165,RB,1
1,1,21,1666,1707,-41,-128,-121,-7,142.7872340425532,47,0,337,329,WR,1
0,1,0,481,499,-18,-69,-65,-4,48.95238095238095,21,0,39,32,TE,1
0,1,0,2136,220,1916,-160,-421,261,273.7358490566038,106,0,484,2401,RB,1
0,1,0,259,-244,503,-528,-539,11,210.20833333333334,24,1,5,509,RB,0
1,1,0,572,-509,1081,-199,-131,-68,227.07692307692307,52,1,28,1072,TE,0
0,1,0,443,-421,864,-141,-86,-55,215.5581395348837,43,1,24,851,TE,0
1,1,45,216,-9,225,-498,-818,320,166.04166666666666,24,1,4,241,RB,0
1,1,19,1876,615,1261,-191,-155,-36,283.19565217391306,46,0,32,1278,TE,0
0,1,10,215,-25,240,-496,-864,368,176.6153846153846,26,1,14,249,RB,0
0,1,9,245,-179,424,-547,-425,-122,163.98863636363637,88,1,377,825,RB,1
0,1,0,68,256,-188,-508,-242,-266,187.6590909090909,44,0,480,261,TE,1
0,1,0,1917,1917,0,-35,297,-332,77.25,4,0,11,12,WR,1
1,1,0,632,-1093,1725,-199,211,-410,320.1090909090909,55,1,0,1729,TE,0
1,1,33,34,212,-178,-656,-111,-545,90.51612903225806,31,0,186,14,RB,0
0,1,27,755,-820,1575,-230,-161,-69,332.3541666666667,48,1,6,1584,WR,0
0,1,35,262,-253,515,-475,-496,21,194.07407407407408,27,1,4,525,RB,0
0,1,51,55,21,34,-723,-765,42,138.05128205128204,39,0,60,38,RB,1
0,1,0,1041,465,576,-180,-265,85,286.4237288135593,59,0,557,1139,TE,1
0,1,28,299,-269,568,-425,-420,-5,153.21052631578948,38,1,9,579,RB,0
0,1,0,849,503,346,-193,-204,11,274.6923076923077,13,0,13,342,WR,0
0,1,18,140,-255,395,-514,-489,-25,205.0,20,1,6,394,RB,0
0,1,66,255,29,226,-545,-695,150,146.29166666666666,24,0,2,253,RB,0
0,1,27,60,-200,260,-560,-464,-96,151.5,20,1,23,287,RB,0
0,1,29,1040,-534,1574,-238,-140,-98,339.9166666666667,48,1,32,1601,TE,0
1,1,0,872,658,214,-126,-103,-23,69.07894736842105,38,0,41,250,TE,0
1,1,32,173,23,150,-679,-757,78,108.4,20,0,18,166,RB,0
1,1,25,1165,535,630,-251,-213,-38,243.3448275862069,29,0,37,665,TE,0
1,1,19,1792,1164,628,-86,-76,-10,134.61363636363637,44,0,10,610,WR,0
1,1,107,10,-1983,1993,-780,-158,-622,409.7843137254902,51,1,2,2017,RB,0
1,1,113,564,1614,-1050,-169,-196,27,223.85106382978722,47,0,1076,57,TE,0
1,1,130,734,611,123,-183,-98,-85,82.25,20,0,19,180,TE,0
1,1,127,416,966,-550,-86,-210,124,166.78125,32,0,550,24,TE,0
0,1,0,244,-237,481,-519,-519,0,192.04,25,1,0,478,RB,0
0,1,30,622,437,185,-109,-93,-16,64.06060606060606,33,0,34,200,TE,0
0,1,0,904,-575,1479,-271,-212,-59,437.70588235294116,34,1,10,1474,WR,0
0,1,0,626,-584,1210,-188,-242,54,270.1666666666667,48,1,38,1258,WR,0
0,1,0,471,-572,1043,-240,-251,11,296.05555555555554,36,1,0,1045,TE,0
0,1,0,73,542,-469,-359,-88,-271,211.7037037037037,27,0,481,14,TE,0
0,1,38,826,1370,-544,-104,-34,-70,181.57692307692307,52,0,741,218,WR,1
1,1,36,22,11,11,-733,-687,-46,113.5945945945946,74,0,138,99,RB,1
1,1,56,967,1111,-144,-226,-202,-24,91.54545454545455,33,0,241,87,WR,1
1,1,2,566,585,-19,-186,-140,-46,85.49484536082474,97,0,506,472,TE,1
0,1,0,410,396,14,-226,-210,-16,51.90243902439025,41,0,89,90,TE,1
0,1,0,14,1023,-1009,-748,-282,-466,238.30612244897958,49,0,1047,5,WR,0
0,1,0,1149,-236,1385,-196,-389,193,458.90625,32,1,51,1431,WR,0
0,1,0,818,-391,1209,-248,-230,-18,341.4310344827586,58,1,377,1584,WR,1
0,1,13,318,172,146,-413,-472,59,190.0327868852459,61,0,466,598,RB,1
0,1,66,1048,151,897,-224,-443,219,182.6727272727273,55,0,15,937,RB,0
0,1,0,99,226,-127,-499,-301,-198,84.22222222222223,18,0,133,20,RB,0
1,1,17,711,-725,1436,-158,-114,-44,261.0357142857143,56,1,20,1453,WR,0
1,1,0,254,-246,500,-517,-503,-14,195.72,25,1,20,504,RB,0
0,1,0,586,-962,1548,-217,-112,-105,278.50877192982455,57,1,7,1564,WR,0
0,1,0,1301,-538,1839,-175,-257,82,390.42857142857144,49,1,40,1888,WR,0
0,1,23,45,-6,51,-700,-698,-2,108.57894736842105,95,0,92,109,RB,1
0,1,0,1042,657,385,-146,-283,137,360.90909090909093,11,0,22,380,WR,0
0,1,18,548,-630,1178,-243,-162,-81,249.89361702127658,47,1,2,1205,TE,0
0,1,0,185,-548,733,-586,-589,3,450.94117647058823,17,1,31,759,RB,0
0,1,0,696,-1166,1862,-186,-135,-51,358.78846153846155,52,1,0,1861,WR,0
0,1,0,712,-1159,1871,-210,-172,-38,425.40909090909093,44,1,2,1872,WR,0
0,1,0,910,784,126,-180,-197,17,94.0,18,0,16,140,WR,0
0,1,65,1345,1235,110,-136,-167,31,64.94444444444444,18,0,2,128,WR,0
0,1,1,1118,-395,1513,-245,-61,-184,270.82758620689657,58,1,64,1534,TE,0
0,1,0,728,-118,846,-215,-180,-35,337.95652173913044,46,1,329,1226,WR,1
0,1,0,116,191,-75,-554,-464,-90,79.625,16,0,117,42,RB,1
0,1,0,222,1256,-1034,-509,-145,-364,234.7391304347826,46,0,1026,13,WR,0
0,1,16,90,-128,218,-564,-442,-122,105.03333333333333,30,1,45,296,RB,0
0,1,4,1403,937,466,-194,-213,19,172.03703703703704,27,0,21,469,WR,0
0,1,0,428,-495,923,-220,-179,-41,204.44,50,1,56,975,TE,0
0,1,0,200,116,84,-580,-458,-122,154.71428571428572,7,0,16,117,RB,0
0,1,4,544,-1247,1791,-213,-143,-70,402.55555555555554,45,1,0,1783,WR,0
0,1,20,949,936,13,-224,-229,5,28.0,1,0,2,14,RB,0
0,1,0,1328,782,546,-198,-159,-39,166.02941176470588,34,0,6,552,WR,0
0,1,15,249,-151,400,-499,-375,-124,107.975,40,1,15,473,RB,0
0,1,0,814,-628,1442,-189,-217,28,418.8285714285714,35,1,11,1452,WR,0
0,1,0,681,-620,1301,-200,-137,-63,306.20454545454544,44,1,2,1309,WR,0
0,1,37,264,1123,-859,-308,-136,-172,323.32142857142856,28,0,867,4,WR,0
0,1,0,869,-384,1253,-239,-208,-31,285.42,50,1,92,1334,RB,0
0,1,0,420,412,8,-144,-57,-87,58.65217391304348,23,0,88,98,TE,1
0,1,16,479,1283,-804,-269,-112,-157,300.0,28,0,798,5,WR,0
0,1,0,945,241,704,-251,-632,381,407.65,20,0,6,706,RB,0
0,1,68,1245,-15,1260,-101,-670,569,347.7073170731707,41,1,35,1277,RB,0
0,1,48,1251,11,1240,-46,-665,619,323.25,44,0,43,1269,RB,0
0,1,0,822,329,493,-292,-683,391,358.5,18,0,3,512,RB,0
0,1,0,19,-830,849,-366,-254,-112,602.7333333333333,15,1,0,844,WR,0
0,1,0,248,268,-20,-526,-492,-34,48.4,10,0,15,5,RB,1
0,1,0,1045,653,392,-242,-307,65,329.8333333333333,12,0,8,419,WR,0
0,1,2,12,-170,182,-763,-533,-230,101.43373493975903,83,1,123,315,RB,1
0,1,0,700,-1350,2050,-158,-139,-19,327.6666666666667,63,1,10,2063,WR,0
0,1,0,781,658,123,-317,-326,9,198.0,7,0,12,128,QB,0
0,1,60,278,649,-371,-456,-225,-231,168.29166666666666,24,0,374,4,RB,0
0,1,8,702,-974,1676,-218,-160,-58,374.32608695652175,46,1,11,1684,TE,0
0,1,0,758,-484,1242,-256,-325,69,464.74074074074076,27,1,4,1249,WR,0
0,1,0,541,-196,737,-270,-476,206,204.31914893617022,47,1,80,802,TE,0
0,1,0,563,-566,1129,-216,-153,-63,247.82978723404256,47,1,40,1158,TE,0
0,1,59,843,-1360,2203,-198,-156,-42,396.8363636363636,55,1,10,2200,WR,0
1,1,1,228,284,-56,-513,-549,36,61.1764705882353,17,0,83,29,RB,1
1,1,11,1226,645,581,-211,-132,-79,149.5,48,0,80,655,WR,0
0,1,0,1145,-248,1393,-227,-346,119,510.64285714285717,28,1,7,1411,WR,0
0,1,18,112,204,-92,-410,-571,161,115.65217391304348,23,0,125,23,RB,1
0,1,0,318,349,-31,-500,-435,-65,64.66666666666667,3,0,36,2,RB,0
0,1,57,212,-271,483,-517,-447,-70,157.34375,32,1,21,479,RB,0
1,1,0,1249,896,353,-197,-292,95,316.5,12,0,8,370,WR,0
1,1,0,235,216,19,-508,-572,64,74.675,40,0,49,57,RB,1
0,1,0,1303,-896,2199,-157,-229,72,447.55102040816325,49,1,14,2206,WR,0
0,1,2,131,184,-53,-357,-494,137,78.15094339622641,53,0,152,89,RB,1
0,1,0,17,22,-5,-784,-772,-12,61.81818181818182,11,0,27,22,RB,1
0,1,0,257,269,-12,-463,-508,45,43.57142857142857,7,0,33,33,RB,1
0,1,0,1003,-1108,2111,-188,-155,-33,371.2413793103448,58,1,5,2118,WR,0
0,1,0,238,-194,432,-550,-421,-129,250.72222222222223,18,1,6,432,RB,0
0,1,17,201,277,-76,-480,-418,-62,92.12903225806451,62,0,167,93,RB,1
0,1,0,527,-11,538,-110,-558,448,149.65454545454546,55,1,45,590,TE,0
0,1,10,2020,921,1099,-188,-223,35,251.75555555555556,45,0,10,1101,WR,0
0,1,56,437,-601,1038,-235,-194,-41,287.8421052631579,38,1,33,1061,TE,0
0,1,29,173,-822,995,-552,-164,-388,249.47727272727272,44,1,5,996,WR,0
0,1,0,187,209,-22,-509,-496,-13,47.4375,16,0,79,39,RB,1
0,1,0,459,278,181,-241,-271,30,274.4848484848485,33,0,352,525,TE,1
1,1,7,320,2078,-1758,-548,-214,-334,393.73333333333335,45,0,1749,16,RB,0
1,1,6,271,1554,-1283,-523,-156,-367,310.9347826086956,46,0,1323,2,RB,0
0,1,40,251,240,11,-506,-398,-108,125.28260869565217,46,0,182,187,RB,1
0,1,0,847,-935,1782,-176,-39,-137,309.7719298245614,57,1,1,1768,WR,0
0,1,43,491,-1266,1757,-298,-59,-239,354.02,50,1,13,1746,WR,0
0,1,0,271,-249,520,-479,-445,-34,229.375,24,1,29,544,RB,0
0,1,0,649,-20,669,-187,-270,83,293.5,26,1,43,720,TE,0
0,1,18,180,765,-585,-521,-205,-316,234.0,29,0,594,2,RB,0
0,1,11,510,-175,685,-268,-350,82,253.74074074074073,27,1,6,689,TE,0
0,1,0,725,-746,1471,-236,-249,13,324.2888888888889,45,1,7,1482,WR,0
0,1,16,156,1838,-1682,-485,-128,-357,347.6470588235294,51,0,1705,13,RB,0
0,1,12,1145,-179,1324,-206,-543,337,289.2291666666667,48,1,35,1343,WR,0
0,1,33,553,-540,1093,-233,-187,-46,264.1219512195122,41,1,7,1105,WR,0
0,1,0,505,586,-81,-196,-65,-131,222.0909090909091,44,0,516,446,TE,1
0,1,0,1259,803,456,-265,-175,-90,273.29411764705884,17,0,4,459,WR,0
0,1,0,222,0,222,-510,-621,111,153.6875,16,0,2,226,RB,0
0,1,0,861,766,95,-216,-264,48,379.94,50,0,893,995,WR,1
0,1,0,500,456,44,-255,-255,0,189.08823529411765,34,0,300,346,TE,1
0,1,47,902,-1253,2155,-188,-145,-43,360.52542372881356,59,1,13,2132,WR,0
0,1,18,855,-1127,1982,-225,-138,-87,342.87719298245617,57,1,3,1966,WR,0
0,1,0,474,-671,1145,-155,-90,-65,294.94736842105266,38,1,0,1086,TE,0
0,1,9,521,544,-23,-195,-132,-63,203.93023255813952,43,0,455,418,TE,1
0,1,0,223,-440,663,-558,-160,-398,214.05555555555554,36,1,16,668,TE,0
0,1,0,1029,-403,1432,-206,-77,-129,294.61538461538464,52,1,45,1504,TE,0
0,1,0,1168,527,641,-240,-179,-61,206.83870967741936,31,0,10,651,WR,0
0,1,0,443,258,185,-122,-285,163,181.9,50,0,322,489,TE,1
0,1,14,488,-516,1004,-229,-201,-28,270.8378378378378,37,1,7,1010,TE,0
0,1,15,186,-174,360,-524,-447,-77,121.84848484848484,33,1,7,369,RB,0
0,1,3,597,-1390,1987,-177,-133,-44,415.875,48,1,0,1981,TE,0
0,1,0,727,-1247,1974,-249,-259,10,461.74418604651163,43,1,7,1978,TE,0
0,1,0,807,-1089,1896,-224,-284,60,386.8541666666667,48,1,2,1876,WR,0
0,1,0,1026,-119,1145,-250,-266,16,507.17391304347825,23,1,0,1142,FB,0
0,1,0,448,273,175,-269,-299,30,177.55555555555554,9,0,13,185,FB,0
0,1,0,548,-476,1024,-248,-166,-82,276.9166666666667,36,1,5,1029,TE,0
0,1,0,732,-448,1180,-177,-249,72,346.0882352941176,34,1,2,1172,TE,0
0,1,0,831,410,421,-232,-303,71,369.8333333333333,12,0,12,448,WR,0
0,1,0,933,-233,1166,-304,-361,57,504.9583333333333,24,1,8,1183,FB,0
0,1,2,234,452,-218,-355,-275,-80,157.6,15,0,218,3,FB,0
0,1,0,2009,1177,832,-215,-154,-61,258.3333333333333,33,0,3,829,WR,0
0,1,0,871,634,237,-198,-235,37,241.4,10,0,8,234,WR,0
0,1,7,458,-799,1257,-166,-126,-40,285.1777777777778,45,1,1,1281,TE,0
0,1,11,984,-975,1959,-218,-192,-26,400.81632653061223,49,1,1,1951,WR,0
0,1,0,230,-181,411,-480,-463,-17,318.2307692307692,13,1,11,419,RB,0
0,1,0,839,498,341,-182,-274,92,234.1875,16,0,25,364,RB,0
0,1,0,1272,519,753,-203,-60,-143,232.2,35,0,22,759,TE,0
0,1,0,543,-401,944,-108,-183,75,190.59259259259258,54,1,10,967,TE,0
0,1,35,161,191,-30,-504,-462,-42,58.0,3,0,25,6,RB,1
0,1,0,948,-485,1433,-222,-235,13,494.37931034482756,29,1,9,1437,WR,0
0,1,93,10,736,-726,-275,-209,-66,345.95454545454544,22,0,737,8,TE,0
0,1,30,446,1788,-1342,-323,-191,-132,319.3255813953488,43,0,1357,15,RB,0
0,1,0,964,516,448,-235,-221,-14,379.75,12,0,14,441,WR,0
0,1,58,152,-871,1023,-227,-144,-83,298.57142857142856,35,1,12,1013,WR,0
1,1,0,907,1345,-438,-88,-74,-14,127.02777777777777,36,0,440,13,WR,0
0,1,8,607,-1232,1839,-246,-86,-160,343.01851851851853,54,1,1,1833,WR,0
0,1,3,449,-488,937,-245,-201,-44,259.2162162162162,37,1,6,954,TE,0
0,1,0,1887,1515,372,-240,-189,-51,199.21052631578948,19,0,0,375,WR,0
0,1,17,690,-1449,2139,-239,-184,-55,381.6607142857143,56,1,4,2134,WR,0
0,1,23,1544,260,1284,-317,-508,191,252.94117647058823,51,0,6,1282,RB,0
0,1,50,524,-1464,1988,-258,-112,-146,413.0612244897959,49,1,32,2026,WR,0
0,1,0,1150,-452,1602,-125,-150,25,382.07142857142856,42,1,15,1631,TE,0
0,1,64,2222,2219,3,-148,-101,-47,47.5,2,0,16,5,RB,1
0,1,21,414,230,184,-218,-539,321,148.25,24,0,27,201,RB,0
0,1,19,798,-297,1095,-528,-462,-66,387.03333333333336,30,1,13,1118,RB,0
0,1,37,396,-537,933,-236,-170,-66,270.0,34,1,16,933,TE,0
0,1,0,786,509,277,-247,-244,-3,263.1818181818182,11,0,6,284,WR,0
0,1,0,302,-255,557,-276,-354,78,291.35,20,1,0,557,TE,0
0,1,0,726,564,162,-220,-248,28,187.7,10,0,15,183,WR,0
0,1,48,395,-458,853,-214,-168,-46,276.96774193548384,31,1,6,865,TE,0
0,1,29,1853,457,1396,-242,-185,-57,226.95238095238096,63,0,15,1407,TE,0
0,1,35,519,-607,1126,-236,-179,-57,299.84615384615387,39,1,41,1173,TE,0
0,1,9,456,-450,906,-247,-213,-34,243.54054054054055,37,1,10,921,TE,0
1,1,18,113,-247,360,-556,-423,-133,148.0,26,1,9,359,RB,0
1,1,0,1999,1449,550,-163,-122,-41,208.4814814814815,27,0,2,562,WR,0
0,1,71,1658,1761,-103,-134,-31,-103,115.8,15,0,148,19,RB,0
0,1,31,522,1416,-894,-253,-211,-42,263.34285714285716,35,0,896,8,TE,0
0,1,20,192,236,-44,-634,-514,-120,118.81818181818181,11,0,52,14,RB,1
0,1,7,853,-1304,2157,-246,-83,-163,360.0,60,1,18,2166,WR,0
0,1,60,574,-970,1544,-224,-57,-167,331.6170212765957,47,1,2,1529,WR,0
0,1,0,1484,971,513,-314,-172,-142,210.56,25,0,0,518,WR,0
0,1,0,604,-460,1064,-208,-198,-10,253.04545454545453,44,1,19,1079,TE,0
0,1,0,836,-152,988,-246,-231,-15,363.9375,32,1,81,1066,WR,0
0,1,0,581,-398,979,-196,-218,22,364.7037037037037,27,1,5,984,TE,0
0,1,0,536,215,321,-175,-244,69,279.4166666666667,12,0,4,317,TE,0
0,1,0,601,-356,957,-176,-231,55,354.74074074074076,27,1,2,957,TE,0
0,1,0,992,-351,1343,-171,-262,91,461.06666666666666,30,1,10,1346,WR,0
0,1,0,1026,665,361,-189,-267,78,350.4166666666667,12,0,26,393,WR,0
0,1,47,987,-38,1025,-383,-752,369,377.26666666666665,30,1,16,1061,RB,0
0,1,0,836,-297,1133,-252,-530,278,274.2325581395349,43,1,7,1137,WR,0
0,1,0,486,-1341,1827,-192,-164,-28,355.6470588235294,51,1,0,1821,TE,0
0,1,0,1466,441,1025,-192,-200,8,339.73333333333335,30,0,13,1028,TE,0
0,1,0,1526,873,653,-186,-177,-9,267.5833333333333,24,0,2,645,TE,0
0,1,0,1264,820,444,-205,-219,14,188.57692307692307,26,0,11,441,WR,0
0,1,32,1078,1067,11,-70,-56,-14,35.333333333333336,3,0,18,14,TE,1
0,1,6,623,1121,-498,-326,-248,-78,297.1111111111111,18,0,498,2,RB,0
0,1,0,468,-775,1243,-241,-229,-12,435.62068965517244,29,1,3,1266,TE,0
0,1,0,868,-562,1430,-196,-252,56,334.375,56,1,210,1661,WR,0
0,1,0,502,-713,1215,-269,-272,3,339.4166666666667,36,1,4,1215,TE,0
0,1,36,340,485,-145,-481,-184,-297,108.95652173913044,23,0,156,41,RB,1
0,1,0,470,-618,1088,-191,-150,-41,252.2,55,1,156,1239,TE,0
0,1,6,623,-474,1097,-181,-137,-44,266.8809523809524,42,1,4,1075,TE,0
0,1,0,1233,717,516,-181,-235,54,356.2,15,0,15,535,WR,0
0,1,70,163,265,-102,-558,-463,-95,67.47727272727273,132,0,271,206,FB,1
0,1,0,630,448,182,-218,-330,112,200.0,11,0,20,191,RB,0
0,1,0,235,-234,469,-579,-580,1,211.5909090909091,22,1,0,467,RB,0
0,1,0,442,-442,884,-226,-251,25,239.75675675675674,37,1,13,898,TE,0
0,1,29,252,-208,460,-530,-479,-51,190.04347826086956,23,1,14,448,RB,0
0,1,0,2171,1458,713,-205,-154,-51,216.93939393939394,33,0,0,706,WR,0
0,1,0,687,150,537,-214,-280,66,326.46153846153845,52,0,547,1083,WR,1
0,1,0,1072,-403,1475,-162,-270,108,399.3783783783784,37,1,6,1475,WR,0
0,1,1,479,-434,913,-258,-264,6,246.8421052631579,38,1,22,944,TE,0
0,1,4,1017,-1069,2086,-181,-114,-67,365.29824561403507,57,1,0,2089,WR,0
0,1,0,1033,-1064,2097,-182,-214,32,361.94827586206895,58,1,2,2100,WR,0
0,1,26,214,-220,434,-525,-511,-14,180.82608695652175,23,1,4,424,RB,0
0,1,31,233,-207,440,-513,-479,-34,205.66666666666666,24,1,20,481,RB,0
0,1,26,661,703,-42,-267,-207,-60,96.875,8,0,34,3,RB,0
0,1,0,1060,778,282,-241,-282,41,292.0,10,0,2,288,WR,0
0,1,30,1894,1897,-3,-104,-99,-5,95.5,116,0,405,377,WR,1
1,1,31,441,-543,984,-197,-190,-7,113.3157894736842,95,1,45,997,TE,0
0,1,0,963,-1162,2125,-175,-291,116,452.93617021276594,47,1,2,2121,WR,0
0,1,23,497,492,5,-225,-192,-33,168.83333333333334,42,0,374,380,TE,1
1,1,12,616,-780,1396,-252,-197,-55,269.188679245283,53,1,4,1401,TE,0
0,1,6,260,-588,848,-247,-237,-10,319.0357142857143,28,1,24,857,TE,0
0,1,12,704,771,-67,-276,-268,-8,202.7674418604651,43,0,452,396,WR,1
0,1,23,219,-182,401,-540,-426,-114,170.3846153846154,26,1,4,413,RB,0
1,1,0,218,-198,416,-521,-507,-14,136.83333333333334,30,1,9,433,RB,0
0,1,0,1357,-406,1763,-237,-175,-62,259.81159420289856,69,1,11,1781,TE,0
0,1,0,835,-347,1182,-236,-178,-58,440.0,27,1,4,1186,WR,0
0,1,71,342,-937,1279,-225,-136,-89,332.71794871794873,39,1,12,1281,TE,0
0,1,20,346,1389,-1043,-546,-124,-422,294.53846153846155,39,0,1059,27,WR,0
0,1,6,448,-507,955,-235,-155,-80,282.44117647058823,34,1,3,961,TE,0
0,1,1,449,-432,881,-184,-240,56,201.36363636363637,44,1,16,893,TE,0
0,1,0,1235,918,317,-200,-184,-16,212.6875,16,0,27,348,WR,0
0,1,26,388,1946,-1558,-354,-189,-165,393.1951219512195,41,0,1574,15,RB,0
1,1,72,1982,2006,-24,-175,-64,-111,21.666666666666668,6,0,69,31,WR,1
1,1,88,502,1224,-722,-306,-134,-172,302.08,25,0,726,14,RB,0
0,1,0,1046,239,807,-214,-388,174,281.6,30,0,5,820,WR,0
0,1,10,426,550,-124,-366,-139,-227,134.375,16,0,138,2,RB,0
0,1,10,178,-235,413,-534,-418,-116,133.33333333333334,33,1,17,434,RB,0
0,1,0,160,-132,292,-577,-566,-11,211.6,15,1,14,305,RB,0
0,1,0,288,296,-8,-526,-480,-46,27.333333333333332,3,0,15,9,RB,1
0,1,0,1219,758,461,-216,-136,-80,169.8148148148148,27,0,0,461,WR,0
0,1,0,31,-536,567,-270,-193,-77,200.13793103448276,29,1,2,563,TE,0
0,1,0,276,241,35,-629,-519,-110,47.8,30,0,96,108,RB,1
0,1,1,399,197,202,-242,-399,157,118.59493670886076,79,0,360,586,FB,1
0,1,0,796,-71,867,-265,-261,-4,442.55,20,1,8,885,WR,0
0,1,0,804,-447,1251,-228,-365,137,509.52,25,1,13,1269,WR,0
0,1,0,480,550,-70,-204,-189,-15,64.78571428571429,14,0,82,11,TE,0
0,1,0,902,657,245,-171,-315,144,272.27272727272725,11,0,6,261,WR,0
0,1,0,403,-242,645,-289,-414,125,253.68,25,1,6,640,TE,0
0,1,0,759,-744,1503,-290,-199,-91,423.6857142857143,35,1,0,1486,WR,0
0,1,1,815,-1060,1875,-170,-170,0,311.1333333333333,60,1,21,1878,WR,0
0,1,0,561,545,16,-134,-154,20,24.09090909090909,11,0,57,67,TE,1
0,1,0,751,-367,1118,-262,-305,43,434.0769230769231,26,1,9,1134,FB,0
0,1,0,825,-543,1368,-243,-260,17,296.19565217391306,46,1,0,1362,WR,0
0,1,0,106,249,-143,-538,-392,-146,68.125,24,0,170,33,RB,1
0,1,0,754,-448,1202,-230,-157,-73,374.09375,32,1,2,1206,TE,0
0,1,0,648,-1012,1660,-237,-194,-43,350.7708333333333,48,1,8,1663,WR,0
1,1,43,263,-799,1062,-252,-139,-113,299.0857142857143,35,1,3,1053,WR,0
0,1,0,369,405,-36,-125,-71,-54,62.101694915254235,59,0,287,241,TE,1
0,1,0,23,738,-715,-654,-207,-447,347.9259259259259,27,0,728,3,RB,0
0,1,0,767,-518,1285,-234,-271,37,435.06666666666666,30,1,9,1287,WR,0
0,1,21,1421,-8,1429,-256,-775,519,260.1111111111111,63,1,34,1460,RB,0
0,1,28,204,2273,-2069,-548,-252,-296,361.28333333333336,60,0,2076,2,TE,0
0,1,41,8,-199,207,-764,-511,-253,99.07692307692308,26,1,2,221,RB,0
0,1,1,1016,391,625,-267,-271,4,218.42857142857142,28,0,2,604,TE,0
0,1,2,82,983,-901,-301,-221,-80,253.64864864864865,37,0,907,2,WR,0
0,1,3,1969,1996,-27,-103,-68,-35,42.90909090909091,11,0,63,23,WR,1
1,1,26,372,298,74,-565,-467,-98,41.388888888888886,36,0,79,207,RB,1
0,1,51,437,165,272,-258,-336,78,109.04,25,0,47,264,FB,1
1,1,39,456,1180,-724,-491,32,-523,147.53571428571428,56,0,741,74,WR,0
0,1,0,644,471,173,-320,-296,-24,144.6,15,0,32,221,FB,0
0,1,11,11,-203,214,-637,-559,-78,122.0,20,1,3,217,RB,0
0,1,22,13,-237,250,-743,-551,-192,120.28,25,1,10,258,RB,0
0,1,7,186,-276,462,-604,-493,-111,150.13333333333333,30,1,7,468,RB,0
0,1,4,246,252,-6,-562,-530,-32,180.3695652173913,46,0,413,411,RB,1
0,1,27,1614,234,1380,-208,-563,355,241.125,88,0,155,1542,RB,0
1,1,10,313,293,20,-526,-482,-44,44.94736842105263,19,0,61,89,RB,1
0,1,2,819,-946,1765,-282,-152,-130,353.11764705882354,51,1,33,1799,WR,0
0,1,0,1291,-244,1535,-174,-513,339,219.71052631578948,76,1,26,1565,RB,0
0,1,0,1561,-517,2078,-268,-203,-65,356.6949152542373,59,1,35,2102,TE,0
0,1,2,476,-488,964,-215,-143,-72,203.82608695652175,46,1,5,954,TE,0
0,1,0,520,-701,1221,-216,-333,117,382.90909090909093,33,1,19,1243,FB,0
0,1,0,1021,435,586,-257,-334,77,247.4814814814815,27,0,34,620,FB,0
0,1,0,847,-580,1427,-101,-72,-29,455.3225806451613,31,1,2,1416,WR,0
0,1,15,743,-854,1597,-235,-181,-54,304.7671232876712,73,1,289,1980,WR,0
0,1,0,1237,651,586,-85,-334,249,259.3703703703704,27,0,15,601,WR,0
0,1,0,27,-328,355,-771,-258,-513,329.92,25,1,75,406,RB,1
0,1,0,744,412,332,-306,-256,-50,246.84615384615384,13,0,7,334,FB,0
0,1,0,25,-6,31,-746,-704,-42,41.15384615384615,13,0,24,51,RB,1
0,1,42,200,-1560,1760,-435,-149,-286,369.51020408163265,49,1,11,1762,RB,0
0,1,0,609,463,146,-253,-270,17,157.04761904761904,21,0,111,249,TE,1
0,1,0,123,-289,412,-557,-547,-10,159.85185185185185,27,1,7,414,RB,0
0,1,0,734,-1031,1765,-245,-116,-129,445.7,40,1,5,1796,WR,0
0,1,0,315,324,-9,-357,-347,-10,33.59090909090909,22,0,97,94,TE,1
0,1,0,972,-266,1238,-235,-323,88,479.3076923076923,26,1,3,1243,WR,0
0,1,64,453,-844,1297,-239,-189,-50,272.46938775510205,49,1,12,1328,WR,0
0,1,0,553,522,31,-92,-14,-78,24.625,8,0,15,38,TE,1
0,1,0,1775,848,927,-275,-158,-117,315.53333333333336,30,0,11,961,WR,0
0,1,0,269,251,18,-492,-375,-117,29.571428571428573,7,0,26,34,RB,1
0,1,0,745,-814,1559,-285,-126,-159,432.27777777777777,36,1,4,1550,WR,0
0,1,0,676,-641,1317,-255,-288,33,337.79487179487177,39,1,10,1319,WR,0
0,1,0,140,-732,872,-259,-143,-116,311.34375,32,1,22,902,WR,0
1,1,0,1491,1470,21,-132,-79,-53,52.04545454545455,22,0,105,118,WR,1
1,1,0,390,-550,940,-315,-215,-100,391.44,25,1,0,948,TE,0
0,1,0,1478,1462,16,-73,80,-153,54.05882352941177,17,0,41,93,WR,1
0,1,0,432,-471,903,-244,-268,24,404.5652173913044,23,1,7,910,TE,0
0,1,0,725,-781,1506,-143,-81,-62,332.46666666666664,45,1,10,1502,WR,0
0,1,0,589,-339,928,-199,-163,-36,434.09090909090907,22,1,4,932,TE,0
0,1,0,596,-859,1455,-217,-230,13,560.0384615384615,26,1,10,1458,TE,0
0,1,0,441,-455,896,-253,-29,-224,228.8421052631579,38,1,1,887,TE,0
0,1,35,503,-559,1062,-191,-174,-17,278.63157894736844,38,1,24,1090,TE,0
0,1,4,217,-255,472,-583,-456,-127,203.56521739130434,23,1,4,477,RB,0
0,1,0,192,-224,416,-579,-406,-173,228.52631578947367,19,1,4,430,RB,0
0,1,0,418,819,-401,-298,-67,-231,126.6969696969697,33,0,410,20,WR,0
0,1,16,241,209,32,-488,-457,-31,104.04255319148936,47,0,146,161,RB,1
0,1,0,844,74,770,-279,-257,-22,443.1111111111111,18,0,1,784,WR,0
0,1,0,1478,927,551,-185,-138,-47,250.8181818181818,22,0,17,559,WR,0
0,1,23,542,-1162,1704,-334,-77,-257,300.55,60,1,7,1733,WR,0
0,1,18,69,190,-121,-512,-499,-13,141.77777777777777,45,0,391,267,RB,1
1,1,0,776,653,123,-276,-260,-16,363.2093023255814,43,0,736,848,TE,1
0,1,26,232,213,19,-530,-486,-44,16.0,2,0,2,33,RB,0
0,1,0,225,203,22,-477,-407,-70,192.2,40,0,168,170,RB,1
0,1,0,891,-391,1282,-224,-306,82,505.9230769230769,26,1,9,1284,WR,0
0,1,0,261,-214,475,-563,-443,-120,166.86206896551724,29,1,6,481,RB,0
0,1,41,479,-491,970,-259,-144,-115,278.3529411764706,34,1,9,972,TE,0
0,1,0,950,-95,1045,-194,-264,70,486.6818181818182,22,1,13,1039,WR,0
0,1,7,638,-672,1310,-187,-190,3,330.2,40,1,4,1332,TE,0
0,1,9,26,247,-221,-542,-373,-169,188.30769230769232,13,0,217,4,RB,0
0,1,45,1180,244,936,-367,-421,54,264.1111111111111,36,0,12,940,RB,0
0,1,74,644,656,-12,-40,-76,36,49.166666666666664,6,0,7,9,WR,1
0,1,0,443,-419,862,-122,-191,69,229.8780487804878,41,1,28,885,TE,0
0,1,0,683,-463,1146,-132,-146,14,280.0,41,1,16,1175,TE,0
0,1,6,856,-613,1469,-181,-206,25,370.05,40,1,3,1471,WR,0
0,1,42,254,-718,972,-509,-139,-370,278.0769230769231,39,1,7,985,RB,0
0,1,0,714,-429,1143,-192,-229,37,249.67391304347825,46,1,22,1171,FB,0
0,1,55,113,-1838,1951,-319,-75,-244,389.7647058823529,51,1,8,1964,TE,0
1,1,83,445,678,-233,-90,33,-123,88.14285714285714,21,0,231,2,TE,0
1,1,52,589,1930,-1341,-187,-93,-94,246.98181818181817,55,0,1339,2,TE,0
1,1,64,6,-1412,1418,-769,-64,-705,353.3863636363636,44,1,21,1442,RB,0
1,1,50,8,1315,-1307,-498,-2,-496,253.92857142857142,56,0,1344,36,TE,0
0,1,22,776,-848,1624,-158,-120,-38,360.8222222222222,45,1,9,1632,WR,0
0,1,31,517,-542,1059,-322,-179,-143,261.7857142857143,42,1,15,1064,WR,0
0,1,33,189,220,-31,-505,-356,-149,65.0,5,0,37,11,RB,1
0,1,0,844,-430,1274,-184,-130,-54,492.8076923076923,26,1,0,1270,WR,0
0,1,11,449,1076,-627,-309,-238,-71,315.3333333333333,21,0,629,2,WR,0
0,1,0,829,-197,1026,-151,-396,245,367.6666666666667,30,1,23,1036,WR,0
0,1,7,776,-656,1432,-244,-222,-22,362.65,40,1,3,1431,WR,0
1,1,59,961,2183,-1222,-231,-222,-9,377.1212121212121,33,0,1233,4,TE,0
1,1,59,1613,693,920,-197,-79,-118,291.8484848484849,33,0,8,918,TE,0
0,1,27,1851,569,1282,-197,-120,-77,313.9047619047619,42,0,6,1302,TE,0
0,1,66,790,18,772,-175,-771,596,165.4262295081967,61,0,26,786,RB,0
0,1,0,870,624,246,-145,-149,4,225.0909090909091,11,0,6,264,WR,0
0,1,48,1057,-5,1062,-170,-722,552,192.49253731343285,67,1,34,1078,RB,0
0,1,17,301,305,-4,-537,-538,1,39.0,2,0,7,7,RB,1
0,1,4,1763,717,1046,-170,-176,6,221.12765957446808,47,0,0,1042,WR,0
0,1,7,227,252,-25,-508,-374,-134,84.66666666666667,6,0,40,1,RB,0
0,1,33,837,26,811,-129,-746,617,162.20833333333334,72,0,46,850,RB,0
0,1,34,1241,25,1216,-203,-745,542,256.2909090909091,55,0,61,1269,RB,0
0,1,0,635,-325,960,-196,-624,428,485.9166666666667,24,1,62,995,TE,0
0,1,48,1982,1975,7,-124,8,-132,55.97872340425532,47,0,125,164,WR,1
0,1,29,824,-1182,2006,-250,-72,-178,390.6666666666667,51,1,11,2005,WR,0
0,1,8,217,-239,456,-547,-457,-90,193.54166666666666,24,1,13,459,RB,0
0,1,35,748,-1143,1891,-267,-120,-147,539.5555555555555,36,1,10,1907,WR,0
0,1,0,1886,1362,524,-46,111,-157,114.24615384615385,65,0,127,636,WR,1
1,1,2,1030,465,565,-171,-21,-150,118.03508771929825,57,0,80,622,TE,0
1,1,48,261,-226,487,-516,-373,-143,115.14634146341463,41,1,10,516,RB,0
0,1,34,1888,1902,-14,-107,3,-110,134.3859649122807,114,0,807,775,WR,1
0,1,0,776,-314,1090,-213,-600,387,312.16279069767444,43,1,9,1128,WR,0
0,1,43,886,-1123,2009,-234,-182,-52,393.8627450980392,51,1,6,2002,WR,0
0,1,0,900,-617,1517,-225,-207,-18,570.1111111111111,27,1,12,1513,WR,0
0,1,24,233,-290,523,-468,-456,-12,157.625,32,1,8,511,RB,0
0,1,0,533,-478,1011,-221,-174,-47,378.9259259259259,27,1,1,1011,TE,0
0,1,0,232,-415,647,-566,-244,-322,171.15686274509804,51,1,11,653,FB,0
0,1,0,930,-275,1205,-199,-395,196,378.1470588235294,34,1,14,1206,WR,0
0,1,0,980,576,404,-225,-243,18,291.53333333333336,15,0,13,430,WR,0
0,1,26,256,-446,702,-432,-179,-253,195.54054054054055,37,1,7,705,TE,0
0,1,0,607,-943,1550,-314,-208,-106,356.8,45,1,6,1543,WR,0
0,1,2,250,-220,470,-543,-499,-44,193.92,25,1,4,472,RB,0
0,1,0,801,-595,1396,-201,-323,122,405.74285714285713,35,1,14,1408,WR,0
0,1,16,6,26,-20,-727,-667,-60,99.32786885245902,61,0,83,50,RB,1
0,1,0,612,665,-53,-60,166,-226,133.8,5,0,1,5,WR,1
0,1,0,734,757,-23,-213,-45,-168,75.75,4,0,0,36,WR,0
0,1,0,438,447,-9,-243,-65,-178,81.0,6,0,0,50,TE,0
0,1,0,15,35,-20,-690,-509,-181,112.0,4,0,0,38,RB,0
0,1,0,1446,640,806,-238,-178,-60,250.5625,32,0,4,820,WR,0
0,1,0,6,-290,296,-293,-156,-137,210.0,17,1,4,272,RB,0
1,1,56,402,-400,802,-174,-153,-21,231.11111111111111,36,1,17,820,TE,0
1,1,16,462,-582,1044,-220,-51,-169,284.7073170731707,41,1,26,1072,TE,0
0,1,0,366,-1115,1481,-229,-123,-106,263.04651162790697,86,1,354,1833,WR,1
0,1,0,329,-405,734,-227,-254,27,198.6046511627907,43,1,50,783,TE,0
0,1,14,1214,614,600,-183,-150,-33,184.42424242424244,33,0,2,605,WR,0
0,1,0,1484,194,1290,-196,-284,88,305.8863636363636,44,0,4,1297,TE,0
0,1,0,996,100,896,-241,-408,167,360.5833333333333,24,0,15,905,WR,0
1,1,30,1128,830,298,-162,-79,-83,93.9,40,0,3,308,TE,0
0,1,0,1305,780,525,-116,-390,274,419.35714285714283,14,0,7,519,WR,0
0,1,0,1237,660,577,-232,-250,18,289.42857142857144,21,0,3,573,WR,0
0,1,13,13,-482,495,-262,-178,-84,210.92307692307693,26,1,16,519,TE,0
0,1,7,1126,731,395,-128,-133,5,142.0344827586207,29,0,25,428,WR,0
0,1,0,1080,733,347,-183,-191,8,276.85714285714283,14,0,20,368,TE,0
0,1,0,300,457,-157,-289,-225,-64,145.73333333333332,15,0,187,33,TE,1
1,1,0,803,413,390,-205,-249,44,299.625,40,0,398,778,WR,1
0,1,13,312,299,13,-538,-528,-10,37.0,2,0,2,15,WR,0
0,1,8,290,-1903,2193,-279,-185,-94,444.8,50,1,1,2192,TE,0
0,1,0,776,-335,1111,-241,-367,126,464.7916666666667,24,1,10,1100,TE,0
0,1,0,1384,813,571,-242,-191,-51,183.4375,32,0,6,574,WR,0
0,1,0,1307,198,1109,-186,-234,48,457.60869565217394,46,0,493,1587,WR,1
0,1,8,1236,729,507,-175,-194,19,171.10344827586206,29,0,3,504,WR,0
0,1,0,699,-386,1085,-290,-366,76,428.7692307692308,26,1,12,1082,TE,0
0,1,0,216,-221,437,-600,-570,-30,220.9,20,1,1,438,RB,0
1,1,30,231,-6,237,-463,-726,263,104.25714285714285,35,1,12,265,RB,0
1,1,23,1527,489,1038,-151,-228,77,225.72916666666666,48,0,31,1083,TE,0
1,1,36,1932,480,1452,-154,-140,-14,357.3170731707317,41,0,35,1475,TE,0
0,1,0,1026,-923,1949,-174,-116,-58,338.63793103448273,58,1,7,1956,WR,0
0,1,36,497,-859,1356,-229,-146,-83,384.5,36,1,2,1366,WR,0
0,1,10,5,544,-539,-531,-175,-356,185.73529411764707,34,0,538,3,TE,0
0,1,0,898,-385,1283,-212,-304,92,469.2857142857143,28,1,5,1288,FB,0
0,1,0,996,-1059,2055,-132,-154,22,345.08196721311475,61,1,9,2051,WR,0
0,1,47,64,-15,79,-603,-736,133,134.0,13,0,19,95,RB,1
0,1,11,1259,789,470,-210,-163,-47,163.06896551724137,29,0,6,477,WR,0
0,1,0,844,274,570,-254,-299,45,359.125,16,0,14,552,WR,0
0,1,4,129,841,-712,-249,-159,-90,235.7741935483871,31,0,706,0,WR,0
1,1,31,1885,514,1371,-216,-93,-123,269.2156862745098,51,0,2,1368,TE,0
1,1,15,1488,224,1264,-126,-387,261,241.98275862068965,58,0,33,1305,RB,0
1,1,35,897,1195,-298,-104,35,-139,117.33333333333333,24,0,298,10,WR,0
0,1,0,1454,929,525,-252,-228,-24,173.29032258064515,31,0,0,527,WR,0
0,1,0,963,482,481,-193,-267,74,408.94736842105266,38,0,522,1019,WR,1
0,1,0,760,393,367,-193,-268,75,361.05263157894734,38,0,489,860,WR,1
0,1,0,202,1118,-916,-576,-729,153,385.1372549019608,51,0,1404,492,RB,1
0,1,0,892,-50,942,-229,-269,40,456.7142857142857,21,1,10,945,WR,0
0,1,32,147,-568,715,-240,-118,-122,255.51724137931035,29,1,2,714,TE,0
0,1,9,802,910,-108,-101,-33,-68,89.53703703703704,54,0,276,176,TE,1
0,1,0,195,256,-61,-493,-412,-81,60.592592592592595,27,0,137,75,RB,1
0,1,0,844,405,439,-240,-328,88,266.7435897435897,39,0,287,723,WR,1
1,1,51,49,12,37,-784,-804,20,36.0,2,0,6,26,RB,1
0,1,0,1174,536,638,-255,-103,-152,224.2,30,0,10,648,TE,0
0,1,0,702,485,217,-250,-321,71,323.46875,32,0,397,618,WR,1
0,1,17,334,-225,559,-382,-595,213,309.0,21,1,4,573,RB,0
0,1,0,523,-439,962,-188,-66,-122,253.0,41,1,9,972,TE,0
0,1,0,286,-1336,1622,-623,-683,60,609.6296296296297,27,1,0,1618,RB,0
0,1,7,1099,1081,18,-228,-73,-155,309.04819277108436,83,0,1275,1297,WR,1
0,1,2,257,-1976,2233,-527,-203,-324,407.7818181818182,55,1,5,2242,RB,0
0,1,0,980,421,559,-208,-258,50,353.75,16,0,10,570,WR,0
0,1,43,61,-506,567,-281,-175,-106,232.42307692307693,26,1,10,565,TE,0
0,1,0,248,-147,395,-477,-473,-4,109.16666666666667,36,1,9,403,RB,0
0,1,0,784,575,209,-160,-296,136,357.79411764705884,34,0,492,699,WR,1
0,1,13,767,-909,1676,-239,-146,-93,283.12820512820514,78,1,258,1942,WR,0
0,1,0,222,-173,395,-462,-452,-10,206.94736842105263,19,1,1,396,FB,0
0,1,6,106,-477,583,-261,-186,-75,269.0,23,1,2,587,TE,0
0,1,23,1201,1202,-1,-311,-266,-45,95.825,40,0,219,203,RB,1
0,1,54,465,-1421,1886,-218,-157,-61,444.6744186046512,43,1,6,1896,WR,0
0,1,0,221,-251,472,-508,-465,-43,188.5,26,1,16,482,RB,0
0,1,0,1061,-396,1457,-245,-328,83,520.2857142857143,28,1,7,1463,WR,0
0,1,0,10,-412,422,-268,72,-340,194.86666666666667,30,1,17,459,TE,0
0,1,26,425,-382,807,-235,-208,-27,248.15151515151516,33,1,24,827,TE,0
0,1,0,723,-416,1139,-221,-183,-38,230.9056603773585,53,1,49,1187,TE,0
0,1,0,609,341,268,-249,-259,10,232.66666666666666,12,0,14,282,TE,0
0,1,0,220,-332,552,-571,-466,-105,187.44827586206895,29,1,9,567,RB,0
0,1,0,687,-756,1443,-265,-125,-140,401.9166666666667,36,1,4,1439,WR,0
0,1,12,1148,-256,1404,-206,-459,253,287.8979591836735,49,1,6,1415,WR,0
1,1,30,180,0,180,-535,-791,256,117.82352941176471,34,0,27,191,RB,0
0,1,0,924,-833,1757,-207,-146,-61,336.7169811320755,53,1,12,1764,WR,0
1,1,10,219,504,-285,-465,-210,-255,118.1875,32,0,313,26,RB,0
1,1,44,1454,809,645,-228,-110,-118,232.76666666666668,30,0,2,649,TE,0
0,1,26,626,1466,-840,-333,-254,-79,363.0416666666667,24,0,839,5,WR,0
0,1,23,811,1590,-779,-336,-215,-121,302.962962962963,27,0,778,3,RB,0
0,1,29,1308,1634,-326,-63,-89,26,114.53125,32,0,338,23,WR,0
0,1,19,1289,230,1059,-293,-456,163,302.97222222222223,36,0,7,1064,RB,0
0,1,46,185,-199,384,-537,-513,-24,168.7826086956522,23,1,6,405,RB,0
0,1,0,1121,-529,1650,-208,-330,122,509.030303030303,33,1,5,1648,WR,0
0,1,0,733,1147,-414,-198,-148,-50,127.82191780821918,73,0,685,270,WR,1
1,1,55,250,-224,474,-487,-446,-41,145.59375,32,1,15,509,RB,0
0,1,1,552,-514,1066,-174,-138,-36,301.5,36,1,9,1080,TE,0
0,1,0,580,-500,1080,-193,-124,-69,336.71875,32,1,0,1076,TE,0
0,1,0,1027,230,797,-334,-438,104,307.44444444444446,27,0,11,811,RB,0
0,1,1,1616,245,1371,-229,-394,165,306.3541666666667,48,0,50,1436,RB,0
0,1,0,809,-877,1686,-201,-248,47,392.7906976744186,43,1,5,1697,WR,0
0,1,34,434,1142,-708,-287,-160,-127,169.2093023255814,43,0,709,3,WR,0
0,1,0,1127,-1026,2153,-208,-116,-92,387.74545454545455,55,1,12,2132,WR,0
0,1,27,775,-640,1415,-239,-183,-56,310.5652173913044,46,1,2,1423,QB,0
0,1,0,1397,-722,2119,-194,-244,50,459.3695652173913,46,1,8,2127,WR,0
0,1,0,990,508,482,-209,-257,48,227.3181818181818,22,0,16,506,WR,0
0,1,0,472,437,35,-82,-14,-68,55.125,8,0,13,23,TE,1
0,1,59,438,909,-471,-445,-204,-241,167.4375,32,0,475,8,RB,0
0,1,0,1416,1449,-33,-46,145,-191,132.25,4,0,8,7,WR,1
0,1,0,922,923,-1,-69,80,-149,82.66666666666667,3,0,29,2,TE,0
0,1,62,275,2260,-1985,-457,-141,-316,362.45454545454544,55,0,1994,3,RB,0
0,1,0,1236,-887,2123,-282,-250,-32,432.734693877551,49,1,3,2128,WR,0
0,1,0,905,517,388,-190,-301,111,304.92857142857144,14,0,19,409,WR,0
0,1,22,371,2162,-1791,-374,-160,-214,374.55102040816325,49,0,1788,3,RB,0
0,1,0,1877,1427,450,-176,-207,31,218.25,20,0,0,449,WR,0
0,1,56,102,360,-258,-524,-466,-58,125.0,22,0,263,10,RB,0
0,1,62,115,-1000,1115,-315,-139,-176,325.8611111111111,36,1,14,1137,WR,0
0,1,0,980,-574,1554,-188,-248,60,436.125,40,1,102,1653,WR,0
0,1,54,69,1211,-1142,-287,-185,-102,330.44444444444446,36,0,1152,12,WR,0
0,1,0,964,-915,1879,-204,-207,3,358.03846153846155,52,1,2,1877,WR,0
0,1,0,824,-859,1683,-214,-268,54,371.15555555555557,45,1,9,1671,WR,0
0,1,0,730,749,-19,-59,323,-382,140.25,4,0,2,5,WR,1
0,1,0,1040,-515,1555,-258,-248,-10,360.93023255813955,43,1,5,1544,QB,0
0,1,20,244,595,-351,-501,-70,-431,177.9,30,0,340,18,TE,0
0,1,0,619,-386,1005,-207,-216,9,278.02777777777777,36,1,10,998,TE,0
0,1,0,1739,1044,695,-269,-225,-44,215.71875,32,0,1,697,WR,0
0,1,0,9,4,5,-681,-605,-76,134.33333333333334,3,0,4,28,RB,0
0,1,0,1377,-911,2288,-143,-143,0,379.75409836065575,61,1,5,2295,WR,0
0,1,23,86,280,-194,-174,-446,272,108.1470588235294,34,0,206,14,RB,0
0,1,3,864,-451,1315,-222,-229,7,314.0952380952381,42,1,4,1328,TE,0
0,1,121,1403,495,908,-219,-192,-27,210.71428571428572,42,0,19,913,TE,0
0,1,0,1884,1443,441,-250,-210,-40,171.76,25,0,0,441,WR,0
0,1,42,416,-1175,1591,-209,-186,-23,335.6041666666667,48,1,6,1598,WR,0
0,1,0,1174,-621,1795,-142,-232,90,386.40425531914894,47,1,0,1799,WR,0
0,1,0,501,-556,1057,-121,-160,39,187.984126984127,63,1,47,1108,TE,0
0,1,0,789,-1410,2199,-322,-305,-17,480.2608695652174,46,1,20,2213,WR,0
0,1,64,792,1232,-440,-310,-170,-140,153.46666666666667,30,0,454,22,WR,0
0,1,0,1082,-1368,2450,-136,-122,-14,444.09090909090907,55,1,3,2454,WR,0
0,1,0,533,-702,1235,-264,-244,-20,343.6216216216216,37,1,2,1246,WR,0
0,1,0,479,228,251,-207,-310,103,129.65217391304347,23,0,31,263,TE,0
0,1,0,236,563,-327,-218,-183,-35,207.3684210526316,19,0,360,27,TE,0
0,1,0,604,161,443,-212,-775,563,419.468085106383,47,0,649,1087,WR,1
0,1,0,1847,1523,324,-137,-185,48,193.47058823529412,17,0,6,317,WR,0
0,1,5,750,-515,1265,-209,-157,-52,336.86842105263156,38,1,0,1262,WR,0
0,1,0,50,-229,279,-561,-423,-138,217.42307692307693,26,1,129,427,RB,1
0,1,0,915,700,215,-212,-252,40,183.0,11,0,13,218,WR,0
0,1,2,856,-2139,2995,-316,-196,-120,441.47058823529414,68,1,6,3000,WR,0
0,1,0,1373,2072,-699,-172,-132,-40,241.06896551724137,29,0,713,2,WR,0
0,1,0,499,201,298,296,-71,367,161.85185185185185,27,0,13,297,TE,0
0,1,0,904,662,242,-265,-321,56,255.55555555555554,9,0,4,247,WR,0
0,1,7,1053,-1078,2131,-170,-189,19,354.4754098360656,61,1,0,2149,WR,0
0,1,3,1467,1076,391,-105,-161,56,131.13793103448276,29,0,3,408,WR,0
0,1,47,333,496,-163,-253,-86,-167,103.57692307692308,26,0,181,6,TE,0
0,1,89,1222,1432,-210,-86,-79,-7,79.375,104,0,525,296,WR,1
0,1,0,1975,1554,421,-295,-249,-46,93.95945945945945,74,0,138,582,WR,1
0,1,94,1108,1169,-61,-256,-107,-149,49.26923076923077,104,0,253,194,WR,1
0,1,0,2380,629,1751,-278,-340,62,421.04761904761904,42,0,21,1764,RB,0
0,1,0,2134,1511,623,-177,-195,18,275.54545454545456,22,0,2,628,WR,0
0,1,39,465,-458,923,-224,-197,-27,264.2,35,1,11,925,TE,0
0,1,0,1055,732,323,-175,-236,61,305.90909090909093,11,0,4,330,WR,0
0,1,0,218,-17,235,-77,-442,365,194.16666666666666,12,1,2,244,RB,0
0,1,8,1166,613,553,-241,-175,-66,191.6551724137931,29,0,2,575,WR,0
0,1,0,240,-409,649,-537,-200,-337,232.62857142857143,35,1,9,674,WR,0
0,1,5,223,-1758,1981,-499,-164,-335,394.80392156862746,51,1,5,1981,RB,0
0,1,3,553,680,-127,-168,-141,-27,247.375,48,0,640,522,TE,1
0,1,0,2048,1419,629,-111,-211,100,235.1851851851852,27,0,6,624,WR,0
0,1,0,2001,1465,536,-144,-109,-35,198.48275862068965,29,0,0,557,WR,0
0,1,0,1206,547,659,-150,-100,-50,178.3170731707317,41,0,15,703,TE,0
0,1,0,516,-723,1239,-195,-120,-75,291.09090909090907,44,1,10,1260,TE,0
0,1,71,71,893,-822,-254,-159,-95,320.3703703703704,27,0,842,7,WR,0
0,1,0,1997,1668,329,-165,-199,34,144.2173913043478,23,0,20,341,WR,0
0,1,0,1255,-788,2043,-202,-199,-3,347.6,60,1,10,2044,WR,0
0,1,11,577,-1103,1680,-230,-161,-69,331.48,50,1,16,1679,TE,0
0,1,31,403,-547,950,-271,-46,-225,229.85,40,1,17,938,TE,0
0,1,0,892,498,394,-285,-204,-81,161.45833333333334,24,0,15,398,TE,0
0,1,5,248,-754,1002,-550,-179,-371,305.6,35,1,6,995,RB,0
0,1,0,1128,-220,1348,-166,-311,145,431.60377358490564,53,1,465,1822,WR,1
0,1,0,34,1108,-1074,-316,-184,-132,344.09375,32,0,1067,2,TE,0
0,1,0,433,-449,882,-284,-282,-2,272.59375,32,1,5,876,TE,0
0,1,14,482,-388,870,-265,-264,-1,267.75,32,1,16,866,TE,0
0,1,6,567,214,353,-196,-417,221,183.5483870967742,31,0,103,444,TE,1
0,1,32,14,-203,217,-764,-540,-224,164.73684210526315,19,1,6,235,RB,0
0,1,1,432,674,-242,-114,-60,-54,125.3157894736842,19,0,239,16,TE,0
0,1,0,1280,1298,-18,-188,-79,-109,82.82352941176471,34,0,134,120,WR,1
1,1,22,194,-214,408,-553,-547,-6,142.07142857142858,28,1,5,423,RB,0
0,1,0,265,247,18,-526,-381,-145,36.75,4,0,2,23,RB,0
0,1,0,138,-446,584,-305,-262,-43,245.0,25,1,8,609,TE,0
0,1,0,13,-74,87,-497,-280,-217,211.325,40,0,349,438,FB,1
0,1,12,255,-205,460,-551,-499,-52,103.40677966101696,59,1,6,472,RB,0
0,1,9,431,-867,1298,-265,-223,-42,270.06382978723406,47,1,3,1298,TE,0
0,1,0,492,728,-236,-246,-135,-111,174.21428571428572,56,0,607,370,TE,1
0,1,52,426,-492,918,-255,-247,-8,240.26315789473685,38,1,14,946,TE,0
0,1,10,7,-177,184,-773,-571,-202,149.11111111111111,18,1,13,209,RB,0
0,1,0,31,213,-182,-818,-579,-239,138.42857142857142,21,0,181,6,RB,0
0,1,52,881,1002,-121,-153,-118,-35,60.95238095238095,21,0,123,4,WR,0
0,1,1,434,-810,1244,-249,-184,-65,287.6511627906977,43,1,4,1258,TE,0
0,1,12,538,-405,943,-253,-45,-208,235.3095238095238,42,1,13,953,TE,0
0,1,0,774,-829,1603,-153,60,-213,360.55555555555554,45,1,8,1596,WR,0
0,1,6,2,-225,227,-739,-487,-252,165.35294117647058,17,1,4,225,RB,0
0,1,18,155,223,-68,-603,-546,-57,125.75,8,0,78,5,RB,0
0,1,13,4,207,-203,-746,-547,-199,173.61111111111111,18,0,224,16,RB,0
0,1,5,1,224,-223,-689,-529,-160,160.94117647058823,17,0,231,2,RB,0
0,1,17,12,210,-198,-674,-518,-156,134.41666666666666,24,0,260,41,RB,0
0,1,0,1001,457,544,-195,-231,36,378.53333333333336,15,0,19,569,WR,0
0,1,11,549,-552,1101,-222,-206,-16,290.97435897435895,39,1,8,1112,TE,0
0,1,0,188,16,172,-466,-560,94,182.06666666666666,15,0,38,205,WR,1
0,1,8,816,-918,1734,-175,-186,11,342.1764705882353,51,1,4,1737,WR,0
0,1,0,1133,874,259,-222,-214,-8,112.8695652173913,23,0,2,267,WR,0
0,1,19,576,-457,1033,-196,-212,16,276.5135135135135,37,1,9,1025,TE,0
0,1,70,297,1916,-1619,-513,-168,-345,363.8723404255319,47,0,1602,18,RB,0
0,1,11,828,205,623,-233,-524,291,241.17857142857142,28,0,11,622,WR,0
0,1,5,780,-1104,1884,-201,-189,-12,374.2307692307692,52,1,0,1881,WR,0
0,1,0,1488,753,735,-267,-188,-79,243.3548387096774,31,0,0,735,TE,0
0,1,29,456,173,283,-238,-327,89,163.1578947368421,19,0,18,297,TE,0
0,1,0,590,-545,1135,-197,-225,28,329.2,35,1,10,1155,TE,0
1,1,23,893,1266,-373,-275,-190,-85,179.43333333333334,30,0,387,12,WR,0
0,1,0,1071,685,386,-191,-272,81,339.5,12,0,5,384,WR,0
0,1,0,208,721,-513,-289,-125,-164,203.30769230769232,26,0,501,0,TE,0
0,1,15,554,-476,1030,-204,-227,23,274.8918918918919,37,1,2,1029,TE,0
0,1,0,974,216,758,-231,-467,236,362.8181818181818,22,0,4,762,RB,0
0,1,0,1263,123,1140,-172,-737,565,357.28333333333336,60,0,402,1536,RB,1
0,1,0,687,216,471,-259,-361,102,348.06666666666666,15,0,17,498,WR,0
0,1,34,1047,-431,1478,-242,-189,-53,287.921568627451,51,1,10,1474,TE,0
0,1,33,147,-204,351,-557,-479,-78,188.23809523809524,21,1,20,378,RB,0
0,1,0,194,407,-213,-548,-241,-307,152.53333333333333,30,0,276,48,TE,0
0,1,11,592,-1402,1994,-257,-233,-24,358.94642857142856,56,1,0,1996,WR,0
0,1,0,433,455,-22,-198,-111,-87,49.2,10,0,13,52,WR,1
0,1,0,679,-444,1123,-247,-227,-20,199.10526315789474,57,1,17,1143,WR,0
0,1,5,212,-639,851,-270,-124,-146,202.82608695652175,46,1,24,906,TE,0
0,1,0,1001,333,668,-229,-294,65,430.05882352941177,17,0,5,719,WR,0
0,1,0,645,1243,-598,-213,-790,577,499.8095238095238,63,0,1749,1154,WR,1
0,1,0,944,313,631,-293,-394,101,440.46666666666664,15,0,8,629,WR,0
0,1,0,179,378,-199,-521,-225,-296,157.38709677419354,31,0,290,85,TE,1
0,1,0,932,380,552,-232,-371,139,352.4117647058824,17,0,24,562,WR,0
0,1,0,272,-456,728,-302,-332,30,327.94117647058823,51,1,455,1188,WR,1
0,1,11,568,-875,1443,-233,-175,-58,382.36842105263156,38,1,2,1446,WR,0
0,1,34,260,1181,-921,-251,-119,-132,399.9583333333333,24,0,904,10,WR,0
0,1,39,79,-1243,1322,-519,-266,-253,370.0263157894737,38,1,2,1363,RB,0
0,1,0,221,562,-341,-308,-349,41,326.9259259259259,54,0,1027,693,WR,1
0,1,19,500,1031,-531,-448,-229,-219,215.7719298245614,57,0,843,305,WR,1
0,1,0,973,532,441,-161,-296,135,333.64285714285717,14,0,6,445,WR,0
0,1,58,597,-602,1199,-210,-188,-22,288.14285714285717,42,1,18,1203,TE,0
0,1,0,1574,1199,375,-148,-125,-23,250.66666666666666,15,0,11,377,WR,0
0,1,0,1471,587,884,-204,-333,129,378.6666666666667,24,0,6,890,WR,0
0,1,35,706,-395,1101,-163,-223,60,286.61538461538464,39,1,6,1118,WR,0
0,1,15,1450,739,711,-255,-180,-75,190.54054054054055,37,0,6,708,TE,0
0,1,0,212,115,97,-361,-258,-103,334.06,50,0,754,845,WR,1
0,1,0,411,228,183,-202,-231,29,256.5,8,0,11,202,TE,0
0,1,107,147,-226,373,-597,-574,-23,109.93333333333334,75,1,63,420,RB,0
1,1,10,651,-652,1303,-205,-158,-47,304.27906976744185,43,1,7,1300,WR,0
1,1,31,193,178,15,-559,-534,-25,132.0566037735849,53,0,96,95,RB,1
1,1,54,466,-1136,1602,-193,-157,-36,265.51612903225805,62,1,52,1662,TE,0
0,1,42,1101,-567,1668,-262,-183,-79,360.21276595744683,47,1,2,1693,TE,0
0,1,75,406,483,-77,-370,-291,-79,53.4,20,0,56,11,TE,1
0,1,36,634,-612,1246,-221,-101,-120,276.06666666666666,45,1,8,1240,TE,0
0,1,0,791,-460,1251,-212,-303,91,374.05882352941177,34,1,2,1262,WR,0
0,1,16,133,128,5,-244,-223,-21,18.5,2,0,26,17,RB,1
0,1,0,1992,906,1086,-184,-238,54,425.7692307692308,26,0,4,1109,TE,0
0,1,0,569,-558,1127,-206,-263,57,337.1212121212121,33,1,9,1112,TE,0
1,1,18,779,189,590,-209,-465,256,174.75,36,0,8,586,WR,0
0,1,0,231,241,-10,-328,-298,-30,32.4,5,0,20,12,TE,1
1,1,28,1430,676,754,-260,-171,-89,260.73333333333335,30,0,10,771,RB,0
1,1,0,2113,2150,-37,-190,-193,3,51.964285714285715,28,0,92,32,TE,1
1,1,0,871,-414,1285,-187,-241,54,435.06666666666666,30,1,14,1324,WR,0
0,1,17,228,-265,493,-502,-461,-41,152.68571428571428,35,1,5,515,RB,0
0,1,6,276,-302,578,-565,-562,-3,232.16,25,1,39,590,RB,0
0,1,0,1278,273,1005,-266,-460,194,273.8421052631579,38,0,30,1013,RB,0
0,1,0,1033,654,379,-209,-233,24,368.09090909090907,11,0,4,390,RB,0
0,1,67,837,856,-19,349,182,167,71.33333333333333,3,0,42,11,RB,1
0,1,29,209,238,-29,-533,-528,-5,53.4,5,0,27,4,RB,0
0,1,22,583,-604,1187,-197,-182,-15,252.34782608695653,46,1,14,1186,TE,0
0,1,0,1507,1172,335,-175,-146,-29,132.54166666666666,24,0,0,333,WR,0
0,1,0,524,474,50,-56,-97,41,60.473684210526315,19,0,12,59,TE,1
0,1,0,250,403,-153,-557,-534,-23,213.5,8,0,181,2,RB,0
0,1,33,527,-603,1130,-268,-137,-131,252.59183673469389,49,1,8,1144,TE,0
0,1,0,929,-966,1895,-172,-297,125,542.0,35,1,7,1892,WR,0
0,1,24,768,-783,1551,-215,-110,-105,338.6170212765957,47,1,12,1557,WR,0
0,1,35,138,263,-125,-412,-441,29,70.33333333333333,24,0,134,11,RB,0
0,1,0,870,576,294,-185,-262,77,140.59259259259258,27,0,26,306,RB,0
0,1,0,2073,1864,209,-250,-257,7,193.16666666666666,12,0,31,234,WR,0
0,1,18,741,326,415,-161,-412,251,173.96666666666667,30,0,16,444,RB,0
0,1,0,2046,1524,522,-204,-98,-106,114.03125,64,0,121,658,WR,1
0,1,99,1215,1210,5,-87,41,-128,65.4375,48,0,192,185,TE,1
0,1,7,276,-259,535,-463,-424,-39,188.96428571428572,28,1,13,522,RB,0
0,1,0,274,-523,797,-478,-147,-331,233.63888888888889,36,1,19,809,RB,0
0,1,0,663,680,-17,-36,237,-273,61.666666666666664,3,0,3,0,WR,0
0,1,30,2,19,-17,-730,-690,-40,57.97727272727273,44,0,47,17,RB,1
0,1,20,651,-1150,1801,-204,-53,-151,341.05555555555554,54,1,6,1822,WR,0
0,1,13,1810,-236,2046,-349,-441,92,327.2769230769231,65,1,6,2035,RB,0
0,1,70,279,1697,-1418,-445,-166,-279,349.0,42,0,1427,9,RB,0
0,1,25,451,-471,922,-255,-184,-71,256.52777777777777,36,1,7,925,TE,0
0,1,28,760,-867,1627,-189,-161,-28,309.8269230769231,52,1,2,1621,WR,0
0,1,91,104,-415,519,-278,-261,-17,248.22727272727272,22,1,16,532,TE,0
0,1,0,1183,-576,1759,-141,-396,255,561.625,32,1,2,1760,WR,0
0,1,0,1366,666,700,-151,-216,65,234.66666666666666,30,0,7,703,WR,0
0,1,32,2,216,-214,-715,-512,-203,96.31111111111112,45,0,283,56,RB,1
0,1,32,738,-904,1642,-214,-199,-15,316.07547169811323,53,1,6,1670,WR,0
1,1,41,1310,3,1307,-260,-708,448,252.46428571428572,56,0,24,1327,RB,0
0,1,0,724,-770,1494,-293,-286,-7,353.3809523809524,42,1,3,1483,TE,0
0,1,14,8,-220,228,-618,-535,-83,149.66666666666666,42,1,183,426,RB,1
0,1,0,831,-727,1558,-119,-386,267,518.53125,32,1,11,1562,WR,0
0,1,0,1488,1004,484,-220,-189,-31,204.33333333333334,24,0,0,484,TE,0
0,1,0,392,-643,1035,-231,-248,17,351.23333333333335,30,1,6,1055,TE,0
0,1,59,94,-13,107,-344,-733,389,120.46341463414635,41,0,2,120,RB,0
0,1,0,1896,1017,879,-265,-268,3,269.84375,32,0,5,881,WR,0
0,1,12,748,-410,1158,-262,-278,16,317.2972972972973,37,1,5,1161,WR,0
0,1,6,744,1351,-607,-356,-304,-52,283.8695652173913,23,0,603,0,WR,0
0,1,0,693,-809,1502,-257,-225,-32,327.04347826086956,46,1,8,1504,TE,0
0,1,0,1185,535,650,-196,-300,104,373.1111111111111,18,0,4,650,WR,0
0,1,4,16,-197,213,-720,-491,-229,111.13253012048193,83,1,251,446,RB,1
0,1,32,1896,1250,646,-61,-156,95,175.64102564102564,39,0,40,702,WR,0
0,1,36,1166,751,415,-267,-247,-20,124.54838709677419,31,0,6,414,TE,0
0,1,21,521,360,161,-236,-182,-54,67.19047619047619,21,0,18,177,TE,0
0,1,5,226,-1013,1239,-262,-144,-118,278.4117647058824,51,1,67,1304,WR,0
0,1,0,1526,1081,445,-170,-143,-27,187.375,24,0,5,448,WR,0
0,1,45,22,238,-216,-734,-481,-253,122.76,25,0,208,5,RB,0
0,1,0,722,-597,1319,-195,-202,7,282.59574468085106,47,1,4,1331,TE,0
0,1,0,1018,1215,-197,-180,-212,32,307.3333333333333,54,0,914,731,WR,1
0,1,0,223,-224,447,-455,-459,4,157.09677419354838,31,1,4,471,FB,0
0,1,0,531,-1,532,-159,-194,35,331.2448979591837,49,1,550,1089,TE,1
0,1,33,302,236,66,-499,-418,-81,91.1842105263158,38,0,126,182,RB,1
0,1,0,882,-295,1177,-139,-190,51,526.7826086956521,23,1,19,1192,WR,0
0,1,28,623,-881,1504,-243,-150,-93,322.3958333333333,48,1,12,1513,WR,0
0,1,0,2,29,-27,-471,-229,-242,256.3658536585366,41,0,502,475,TE,1
0,1,34,10,-257,267,-759,-371,-388,142.77777777777777,27,1,10,287,RB,0
1,1,24,1210,4,1206,-123,-755,632,271.66,50,0,3,1204,RB,0
0,1,43,190,1718,-1528,-484,-162,-322,260.75384615384615,65,0,1580,46,RB,0
0,1,72,870,1428,-558,-119,-159,40,196.8,35,0,693,21,WR,0
0,1,0,1430,-141,1571,-166,-223,57,299.60377358490564,53,1,20,1580,TE,0
0,1,0,794,-508,1302,-211,-307,96,383.29411764705884,34,1,13,1292,TE,0
0,1,12,1859,492,1367,-176,-166,-10,339.65,40,0,1,1364,RB,0
0,1,0,293,-1258,1551,-247,-141,-106,462.54285714285714,35,1,4,1559,WR,0
0,1,0,217,-515,732,-496,-666,170,422.1904761904762,21,1,15,750,RB,0
0,1,0,1101,690,411,-169,-115,-54,150.5185185185185,27,0,0,411,WR,0
0,1,0,764,860,-96,-225,-26,-199,206.6086956521739,46,0,502,412,WR,1
0,1,9,1106,681,425,-198,-96,-102,181.70833333333334,24,0,1,425,WR,0
0,1,0,922,634,288,-154,8,-162,149.2608695652174,23,0,10,313,WR,0
0,1,18,442,195,247,-82,-350,268,139.4090909090909,44,0,113,354,TE,1
0,1,27,482,694,-212,-167,-173,6,118.77777777777777,18,0,230,4,TE,0
0,1,13,441,427,14,-239,-246,7,225.5952380952381,42,0,480,497,FB,1
1,1,51,882,875,7,-160,-38,-122,31.2,5,0,12,24,WR,1
0,1,0,459,535,-76,-177,-44,-133,39.3125,32,0,137,50,TE,1
1,1,35,1142,1165,-23,-203,-97,-106,74.25,8,0,37,12,RB,1
0,1,41,930,30,900,-214,-627,413,156.48529411764707,68,0,40,925,RB,0
0,1,25,1,-11,12,-784,-633,-151,98.59649122807018,57,0,35,68,RB,1
0,1,72,1090,1176,-86,-380,39,-419,50.39325842696629,89,0,225,189,WR,1
0,1,63,1406,1447,-41,-388,15,-403,103.19047619047619,105,0,580,490,WR,1
0,1,32,211,81,130,-469,-129,-340,158.15,20,0,2,147,RB,0
0,1,8,1159,619,540,-145,-93,-52,182.75862068965517,29,0,9,538,WR,0
0,1,0,932,-1446,2378,-189,-136,-53,412.33898305084745,59,1,32,2399,WR,0
0,1,0,1311,-174,1485,-136,-88,-48,308.2448979591837,49,1,4,1515,TE,0
1,1,37,1083,1870,-787,-37,-79,42,145.83333333333334,54,0,797,8,WR,0
0,1,0,912,-446,1358,-150,-656,506,357.05,40,1,9,1368,WR,0
1,1,72,436,1009,-573,-183,-153,-30,131.9047619047619,42,0,604,16,TE,0
1,1,51,795,1497,-702,-81,-61,-20,195.88888888888889,36,0,714,25,WR,0
1,1,55,1137,198,939,-182,-522,340,237.95238095238096,42,0,17,933,RB,0
1,1,26,1319,-4,1323,-195,-760,565,278.1320754716981,53,1,5,1338,RB,0
0,1,49,245,-191,436,-225,-366,141,273.45,20,1,17,437,TE,0
0,1,16,10,223,-213,-798,-407,-391,187.04545454545453,22,0,247,10,RB,0
0,1,34,2007,465,1542,-242,-88,-154,319.4166666666667,48,0,23,1559,TE,0
1,1,19,1554,1171,383,-291,-215,-76,142.23076923076923,26,0,4,372,WR,0
1,1,24,198,70,128,-477,-218,-259,154.72222222222223,18,0,5,148,RB,0
0,1,13,227,-467,694,-475,-231,-244,229.47058823529412,34,1,4,703,FB,0
0,1,22,783,-499,1282,-207,-180,-27,307.42857142857144,42,1,22,1306,WR,0
0,1,0,1187,558,629,-167,-201,34,393.9805825242718,103,0,1662,2288,WR,1
0,1,29,226,-204,430,-521,-511,-10,153.60714285714286,28,1,31,439,RB,0
0,1,16,15,1429,-1414,-391,-164,-227,393.9189189189189,37,0,1408,0,RB,0
0,1,0,895,-403,1298,-175,-280,105,555.5,24,1,9,1298,WR,0
0,1,39,511,-497,1008,-233,-225,-8,297.0857142857143,35,1,13,1029,TE,0
0,1,9,1574,222,1352,-237,-516,279,276.33846153846156,65,0,221,1563,RB,0
1,1,23,485,331,154,-204,-298,94,99.73333333333333,15,0,28,157,TE,1
1,1,9,939,1218,-279,-59,-71,12,158.33333333333334,18,0,286,23,WR,0
0,1,3,429,-846,1275,-248,-50,-198,406.96875,32,1,0,1266,WR,0
0,1,0,1640,830,810,-182,-298,116,320.46153846153845,26,0,1,812,RB,0
0,1,0,8,157,-149,-493,-252,-241,218.05714285714285,35,0,423,264,FB,1
0,1,4,811,843,-32,-219,-198,-21,255.6206896551724,58,0,766,733,TE,1
0,1,28,844,-602,1446,-189,-90,-99,316.0,46,1,16,1439,WR,0
0,1,5,502,-702,1204,-184,-105,-79,299.5121951219512,41,1,0,1201,TE,0
1,1,36,22,-205,227,-594,-511,-83,76.75,48,1,63,276,RB,1
0,1,7,1058,-760,1818,-167,-172,5,389.02127659574467,47,1,0,1815,WR,0
0,1,0,1831,1007,824,-236,-248,12,225.60526315789474,38,0,1,816,WR,0
0,1,0,1011,-826,1837,-151,-259,108,435.7906976744186,43,1,5,1843,WR,0
0,1,0,1085,-342,1427,-211,-312,101,501.0689655172414,29,1,10,1426,WR,0
0,1,0,260,654,-394,-420,-110,-310,166.24137931034483,29,0,402,9,FB,0
0,1,0,871,866,5,-36,269,-305,91.66666666666667,3,0,2,13,WR,0
0,1,0,1030,659,371,-104,180,-284,116.875,32,0,3,370,WR,0
0,1,0,712,-54,766,-307,-456,149,303.25454545454545,55,1,434,1190,FB,1
0,1,0,700,-428,1128,-232,-250,18,540.2857142857143,21,1,0,1123,WR,0
0,1,28,204,230,-26,-547,-488,-59,50.888888888888886,9,0,37,2,WR,0
0,1,6,28,-568,596,-304,-163,-141,234.17857142857142,28,1,1,594,TE,0
0,1,0,496,513,-17,-176,-156,-20,87.0,3,0,23,16,TE,1
0,1,0,935,486,449,-208,-253,45,346.0,14,0,10,461,WR,0
0,1,0,511,-540,1051,-173,-152,-21,267.8974358974359,39,1,2,1049,TE,0
0,1,0,789,1934,-1145,-193,-166,-27,302.8421052631579,38,0,1163,11,WR,0
0,1,12,450,399,51,-214,-219,5,190.61702127659575,47,0,426,479,TE,1
0,1,53,725,483,242,-161,-197,36,129.0909090909091,22,0,32,264,TE,0
0,1,0,914,-490,1404,-169,-219,50,548.5769230769231,26,1,2,1417,WR,0
0,1,0,912,-461,1373,-208,-161,-47,449.4516129032258,31,1,6,1382,WR,0
0,1,0,1497,523,974,-189,-78,-111,261.86486486486484,37,0,18,985,TE,0
0,1,32,1196,238,958,-276,-394,118,220.65454545454546,55,0,104,1064,RB,0
1,1,11,836,-887,1723,-254,-166,-88,312.0,55,1,2,1727,WR,0
1,1,0,257,-208,465,-476,-420,-56,168.86206896551724,29,1,6,489,RB,0
0,1,0,1223,219,1004,-287,-516,229,238.0222222222222,45,0,49,1035,RB,0
0,1,50,852,-930,1782,-209,-150,-59,359.82,50,1,11,1779,WR,0
0,1,0,1447,523,924,-211,-82,-129,231.92857142857142,42,0,32,958,TE,0
1,1,67,237,122,115,-462,-228,-234,95.91304347826087,23,0,19,121,RB,0
1,1,41,39,501,-462,-216,-212,-4,205.92592592592592,27,0,498,33,TE,0
0,1,0,1105,1116,-11,-113,290,-403,125.0,3,0,2,2,WR,1
0,1,0,777,728,49,-70,363,-433,168.0,4,0,2,38,WR,0
0,1,8,972,-652,1624,-188,-73,-115,385.04651162790697,43,1,0,1650,WR,0
0,1,0,1093,1176,-83,-207,-98,-109,125.0,7,0,85,12,WR,0
0,1,3,1178,278,900,-353,-439,86,143.58064516129033,93,0,181,1081,RB,0
0,1,24,322,-281,603,-569,-463,-106,228.07407407407408,27,1,25,616,RB,0
0,1,24,260,-1521,1781,-267,-91,-176,390.1914893617021,47,1,13,1815,WR,0
0,1,39,705,-1112,1817,-242,-117,-125,330.25454545454545,55,1,10,1823,WR,0
0,1,0,511,494,17,-60,-77,17,22.705882352941178,17,0,30,30,TE,1
0,1,0,261,484,-223,249,-155,404,131.83333333333334,18,0,209,9,TE,0
0,1,9,46,-80,126,-261,-192,-69,132.16666666666666,12,0,2,128,RB,0
0,1,46,232,-251,483,-538,-493,-45,213.91304347826087,23,1,8,503,RB,0
0,1,8,741,-1299,2040,-252,-176,-76,333.655737704918,61,1,4,2041,WR,0
0,1,11,1250,998,252,-93,-101,8,148.76470588235293,17,0,5,258,WR,0
0,1,0,944,404,540,-203,-240,37,176.25806451612902,31,0,9,541,WR,0
0,1,108,107,253,-146,-546,-579,33,102.38888888888889,18,0,178,35,RB,1
0,1,0,851,-376,1227,-270,-303,33,485.0769230769231,26,1,16,1251,WR,0
0,1,0,785,-317,1102,-217,-280,63,432.2692307692308,26,1,14,1111,WR,0
0,1,26,1051,1034,17,-230,-224,-6,38.0,1,0,7,17,RB,1
0,1,0,889,455,434,-105,-122,17,172.7674418604651,43,0,165,561,WR,1
0,1,0,869,-409,1278,-168,-162,-6,260.4313725490196,51,1,29,1299,WR,0
0,1,0,272,-198,470,-481,-615,134,418.6666666666667,12,1,9,470,RB,0
0,1,0,1769,502,1267,-220,-197,-23,324.5128205128205,39,0,15,1280,TE,0
0,1,21,964,545,419,-198,-155,-43,128.2,30,0,12,425,WR,0
0,1,0,1746,1362,384,-228,-97,-131,325.8333333333333,12,0,6,392,WR,0
0,1,33,1113,962,151,-117,-125,8,70.10526315789474,19,0,9,148,WR,0
0,1,0,877,-758,1635,-238,-78,-160,282.12068965517244,58,1,4,1637,WR,0
0,1,0,772,-1346,2118,-192,-81,-111,291.986301369863,73,1,15,2129,WR,0
0,1,0,581,236,345,-240,-282,42,323.09090909090907,11,0,4,348,TE,0
0,1,20,964,-1274,2238,-191,-152,-39,340.42424242424244,66,1,4,2243,WR,0
0,1,0,260,-678,938,-463,-188,-275,265.8918918918919,37,1,8,959,TE,0
0,1,72,1309,1639,-330,-140,-79,-61,132.1304347826087,23,0,327,16,WR,0
0,1,11,220,-657,877,-482,-179,-303,253.31428571428572,35,1,2,860,RB,0
1,1,32,246,-264,510,-414,-463,49,132.29032258064515,62,1,38,579,RB,0
0,1,0,1531,991,540,-114,-133,19,241.5909090909091,22,0,2,548,WR,0
0,1,0,12,172,-160,-389,-273,-116,202.53488372093022,43,0,478,320,TE,1
0,1,0,2054,1340,714,-275,-122,-153,338.8181818181818,22,0,11,734,WR,0
1,1,25,1587,285,1302,-198,-523,325,331.8292682926829,41,0,2,1318,RB,0
0,1,0,1425,1237,188,-110,-71,-39,119.55555555555556,18,0,16,190,WR,0
0,1,0,1745,1270,475,-255,-187,-68,309.4375,16,0,10,481,WR,0
0,1,33,365,503,-138,-263,-154,-109,136.28571428571428,14,0,148,13,TE,0
0,1,0,430,144,286,-213,-302,89,232.30769230769232,13,0,4,276,TE,0
0,1,3,1322,361,961,-162,-230,68,187.11764705882354,51,0,0,953,WR,0
0,1,170,1926,2122,-196,-113,-68,-45,105.2489270386266,233,0,1295,1149,WR,1
0,1,0,293,284,9,-475,-387,-88,68.84,150,0,503,418,RB,1
0,1,175,1162,1217,-55,-66,12,-78,119.8452380952381,168,0,914,934,WR,1
0,1,0,495,743,-248,-82,75,-157,131.0,18,0,248,15,TE,0
0,1,0,717,-549,1266,-189,-71,-118,313.3170731707317,41,1,11,1275,TE,0
0,1,0,946,114,832,-147,-728,581,364.42857142857144,28,0,15,848,WR,0
0,1,0,1898,1395,503,-338,-248,-90,202.92,25,0,3,509,WR,0
0,1,0,599,-821,1420,-221,-361,140,311.82608695652175,46,1,0,1416,WR,0
0,1,0,1485,1001,484,-136,-93,-43,216.58333333333334,24,0,2,522,WR,0
0,1,0,1995,1345,650,-271,-197,-74,221.9655172413793,29,0,4,650,WR,0
0,1,0,439,-635,1074,-261,-239,-22,289.6578947368421,38,1,3,1075,TE,0
0,1,0,547,-23,570,-162,-458,296,199.66666666666666,36,1,48,620,WR,0
0,1,0,464,431,33,-89,-121,32,22.5,12,0,29,28,TE,1
0,1,0,1556,671,885,-253,-192,-61,295.93333333333334,30,0,2,889,TE,0
0,1,1,949,448,501,-285,-253,-32,218.75,24,0,20,523,TE,0
0,1,27,1,224,-223,-791,-555,-236,109.66666666666667,30,0,263,42,RB,0
0,1,0,1519,646,873,-206,-160,-46,332.9230769230769,26,0,7,870,TE,0
0,1,0,1155,645,510,-172,-257,85,143.38888888888889,36,0,3,500,WR,0
0,1,34,453,1520,-1067,-287,-134,-153,400.5,28,0,1069,6,WR,0
0,1,0,469,466,3,-251,-257,6,23.0,15,0,47,46,TE,1
0,1,0,1066,121,945,-175,-768,593,339.75757575757575,33,0,11,956,WR,0
0,1,7,640,-754,1394,-206,-115,-91,313.1363636363636,44,1,2,1369,WR,0
0,1,0,1577,1184,393,-216,-149,-67,257.06666666666666,15,0,8,384,TE,0
0,1,0,184,-199,383,-539,-456,-83,202.95238095238096,21,1,38,420,RB,0
0,1,43,210,233,-23,-307,-376,69,77.95454545454545,44,0,105,104,RB,1
0,1,0,1768,1348,420,-264,-217,-47,149.92592592592592,27,0,0,417,WR,0
0,1,16,286,-263,549,-451,-463,12,116.50819672131148,61,1,8,558,RB,0
0,1,48,144,553,-409,-259,-215,-44,227.75,20,0,426,33,TE,0
0,1,0,23,23,0,-765,-750,-15,38.5,10,0,15,11,RB,1
0,1,0,796,582,214,-195,-221,26,206.0909090909091,11,0,9,200,RB,0
0,1,0,648,-933,1581,-169,-111,-58,374.13953488372096,43,1,0,1575,WR,0
0,1,0,228,332,-104,-617,-557,-60,57.27272727272727,22,0,117,0,RB,0
0,1,0,2099,1482,617,-172,-187,15,285.90909090909093,22,0,2,619,WR,0
0,1,0,1256,619,637,-183,-318,135,471.85714285714283,14,0,4,644,WR,0
0,1,82,971,1102,-131,-185,-178,-7,58.23529411764706,17,0,125,14,WR,0
0,1,6,507,180,327,-234,-491,257,179.53846153846155,26,0,21,337,TE,0
0,1,0,781,-1389,2170,-230,-70,-160,417.9230769230769,52,1,8,2166,WR,0
0,1,0,794,-941,1735,-274,-176,-98,402.74418604651163,43,1,4,1741,WR,0
0,1,9,943,224,719,-242,-440,198,232.64102564102564,39,0,83,797,TE,0
0,1,30,572,-696,1268,-220,-209,-11,265.70212765957444,47,1,5,1266,TE,0
0,1,18,527,660,-133,-174,-148,-26,109.0,12,0,131,12,TE,0
0,1,0,1367,816,551,-331,-247,-84,180.67741935483872,31,0,2,551,TE,0
0,1,13,489,836,-347,-249,-174,-75,231.02702702702703,37,0,614,254,TE,1
0,1,48,554,-928,1482,-201,-189,-12,337.5681818181818,44,1,2,1491,TE,0
0,1,31,230,-204,434,-599,-505,-94,183.45454545454547,22,1,19,414,RB,0
0,1,0,1848,908,940,-215,-246,31,210.0888888888889,45,0,13,948,WR,0
0,1,0,821,501,320,-384,-334,-50,128.6216216216216,37,0,58,361,WR,0
0,1,0,1302,143,1159,-239,-585,346,460.85185185185185,27,0,18,1181,RB,0
0,1,6,227,-213,440,-573,-445,-128,139.7741935483871,31,1,4,427,RB,0
0,1,25,470,202,268,-248,-519,271,146.10344827586206,29,0,19,290,TE,0
0,1,0,463,496,-33,-227,-273,46,188.62962962962962,27,0,271,223,TE,1
0,1,34,1328,-611,1939,-222,-217,-5,371.7692307692308,52,1,2,1943,TE,0
0,1,0,1794,1261,533,-139,-189,50,235.77272727272728,22,0,16,538,WR,0
0,1,26,85,218,-133,-499,-507,8,70.0,27,0,168,50,RB,1
0,1,63,151,213,-62,-386,-475,89,125.23076923076923,13,0,104,32,RB,1
0,1,28,186,-227,413,-45,-75,30,143.46666666666667,30,1,18,426,RB,0
0,1,0,609,183,426,-261,-383,122,227.6551724137931,29,0,106,534,TE,1
0,1,6,427,-485,912,-273,-168,-105,264.9714285714286,35,1,3,919,TE,0
0,1,0,2009,1146,863,-226,-192,-34,269.15625,32,0,0,860,WR,0
0,1,6,1374,864,510,-317,-158,-159,171.41379310344828,29,0,2,515,TE,0
0,1,0,1328,827,501,-210,-196,-14,215.30434782608697,23,0,2,498,WR,0
0,1,0,1320,-1042,2362,-211,29,-240,403.2413793103448,58,1,4,2364,TE,0
0,1,15,1946,1374,572,-213,-190,-23,193.06451612903226,31,0,12,572,WR,0
0,1,0,995,-283,1278,-213,-300,87,458.89285714285717,28,1,9,1282,WR,0
0,1,0,538,-861,1399,-212,-189,-23,300.60869565217394,46,1,2,1401,TE,0
0,1,0,1179,1014,165,-135,-116,-19,185.38709677419354,31,0,206,367,WR,1
0,1,0,510,349,161,-140,-231,91,219.89795918367346,49,0,443,637,TE,1
1,1,15,517,-620,1137,-228,-138,-90,294.1621621621622,37,1,2,1138,TE,0
1,1,19,1646,-1983,3629,-32,24,-56,440.35714285714283,84,1,11,3650,WR,0
1,1,49,999,1365,-366,-88,-53,-35,98.20408163265306,49,0,444,78,WR,0
0,1,30,1451,1316,135,454,66,388,107.75,12,0,15,133,WR,0
0,1,12,2014,2019,-5,461,97,364,80.02857142857142,35,0,134,145,WR,1
0,1,0,470,551,-81,343,-31,374,71.78260869565217,46,0,218,107,TE,1
1,1,27,260,-314,574,-536,-539,3,127.10344827586206,58,1,25,612,RB,0
0,1,35,282,256,26,-17,-154,137,76.16666666666667,66,0,204,238,RB,1
0,1,48,1986,1962,24,448,282,166,57.24390243902439,41,0,107,150,WR,1
0,1,19,1768,654,1114,-124,-170,46,284.28205128205127,39,0,2,1115,WR,0
0,1,26,476,-531,1007,-86,-186,100,198.39285714285714,56,1,29,1030,TE,0
0,1,0,2152,748,1404,-184,-218,34,319.72549019607845,51,0,105,1511,RB,0
0,1,0,1463,1188,275,-229,-196,-33,215.30769230769232,13,0,5,277,WR,0
0,1,16,1959,1269,690,-148,-171,23,210.3030303030303,33,0,2,693,WR,0
0,1,0,957,-514,1471,-168,-689,521,544.1724137931035,29,1,2,1479,WR,0
0,1,0,858,-127,985,-256,-712,456,432.3703703703704,27,1,7,1006,WR,0
0,1,7,482,-625,1107,-223,-164,-59,265.04761904761904,42,1,1,1106,TE,0
0,1,0,1091,604,487,-192,-150,-42,168.06896551724137,29,0,46,508,TE,0
0,1,5,595,-1381,1976,-312,-135,-177,375.2307692307692,52,1,4,1971,WR,0
0,1,0,1536,942,594,-303,-233,-70,163.80555555555554,36,0,0,594,WR,0
0,1,29,1388,267,1121,-300,-371,71,312.0810810810811,37,0,4,1142,RB,0
1,1,70,138,184,-46,-568,-650,82,79.51388888888889,72,0,73,68,RB,1
0,1,32,776,771,5,-212,-217,5,83.45614035087719,57,0,232,213,WR,1
1,1,0,1361,13,1348,-147,-771,624,203.76315789473685,76,0,19,1384,RB,0
0,1,6,769,-1188,1957,-238,-110,-128,323.8360655737705,61,1,2,1940,WR,0
0,1,34,205,1861,-1656,-498,-166,-332,328.19607843137254,51,0,1653,8,RB,0
0,1,9,616,-433,1049,-245,-203,-42,261.25,40,1,15,1061,TE,0
0,1,0,622,-681,1303,-222,-27,-195,368.36842105263156,38,1,57,1328,TE,0
0,1,0,809,350,459,-241,-321,80,177.17857142857142,28,0,28,472,WR,0
1,1,45,9,8,1,-741,-793,52,101.29729729729729,37,0,22,50,RB,1
0,1,38,429,-623,1052,-210,-164,-46,164.06666666666666,90,1,217,1258,TE,0
0,1,29,1103,1148,-45,-69,-74,5,79.93103448275862,58,0,182,153,WR,1
1,1,0,534,407,127,-145,-92,-53,69.08695652173913,23,0,48,172,TE,1
1,1,29,650,522,128,-189,-149,-40,51.30434782608695,23,0,21,145,TE,0
0,1,0,1162,-963,2125,-189,-147,-42,352.75409836065575,61,1,2,2139,WR,0
0,1,0,208,583,-375,-517,-250,-267,178.1,30,0,397,4,WR,0
0,1,43,157,1108,-951,-500,-136,-364,222.4468085106383,47,0,944,10,RB,0
0,1,0,632,-470,1102,-234,-284,50,380.0344827586207,29,1,4,1108,WR,0
0,1,17,507,-876,1383,-264,-91,-173,369.05128205128204,39,1,5,1418,WR,0
0,1,0,184,-212,396,-517,-122,-395,167.74074074074073,27,1,42,432,RB,0
0,1,0,1173,551,622,-181,-259,78,407.9375,16,0,5,626,WR,0
0,1,0,564,-474,1038,-200,-216,16,316.55882352941177,34,1,37,1073,TE,0
0,1,43,257,-1344,1601,-288,-160,-128,296.90909090909093,55,1,9,1606,WR,0
0,1,33,181,-1316,1497,-532,-114,-418,335.5744680851064,47,1,10,1511,RB,0
0,1,0,909,-398,1307,-185,-405,220,473.89285714285717,28,1,11,1320,WR,0
0,1,6,601,-755,1356,-257,-168,-89,291.5869565217391,46,1,6,1349,TE,0
0,1,0,292,272,20,-530,-541,11,32.0,3,0,5,25,RB,1
1,1,57,221,631,-410,-362,-268,-94,129.53125,32,0,412,22,WR,0
1,1,57,12,-1280,1292,-628,-101,-527,294.40425531914894,47,1,7,1292,RB,0
1,1,34,1754,771,983,-173,-85,-88,215.5,46,0,4,1002,WR,0
1,1,67,206,107,99,-468,-121,-347,152.72222222222223,18,0,25,105,RB,1
0,1,0,593,-264,857,-153,-251,98,294.6666666666667,42,1,209,1069,TE,1
1,1,50,526,805,-279,-85,-96,11,118.26923076923077,26,0,316,43,TE,0
0,1,3,613,-463,1076,-153,-165,12,276.3333333333333,39,1,4,1078,TE,0
0,1,0,224,1265,-1041,-534,-547,13,404.03846153846155,26,0,1043,12,RB,0
0,1,0,591,-695,1286,-294,-83,-211,268.78,50,1,8,1310,TE,0
1,1,32,1870,1947,-77,-208,-162,-46,55.541666666666664,24,0,116,12,WR,0
0,1,21,233,199,34,-569,-534,-35,112.95384615384616,65,0,232,279,RB,1
0,1,30,219,-185,404,-433,-515,82,133.16129032258064,31,1,11,402,RB,0
0,1,39,611,-601,1212,-230,-229,-1,274.17391304347825,46,1,24,1244,TE,0
0,1,54,251,220,31,-499,-466,-33,115.80851063829788,47,0,169,213,RB,1
0,1,51,824,185,639,-576,-559,-17,223.825,40,0,126,734,RB,0
0,1,0,553,-515,1068,-257,-322,65,279.3076923076923,39,1,25,1097,TE,0
0,1,37,233,-278,511,-539,-529,-10,178.71428571428572,28,1,15,512,RB,0
0,1,0,689,-972,1661,-283,-189,-94,309.09090909090907,55,1,19,1691,WR,0
0,1,0,1077,1050,27,-79,-75,-4,52.78947368421053,38,0,130,166,WR,1
0,1,25,135,-1158,1293,-311,-183,-128,275.2083333333333,48,1,10,1303,WR,0
0,1,6,1459,-38,1497,-216,-745,529,358.70454545454544,44,1,12,1503,RB,0
0,1,0,460,-498,958,-283,-308,25,351.1111111111111,27,1,7,962,TE,0
0,1,0,739,-450,1189,-341,-232,-109,297.0,85,1,650,1836,WR,1
0,1,0,120,207,-87,-328,-552,224,224.075,40,0,435,363,WR,1
1,1,0,774,1510,-736,-195,-36,-159,169.30612244897958,49,0,764,81,WR,0
1,1,1,1194,185,1009,-286,-392,106,250.40983606557376,61,0,149,1212,RB,0
1,1,0,420,-744,1164,-223,-85,-138,250.67307692307693,52,1,21,1236,TE,0
0,1,0,81,-1144,1225,-288,-143,-145,354.27777777777777,36,1,0,1244,WR,0
0,1,0,1791,1162,629,-250,-143,-107,260.11538461538464,26,0,23,679,WR,0
0,1,0,426,-53,479,-271,-654,383,362.6521739130435,46,1,520,1005,WR,1
1,1,43,209,-272,481,-528,-485,-43,154.57142857142858,28,1,37,475,RB,0
0,1,0,1097,605,492,-229,-367,138,367.0,96,0,1496,1987,WR,1
0,1,0,171,-251,422,-538,-505,-33,247.0,19,1,20,443,RB,0
0,1,51,50,748,-698,-311,-214,-97,255.28571428571428,28,0,707,20,WR,0
0,1,2,23,-11,34,-648,-597,-51,47.2,5,0,10,22,RB,1
0,1,22,67,216,-149,-557,-515,-42,140.63636363636363,11,0,148,13,RB,0
0,1,0,2035,958,1077,-276,-165,-111,275.3421052631579,38,0,13,1071,WR,0
0,1,0,1232,702,530,-255,-347,92,378.7142857142857,14,0,7,524,WR,0
0,1,0,214,-263,477,-559,-502,-57,101.26086956521739,46,1,17,494,RB,0
0,1,0,648,-657,1305,-217,-326,109,385.1764705882353,34,1,2,1311,WR,0
0,1,0,1638,927,711,-232,-165,-67,206.35294117647058,34,0,8,712,WR,0
1,1,31,1704,1927,-223,-170,-73,-97,92.96428571428571,28,0,244,6,WR,0
0,1,0,85,221,-136,-467,-452,-15,78.0,18,0,176,27,RB,0
1,1,26,549,728,-179,-258,-39,-219,93.97142857142858,35,0,185,22,TE,0
0,1,0,580,-477,1057,-215,-121,-94,183.3943661971831,71,1,217,1301,TE,0
0,1,0,534,772,-238,-215,-216,1,167.1086956521739,46,0,493,260,TE,1
0,1,0,998,740,258,-230,-317,87,368.0,36,0,517,785,WR,1
0,1,0,586,-492,1078,-169,-169,0,339.969696969697,33,1,6,1098,WR,0
0,1,22,733,-680,1413,-187,-224,37,297.7659574468085,47,1,4,1417,WR,0
0,1,0,1382,930,452,-219,-199,-20,186.25,24,0,0,450,TE,0
0,1,5,216,-219,435,-499,-466,-33,173.23076923076923,26,1,9,450,RB,0
0,1,0,1504,1377,127,-358,-316,-42,114.38461538461539,13,0,13,133,RB,0
0,1,0,590,-481,1071,-187,-193,6,295.69444444444446,36,1,15,1073,TE,0
0,1,0,518,827,-309,-200,-122,-78,105.56666666666666,30,0,301,15,TE,0
0,1,0,470,-695,1165,-213,-199,-14,291.4,40,1,4,1156,TE,0
0,1,59,17,444,-427,-386,-90,-296,170.88235294117646,34,0,478,34,TE,0
0,1,12,494,-592,1086,-166,-125,-41,267.4047619047619,42,1,11,1118,TE,0
0,1,28,1023,1482,-459,-204,-189,-15,181.52,25,0,467,11,WR,0
0,1,0,4,302,-298,-795,-793,-2,303.4,10,0,298,17,RB,0
0,1,25,170,-642,812,-509,-229,-280,232.33333333333334,36,1,5,813,RB,0
0,1,0,584,718,-134,-181,-212,31,61.84,25,0,158,23,RB,0
0,1,24,217,-469,686,-406,-177,-229,182.24324324324326,37,1,9,688,FB,0
0,1,0,200,-385,585,-479,-259,-220,440.125,16,1,0,584,WR,0
0,1,77,304,-279,583,-608,-565,-43,177.28125,32,1,4,602,RB,0
0,1,5,528,-589,1117,-265,-169,-96,252.58695652173913,46,1,6,1144,TE,0
0,1,0,784,455,329,-252,-207,-45,333.1,10,0,2,329,FB,0
