inMotionAtBallSnap,init_rel_y_dis,end_rel_y_dis,overall_y_change,init_rel_x_dis,end_rel_x_dis,overall_x_change,motion_s_avg,frames_in_motion,max_x_rel_pos,min_x_rel_pos,max_y_rel_pos,min_y_rel_pos,dis_line_start,dis_line_end,passed_fb
1,983,201,782,-244,-649,405,359.93548387096774,31,409,-2,-3,1069,668,-114,0
1,2,-320,322,-475,-256,-219,242.29166666666666,24,0,-248,0,542,-325,-647,0
1,1082,582,500,-151,-117,-34,255.38888888888889,18,4,-29,0,481,945,445,1
0,12,-469,481,-264,-116,-148,8.0,1,2,-165,495,0,-324,-805,0
1,1042,419,623,-98,-331,233,413.2,15,238,0,0,621,746,123,1
1,1243,828,415,-195,-202,7,278.6,15,10,-5,-9,416,953,538,1
0,1552,-213,1765,-121,-541,420,382.3541666666667,48,509,0,0,1769,1263,-502,0
1,929,391,538,-242,-354,112,405.2142857142857,14,112,-2,-17,530,604,66,1
1,1478,932,546,-162,-167,5,189.57142857142858,28,50,-1,0,547,1167,621,1
1,653,-212,865,-217,-250,33,431.75,20,37,0,-3,862,350,-515,0
0,814,1115,-301,-152,-149,-3,133.06666666666666,30,39,-49,17,-387,406,707,1
0,242,-302,544,-502,-482,-20,103.9622641509434,53,1,-107,0,548,-59,-603,0
1,971,-176,1147,-182,-646,464,488.7692307692308,26,465,-1,-5,1152,675,-472,0
0,355,433,-78,-188,-95,-93,126.0,11,0,-109,0,-109,17,95,1
1,1199,359,840,-227,-361,134,506.0,17,127,0,-3,835,897,57,1
1,697,315,382,-203,-264,61,396.9166666666667,12,64,-12,848,-1,334,-48,0
0,1934,875,1059,-28,-77,49,235.95454545454547,44,63,-18,0,1066,1619,560,1
0,588,828,-240,-70,-38,-32,128.19444444444446,36,166,-30,188,-248,225,465,1
0,256,374,-118,-454,-450,-4,89.33333333333333,15,18,0,12,-136,-107,11,1
0,342,-440,782,-214,-154,-60,275.8965517241379,29,47,-61,0,790,36,-746,0
0,307,1491,-1184,-744,-236,-508,333.3421052631579,38,0,-512,0,-1189,3,1187,1
0,1067,1509,-442,-191,-62,-129,184.45833333333334,24,0,-128,0,-444,761,1203,1
0,216,581,-365,-392,-191,-201,194.08333333333334,24,101,-201,17,-367,-90,275,1
0,857,464,393,-192,-164,-28,116.90322580645162,31,25,-46,0,391,595,202,1
1,984,552,432,-264,-394,130,284.0625,16,135,0,-14,427,712,280,1
0,1170,1313,-143,-213,-213,0,85.0,13,13,-1,1,-155,863,1006,1
0,1573,68,1505,-73,-175,102,296.7543859649123,57,416,-1,0,1505,1288,-217,1
1,465,401,64,-248,-244,-4,154.0,4,3,-1,0,65,147,83,1
1,499,446,53,-245,-221,-24,134.5,2,6,0,0,46,203,150,1
0,163,-270,433,-509,-457,-52,191.2,25,18,-60,-31,442,-149,-582,0
1,468,125,343,-234,-255,21,349.9,10,25,0,-2,347,163,-180,1
0,564,-1540,2104,-212,-95,-117,322.40625,64,13,-115,0,2101,259,-1845,0
1,219,-128,347,-610,-616,6,306.8181818181818,11,8,-7,0,349,-84,-431,0
1,718,365,353,-200,-312,112,396.4,10,117,-9,-8,353,450,97,1
1,746,-525,1271,-229,-214,-15,397.1875,32,23,-5,-2,1271,438,-833,0
1,436,207,229,-255,-257,2,307.0,8,3,-22,-15,232,154,-75,1
1,484,-524,1008,-275,-250,-25,532.8947368421053,19,0,-33,-1,1008,195,-813,0
1,12,91,-79,-465,-458,-7,107.71428571428571,7,0,-6,0,-80,-304,-225,1
1,1531,865,666,-174,-210,36,227.20689655172413,29,51,0,-1,668,1213,547,1
1,850,415,435,-185,-294,109,422.09090909090907,11,117,0,0,434,552,117,1
1,509,543,-34,-126,-114,-12,1.0,2,22,-4,0,-61,152,186,1
1,198,-199,397,-585,-520,-65,351.5,12,53,0,0,403,-126,-523,0
0,1104,-1461,2565,-180,-60,-120,353.9178082191781,73,176,-124,0,2562,807,-1758,0
0,518,257,261,-122,-391,269,47.5,2,287,-7,294,-8,158,-103,1
1,929,1040,-111,-174,-233,59,486.09090909090907,22,95,0,947,-113,564,675,0
1,997,613,384,-256,-247,-9,372.75,12,94,0,-59,371,679,295,1
1,513,483,30,-114,35,-149,53.5,2,0,-46,86,0,178,148,1
0,601,-538,1139,-199,-139,-60,313.6388888888889,36,46,-58,0,1144,311,-828,0
1,941,67,874,-154,-245,91,374.9047619047619,42,88,-6,0,1607,665,-209,0
1,272,-726,998,-490,-716,226,466.95454545454544,22,241,0,-3,982,-17,-1015,0
0,1250,468,782,-161,-140,-21,256.375,32,38,-33,0,813,954,172,1
0,108,238,-130,-652,-481,-171,162.3,10,0,-177,0,-123,-201,-71,1
0,415,-455,870,-190,-167,-23,218.15384615384616,39,35,-29,-30,880,103,-767,0
1,766,374,392,-162,-315,153,386.8181818181818,11,150,-2,-8,391,473,81,1
0,943,-498,1441,-215,-188,-27,371.43589743589746,39,39,0,-1,1460,636,-805,0
1,987,-20,1007,-160,-296,136,542.2631578947369,19,139,-8,-7,1005,684,-323,0
0,1691,-1541,3232,-107,-104,-3,444.56944444444446,72,111,-20,-9,3219,1375,-1857,0
1,824,-471,1295,-215,-179,-36,226.33333333333334,6,69,-10,1440,0,528,-767,0
1,769,-194,963,-141,-367,226,509.05,20,205,0,-2,971,457,-506,0
0,236,-571,807,-441,-45,-396,297.27272727272725,33,14,-332,-184,813,68,-739,0
0,676,282,394,-56,0,-56,110.20588235294117,34,12,-8,-5,401,508,114,1
0,882,-378,1260,-231,-241,10,334.7894736842105,38,31,-5,-1,1290,597,-663,0
1,1232,538,694,-62,-314,252,409.27777777777777,18,252,-12,-24,696,909,215,1
0,1257,-10,1267,-179,-452,273,242.4,55,277,-43,0,1264,944,-323,0
0,569,0,569,-149,-776,627,219.51282051282053,39,636,0,0,593,280,-289,0
0,50,215,-165,-817,-496,-321,227.35714285714286,14,0,-339,0,-165,-263,-98,1
1,502,280,222,-230,-236,6,344.8181818181818,11,50,-5,582,-4,155,-67,0
0,424,-425,849,-111,-107,-4,273.1818181818182,33,124,-22,0,854,127,-722,0
0,545,-568,1113,-218,-183,-35,267.57142857142856,42,92,-54,0,1115,248,-865,0
0,223,-489,712,-433,-125,-308,270.7586206896552,29,0,-324,-2,703,-77,-789,0
0,905,-359,1264,-198,-242,44,330.10526315789474,38,77,-1,-10,1273,613,-651,0
1,732,-477,1209,-271,-273,2,392.64516129032256,31,27,-16,-6,1206,434,-775,0
1,962,-542,1504,-164,-336,172,568.1111111111111,27,189,0,-8,1496,653,-851,0
0,37,971,-934,-142,-204,62,292.84375,32,116,0,0,-942,-284,650,1
0,640,457,183,-61,-71,10,112.0625,16,36,-2,0,197,316,133,1
0,229,2413,-2184,-503,-241,-262,471.2340425531915,47,0,-271,2,-2174,-80,2104,1
1,926,-500,1426,-271,-246,-25,449.1875,32,10,-23,-4,1431,631,-795,0
1,609,-273,882,-130,-266,136,425.2307692307692,13,129,0,1431,0,307,-575,0
0,7,18,-11,-723,-766,43,103.0,4,42,-299,-61,10,-277,-266,0
1,589,-391,980,-201,-208,7,410.8333333333333,24,49,-1,0,979,279,-701,0
0,916,1007,-91,-126,-127,1,127.0,11,21,-54,4,-150,603,694,1
0,174,-209,383,-473,-476,3,135.66666666666666,39,4,-159,-6,462,-123,-506,0
1,458,355,103,-215,-221,6,319.4,15,75,0,562,-3,135,32,0
0,823,1442,-619,-106,-100,-6,156.25641025641025,39,16,-21,0,-633,520,1139,1
0,84,833,-749,-267,-4,-263,184.16666666666666,36,1,-201,1,-714,-219,530,1
0,259,486,-227,-406,-95,-311,162.88235294117646,17,142,-245,-267,255,-46,181,1
1,1253,694,559,-116,-98,-18,231.44,25,51,-6,0,573,934,375,1
1,788,-171,959,-239,-329,90,451.72727272727275,22,90,-10,0,967,471,-488,0
0,541,214,327,-143,-415,272,207.85,20,286,-1,0,331,266,-61,1
1,817,-304,1121,-262,-288,26,438.46153846153845,26,25,-6,-6,1122,542,-579,0
0,7,-182,189,-746,-470,-276,157.85,20,0,-278,-7,221,-293,-482,0
0,245,-600,845,-422,-106,-316,303.0571428571429,35,0,-324,-221,852,84,-761,0
0,622,315,307,-31,-49,18,136.95652173913044,23,37,-12,0,328,461,154,1
0,875,-356,1231,-216,-226,10,71.0,1,16,0,1252,0,568,-663,0
1,845,-360,1205,-132,-326,194,568.8181818181819,22,203,-2,-10,1205,544,-661,0
1,845,-390,1235,-146,-346,200,580.3636363636364,22,195,-2,0,1235,523,-712,0
1,928,-293,1221,-118,-243,125,579.6818181818181,22,219,0,-1,1216,616,-605,0
1,1066,35,1031,-160,-458,298,485.8695652173913,23,373,0,0,1034,779,-252,1
0,608,607,1,-175,-178,3,107.6,15,25,-35,20,-145,288,287,1
0,1226,740,486,-299,-86,-213,95.0,4,0,-219,486,0,908,422,1
0,1203,1477,-274,-91,-129,38,91.91891891891892,37,50,-9,0,-328,885,1159,1
1,298,-266,564,-583,-636,53,257.3636363636364,22,69,-1,0,562,-74,-638,0
0,1544,-1343,2887,-293,-137,-156,513.6666666666666,57,9,-153,0,2946,1172,-1715,0
1,1075,95,980,-149,-624,475,396.30555555555554,36,544,0,-13,1384,768,-212,0
0,482,-552,1034,-267,-21,-246,60.75,8,33,-189,1058,-11,132,-902,0
1,1862,967,895,-215,-278,63,417.5,22,130,-29,-15,877,1549,654,1
1,1141,-386,1527,-189,-251,62,439.0285714285714,35,83,-5,0,1545,813,-714,0
1,940,207,733,-228,-241,13,34.0,1,23,-21,728,-1,582,-151,1
0,926,1363,-437,-168,-115,-53,29.666666666666668,3,4,-25,-431,7,583,1020,1
0,1536,207,1329,-213,-456,243,308.2,45,280,0,-9,1360,1193,-136,1
0,978,426,552,-206,-179,-27,47.0,2,14,-9,533,0,655,103,1
1,261,-304,565,-630,-580,-50,171.66666666666666,33,24,-45,0,580,-136,-701,0
0,1606,-249,1855,-282,-420,138,48.0,1,297,0,1861,-7,1247,-608,0
0,460,-530,990,-228,-235,7,246.125,40,85,0,0,1002,193,-797,0
0,325,-544,869,-277,-68,-209,273.24242424242425,33,8,-171,0,884,-1,-870,0
0,851,-1369,2220,-264,-177,-87,453.3469387755102,49,67,-40,-30,2215,525,-1695,0
0,1228,242,986,-256,-460,204,18.0,1,204,-8,995,-19,876,-110,1
0,814,-976,1790,-242,-141,-101,420.8837209302326,43,8,-120,-7,1794,420,-1370,0
0,488,539,-51,-241,-244,3,10.777777777777779,9,156,-27,-145,0,112,163,1
0,195,-234,429,-538,-313,-225,209.34782608695653,23,43,-68,0,459,-155,-584,0
0,665,-245,910,-98,-477,379,93.81818181818181,11,354,-50,918,-6,187,-723,0
0,2224,2204,20,-173,-67,-106,12.5,2,0,-14,37,0,1902,1882,1
0,421,532,-111,-210,-154,-56,108.72222222222223,18,28,-56,46,-146,57,168,1
1,1223,-88,1311,-180,-737,557,378.2916666666667,24,572,-4,2082,-3,876,-435,0
0,532,550,-18,-111,-99,-12,82.46153846153847,13,36,-8,149,-43,178,196,1
0,552,-503,1055,12,-32,44,62.0,1,78,-16,1079,0,24,-1031,0
0,1511,667,844,-202,-191,-11,233.5142857142857,35,33,-14,-1,844,1155,311,1
0,259,-344,603,-615,-562,-53,186.3548387096774,31,18,-32,-4,607,-64,-667,0
0,544,519,25,-142,-65,-77,28.0,3,1,-71,0,23,213,188,1
0,119,541,-422,-282,-179,-103,238.88888888888889,18,0,-143,0,-450,-191,231,1
0,37,526,-489,-269,-33,-236,230.9090909090909,22,0,-211,0,-527,-313,176,1
1,473,162,311,-237,-236,-1,339.38461538461536,26,44,-18,1205,-3,150,-161,0
1,762,579,183,-282,-269,-13,126.42105263157895,19,6,-27,-33,182,284,101,1
0,482,-562,1044,-212,-134,-78,54.0,2,8,-67,1071,0,135,-909,0
1,311,-1246,1557,-240,-172,-68,56.666666666666664,3,34,-89,1599,0,-79,-1636,0
1,1491,1523,-32,-91,-52,-39,49.5,2,0,-2,0,-29,1212,1244,1
1,12,-14,26,-412,-300,-112,117.0,2,0,-75,0,23,-238,-264,0
1,1218,822,396,-89,-291,202,344.8,15,219,0,907,-7,850,454,1
0,168,517,-349,-362,-112,-250,208.05,20,0,-278,0,-355,-200,149,1
0,542,525,17,-202,74,-276,75.0,1,9,-5,-2,20,210,193,1
0,466,-680,1146,-285,-137,-148,226.75510204081633,49,30,-185,-10,1124,166,-980,0
0,924,-1275,2199,-230,-187,-43,481.1521739130435,46,106,-48,0,2189,524,-1675,0
0,1560,235,1325,-155,-415,260,322.0487804878049,41,323,0,0,1325,1226,-99,1
1,1249,386,863,-287,-380,93,478.77777777777777,18,91,-2,0,862,873,10,1
1,445,20,425,-226,-417,191,214.14285714285714,21,198,-2,0,432,203,-222,1
0,572,-667,1239,-231,-157,-74,245.02,50,21,-66,0,1238,121,-1118,0
1,927,952,-25,-104,-119,15,37.0,3,66,-4,0,-55,530,555,1
0,653,-440,1093,-194,-217,23,282.325,40,84,0,-2,1141,330,-763,0
0,685,-964,1649,-291,-177,-114,343.3541666666667,48,0,-113,0,1663,353,-1296,0
1,502,486,16,-131,-110,-21,18.75,4,19,-20,27,-9,147,131,1
0,1445,-293,1738,-249,-480,231,35.0,4,336,-51,1789,-27,1113,-625,0
1,1545,1564,-19,-131,-120,-11,69.0,5,11,-25,5,-25,1105,1124,1
1,1508,1493,15,-186,-108,-78,72.0,3,0,-6,0,31,1192,1177,1
1,294,-258,552,-592,-597,5,190.23333333333332,30,55,-10,-11,590,-81,-633,0
0,724,-1040,1764,-274,243,-517,378.1521739130435,46,23,-149,0,1738,437,-1327,0
0,1907,857,1050,-287,-235,-52,294.0285714285714,35,69,-14,0,1051,1606,556,1
0,473,543,-70,-35,-55,20,61.7,10,138,-1,-175,9,53,123,1
0,597,-658,1255,-126,-87,-39,34.2,5,234,-13,1327,0,257,-998,0
0,1237,1232,5,-91,-81,-10,73.1,20,43,0,-85,55,913,908,1
0,101,-506,607,-250,-35,-215,249.07692307692307,26,0,-178,0,631,-223,-830,0
0,913,-1253,2166,-196,-142,-54,461.4255319148936,47,76,-31,0,2189,589,-1577,0
1,1266,384,882,-168,-129,-39,70.0,1,47,-5,905,0,941,59,1
0,417,-502,919,-284,-155,-129,270.5806451612903,31,12,-33,0,883,111,-808,0
1,986,324,662,-240,-239,-1,397.3125,16,121,-5,0,619,680,18,1
1,760,392,368,-240,-300,60,329.1818181818182,11,65,-5,0,372,420,52,1
0,577,-517,1094,-184,-153,-31,328.8181818181818,33,75,-13,0,1093,195,-899,0
0,345,1888,-1543,-453,-154,-299,325.04,50,0,-275,0,-1555,-7,1536,1
0,451,525,-74,-120,-45,-75,74.53846153846153,13,0,-89,0,-85,116,190,1
0,466,-588,1054,-170,-131,-39,278.425,40,26,-69,-2,1111,118,-936,0
1,603,578,25,-172,-29,-143,57.8,10,0,-41,-13,52,150,125,1
0,797,-963,1760,-219,-166,-53,382.4782608695652,46,48,-51,-20,1762,434,-1326,0
1,488,499,-11,-101,-69,-32,72.66666666666667,3,21,-44,7,-20,160,171,1
0,95,-310,405,-269,-595,326,162.13793103448276,29,344,-1,0,428,-274,-679,0
1,263,269,-6,-523,-424,-99,60.42857142857143,7,4,-14,-51,0,-73,-67,1
1,1575,893,682,-201,-166,-35,183.94444444444446,36,11,-13,0,681,1257,575,1
1,481,519,-38,-101,-52,-49,52.5,4,0,-27,-63,0,163,201,1
1,469,444,25,-227,-211,-16,262.8421052631579,19,3,-23,526,0,129,104,0
1,1055,689,366,-242,-310,68,362.0,10,63,0,-3,349,749,383,1
1,993,-712,1705,-196,-245,49,388.8181818181818,44,121,-4,-4,1736,681,-1024,0
1,1013,-285,1298,-211,-346,135,262.0,12,121,0,1623,-7,622,-676,0
0,677,-451,1128,250,91,159,323.3529411764706,34,64,0,0,1116,388,-740,0
1,188,-2,190,-476,-493,17,266.625,8,85,0,-5,188,-146,-336,0
0,37,554,-517,-486,-171,-315,260.5652173913044,23,0,-273,0,-543,-271,246,1
1,882,-262,1144,391,453,-62,389.6,15,52,-31,1720,-1,607,-537,0
0,1731,824,907,-167,-71,-96,272.90909090909093,33,66,-5,-6,931,1430,523,1
0,323,-438,761,-252,-132,-120,306.4,25,13,-37,0,782,19,-742,0
0,658,-822,1480,-222,-134,-88,343.72727272727275,44,81,-27,0,1515,298,-1182,0
1,2,35,-33,-500,-489,-11,151.0,3,0,-4,20,-35,-308,-275,0
1,1222,415,807,-179,-218,39,284.7142857142857,28,42,0,0,807,908,101,1
0,1911,911,1000,-230,-118,-112,257.4736842105263,38,72,-6,0,990,1609,609,1
1,885,-11,896,-219,-433,214,385.4375,32,305,0,0,1202,548,-348,0
0,879,-284,1163,-189,-301,112,377.1212121212121,33,249,0,0,1194,570,-593,0
0,225,-696,921,-463,-55,-408,273.0,36,1,-274,-1,948,-85,-1006,0
0,675,-810,1485,-206,-149,-57,368.9512195121951,41,69,-22,0,1521,320,-1165,0
1,1046,742,304,-205,-159,-46,214.14285714285714,14,0,-10,0,304,748,444,1
0,1269,-839,2108,-189,-161,-28,428.7959183673469,49,91,-33,0,2109,968,-1140,0
0,967,-250,1217,-176,-403,227,157.92857142857142,14,355,0,1428,0,652,-565,0
0,454,-393,847,-126,-149,23,55.5,2,103,0,887,-16,140,-707,0
1,233,-191,424,-554,-576,22,5.0,1,89,-8,431,-8,-73,-497,0
1,913,668,245,-136,-344,208,389.625,8,217,0,0,243,603,358,1
1,457,-873,1330,-215,-129,-86,348.2631578947368,38,32,-31,0,1321,163,-1167,0
0,938,-268,1206,-214,-310,96,397.8181818181818,33,236,0,0,1278,646,-560,0
0,874,-469,1343,-234,-227,-7,17.5,2,83,-10,1391,-3,593,-750,0
0,468,6,462,-193,-479,286,71.0,2,301,0,497,-2,187,-275,0
0,207,-2223,2430,-499,-25,-474,456.1666666666667,54,0,-368,0,2432,-85,-2515,0
1,5,816,-811,-277,-48,-229,282.9642857142857,28,11,-61,0,-807,-322,489,1
1,604,555,49,-154,-110,-44,35.0,1,9,-8,40,-18,288,239,1
0,1274,1310,-36,-156,-51,-105,251.6206896551724,29,127,-85,705,-32,984,1020,1
0,538,792,-254,-282,-77,-205,76.11764705882354,17,77,-187,-259,134,223,477,1
0,1181,414,767,-344,-225,-119,176.45238095238096,42,55,-102,0,763,866,99,1
0,653,707,-54,-209,-131,-78,192.34782608695653,23,103,-58,380,-61,363,417,1
0,164,-11,175,-560,-698,138,123.95652173913044,23,221,-11,-34,188,-151,-326,0
1,1098,394,704,-211,-86,-125,202.97142857142856,35,31,-8,0,714,822,118,1
0,847,289,558,-201,-401,200,236.68,25,296,0,-6,547,542,-16,1
0,521,-510,1031,-222,-96,-126,263.63157894736844,38,36,-30,0,1027,216,-815,0
1,664,-422,1086,-257,-211,-46,160.5,6,95,0,1186,0,337,-749,0
0,920,-11,931,-274,-526,252,414.5483870967742,31,266,0,0,1270,612,-319,0
1,1050,755,295,-193,-153,-40,264.8,10,45,-2,0,260,747,452,1
1,285,-414,699,-515,-546,31,435.6875,16,70,0,-4,684,-5,-704,0
0,469,-452,921,-105,-46,-59,277.52941176470586,34,144,0,-25,920,188,-733,0
0,874,832,42,-155,25,-180,44.0,1,0,-84,0,28,593,551,1
1,1071,-932,2003,-251,-140,-111,552.9444444444445,36,30,-43,0,2002,782,-1221,0
1,20,14,6,-769,-717,-52,49.5,2,26,-77,-60,5,-345,-351,1
1,433,-439,872,-88,-6,-82,277.7352941176471,34,132,-26,0,906,117,-755,0
0,581,-511,1092,-185,-70,-115,289.6923076923077,39,98,-59,-1,1140,265,-827,0
0,531,-696,1227,-202,-114,-88,279.75,44,69,-3,0,1231,231,-996,0
0,798,-497,1295,-188,-121,-67,304.6904761904762,42,76,0,-1,1291,505,-790,0
1,109,264,-155,-308,-338,30,333.17391304347825,23,26,-24,-142,798,-162,-7,0
1,476,444,32,-129,-103,-26,71.5,2,0,-39,-8,31,187,155,1
0,702,-464,1166,-229,-210,-19,262.95348837209303,43,58,-18,-4,1168,420,-746,0
0,720,-468,1188,-225,-136,-89,255.1086956521739,46,62,-23,-3,1178,476,-712,0
0,432,480,-48,-99,-2,-97,76.14285714285714,7,0,-64,0,-70,116,164,1
0,249,-453,702,-249,-171,-78,309.17391304347825,23,5,-21,0,729,-29,-731,0
1,1241,647,594,-222,-196,-26,266.0,22,4,-21,0,591,965,371,1
1,16,49,-33,-687,-745,58,95.33333333333333,6,92,-1,5,-67,-288,-255,1
0,1272,162,1110,-168,-377,209,281.475,40,355,0,0,1090,983,-127,1
0,530,-656,1186,-228,-87,-141,328.77777777777777,36,58,-51,0,1194,256,-930,0
0,717,-417,1134,-177,-142,-35,0.0,1,37,-16,1155,0,404,-730,0
1,683,-282,965,-262,-200,-62,500.3,20,58,-16,-20,963,401,-564,0
1,959,27,932,-196,-254,58,16.0,1,64,-9,932,0,694,-238,1
0,530,-402,932,-225,-82,-143,282.6969696969697,33,11,-23,0,947,245,-687,0
0,973,-220,1193,-136,-418,282,133.5,8,352,-2,1285,-6,681,-512,0
1,1029,815,214,-262,-429,167,252.0909090909091,11,178,-28,0,212,743,529,1
0,175,252,-77,-321,-489,168,187.05555555555554,18,219,-6,199,-62,-169,-92,0
0,979,553,426,282,68,214,349.0,26,96,-47,1323,0,617,191,0
0,287,564,-277,-16,153,-169,425.38461538461536,13,35,-99,-270,577,-36,241,0
1,488,-562,1050,-210,-100,-110,353.741935483871,31,64,-43,0,1070,198,-852,0
0,279,465,-186,-239,-150,-89,179.0,9,0,-64,0,-189,-18,168,1
0,498,15,483,-206,-479,273,190.6315789473684,19,293,-4,826,-4,197,-286,0
0,440,-378,818,-258,-303,45,285.0689655172414,29,58,0,0,838,92,-726,0
1,1079,-106,1185,-180,-309,129,530.695652173913,23,206,0,0,1195,801,-384,0
0,1143,-324,1467,-176,-543,367,358.9047619047619,42,373,0,0,1478,801,-666,0
0,769,629,140,-74,-69,-5,123.4,10,105,-8,-5,138,432,292,1
1,1354,-129,1483,-135,-283,148,455.28125,32,147,0,-3,1478,1017,-466,0
1,435,334,101,-194,-184,-10,246.66666666666666,21,24,-13,-22,513,57,-44,0
0,863,-945,1808,-236,-121,-115,371.5208333333333,48,74,-23,-1,1808,570,-1238,0
1,1482,199,1283,-107,-281,174,551.1666666666666,24,176,0,-8,1280,1186,-97,1
0,1256,689,567,-81,-69,-12,163.14705882352942,34,12,-28,0,574,949,382,1
1,1098,-377,1475,-161,-246,85,223.125,8,165,0,1643,0,772,-703,0
0,824,206,618,-184,-495,311,230.93103448275863,29,323,0,0,617,517,-101,1
1,502,372,130,-157,-199,42,131.85714285714286,7,33,0,0,129,228,98,1
1,475,272,203,-210,-205,-5,290.55555555555554,18,42,-17,-1,545,99,-104,0
0,426,-458,884,-227,-145,-82,351.4,25,10,-87,0,890,96,-788,0
0,493,-481,974,-193,-107,-86,289.1470588235294,34,59,-21,-2,989,165,-809,0
1,247,-163,410,-519,-594,75,359.9166666666667,12,75,-3,-2,417,-52,-462,0
1,776,288,488,-172,-301,129,371.69444444444446,36,141,0,0,887,458,-30,0
0,1292,1260,32,-33,-53,20,143.92857142857142,14,55,0,-3,204,999,967,1
0,644,378,266,-279,-217,-62,149.41176470588235,17,0,-65,0,266,161,-105,1
0,269,-265,534,-485,-390,-95,206.0,28,100,-25,-25,540,-49,-583,0
0,519,-431,950,-171,-53,-118,297.6829268292683,41,100,-19,0,1234,201,-749,0
0,265,468,-203,-265,-183,-82,303.6,15,16,-84,-219,469,-54,149,0
1,268,-412,680,-178,-89,-89,57.5,4,129,-87,720,-1,-45,-725,0
1,536,303,233,-227,-259,32,308.375,8,37,-1,-6,234,217,-16,1
0,843,-952,1795,-221,-165,-56,379.7659574468085,47,65,-60,0,1795,539,-1256,0
0,6,-214,220,-761,-505,-256,87.5,20,0,-338,0,228,-310,-530,0
0,1276,1235,41,-88,-112,24,111.32142857142857,28,169,0,0,348,960,919,1
0,475,-481,956,-163,-137,-26,286.8529411764706,34,82,-14,0,971,164,-792,0
1,597,358,239,-230,-227,-3,430.5,22,12,-50,1179,-10,273,34,0
0,228,-1474,1702,-258,-35,-223,451.7567567567568,37,3,-132,0,1709,-72,-1774,0
0,13,-165,178,-664,-424,-240,157.71428571428572,14,2,-219,0,194,-283,-461,0
0,509,-471,980,-82,-93,11,51.0,4,210,-18,1012,-8,211,-769,0
1,1173,439,734,-196,-258,62,400.05263157894734,19,64,-4,-20,732,847,113,1
1,187,-251,438,-491,-543,52,16.5,2,100,-5,444,-25,-122,-560,0
1,207,-219,426,-463,-452,-11,206.33333333333334,21,91,0,-3,417,-103,-529,0
0,222,-909,1131,-506,-210,-296,262.09302325581393,43,0,-279,0,1102,-30,-1161,0
0,250,-262,512,-512,-499,-13,201.04,25,26,-14,0,517,-70,-582,0
0,533,189,344,-166,-472,306,163.07142857142858,28,319,0,-8,384,255,-89,1
1,593,344,249,-202,-252,50,407.2857142857143,28,53,-5,-142,746,274,25,0
0,207,-169,376,-458,-425,-33,145.60714285714286,28,67,-27,-4,389,-84,-460,0
1,627,-67,694,-155,-192,37,376.63157894736844,19,90,0,-6,700,283,-411,0
1,949,487,462,-143,-224,81,376.0769230769231,13,81,-3,-3,464,635,173,1
0,1148,1104,44,-189,-150,-39,246.93103448275863,29,96,-25,758,0,853,809,1
0,484,-569,1053,-190,-124,-66,261.9,40,64,-14,0,1075,171,-882,0
0,476,-379,855,-197,-276,79,257.90909090909093,33,81,0,0,868,136,-719,0
0,160,483,-323,-236,-146,-90,191.94117647058823,17,0,-92,0,-331,-139,184,1
1,1175,455,720,-104,-141,37,226.0,32,91,0,0,729,849,129,1
0,658,617,41,-181,-193,12,76.29230769230769,65,199,-2,-176,314,385,344,1
1,864,-84,948,-219,-298,79,471.45,20,83,0,0,948,560,-388,0
0,497,615,-118,-203,-162,-41,88.83333333333333,12,8,-42,0,-137,187,305,1
0,565,-484,1049,-179,-166,-13,318.8787878787879,33,77,-14,0,1067,239,-810,0
1,241,-257,498,-566,-617,51,387.46153846153845,13,47,-3,-2,497,-83,-581,0
0,738,373,365,-240,-278,38,104.3225806451613,31,52,0,0,365,432,67,1
1,520,117,403,-227,-261,34,269.54545454545456,22,45,-4,-16,579,150,-253,0
0,243,210,33,-605,-543,-62,95.6875,16,0,-300,178,0,-30,-63,1
0,833,811,22,-68,-73,5,119.84615384615384,26,78,-3,-7,301,533,511,1
0,260,225,35,-512,-461,-51,129.04545454545453,22,0,-332,0,202,-40,-75,1
1,520,459,61,-168,-211,43,186.25,4,44,-2,-9,66,220,159,1
0,773,744,29,-150,-141,-9,142.28571428571428,14,84,-9,0,212,464,435,1
0,234,187,47,-585,-559,-26,99.66666666666667,12,27,-327,183,0,-58,-105,1
0,465,-490,955,-203,-145,-58,273.14285714285717,35,64,-57,0,957,162,-793,0
1,1028,821,207,-191,-239,48,147.30769230769232,13,55,0,0,205,704,497,1
1,242,-86,328,-564,-616,52,315.09090909090907,11,51,-45,0,336,-59,-387,0
1,343,-924,1267,-309,-334,25,212.4375,16,40,-157,1263,-345,57,-1210,0
0,1848,490,1358,-163,-169,6,350.87179487179486,39,53,-6,0,1375,1517,159,1
0,1332,848,484,-235,-182,-53,153.73333333333332,30,0,-33,0,483,1016,532,1
0,255,1184,-929,-289,-177,-112,339.3703703703704,27,0,-110,0,-937,-66,863,1
0,18,-186,204,-707,-486,-221,149.47058823529412,17,11,-288,-24,201,-284,-488,0
1,275,-604,879,-501,-676,175,422.0,21,174,-22,-5,879,-28,-907,0
1,6,-80,86,-764,-588,-176,302.6,10,0,-177,-220,81,-309,-395,0
0,472,-508,980,-136,-147,11,283.77142857142854,35,145,0,0,978,157,-823,0
0,1,577,-576,-478,-212,-266,239.48,25,2,-279,0,-581,-424,152,1
0,92,2017,-1925,-510,-91,-419,376.1923076923077,52,0,-369,3,-1944,-244,1681,1
0,1178,-1589,2767,-203,-124,-79,478.969696969697,66,128,-80,-1,3164,892,-1875,0
0,783,569,214,-235,-256,21,121.38461538461539,13,22,0,0,216,480,266,1
1,910,98,812,-229,-296,67,434.4736842105263,19,35,-1,-14,798,602,-210,1
1,833,200,633,-256,-379,123,426.8666666666667,15,108,-4,0,636,548,-85,1
0,692,-438,1130,-252,-199,-53,303.5,38,57,-64,0,1156,241,-889,0
1,590,48,542,-178,-507,329,311.9047619047619,21,340,0,-1,587,139,-403,1
1,577,-531,1108,-227,8,-235,262.5121951219512,41,22,-38,0,1085,282,-826,0
1,238,-88,326,-513,-554,41,364.7,10,139,-4,-1,319,-78,-404,0
1,1101,417,684,-222,-216,-6,254.07407407407408,27,31,-6,0,693,805,121,1
0,386,-457,843,-264,-205,-59,269.4516129032258,31,37,-57,0,847,84,-759,0
0,426,-490,916,-194,-195,1,276.3030303030303,33,107,-1,-1,931,142,-774,0
0,204,-154,358,-496,-571,75,61.0,1,80,0,389,-5,-138,-496,0
1,244,300,-56,-477,-292,-185,73.25,4,0,-9,0,-39,-95,-39,1
0,540,959,-419,-222,-136,-86,234.66666666666666,18,0,-116,0,-439,225,644,1
0,585,-928,1513,-242,-163,-79,351.09302325581393,43,35,-83,0,1521,304,-1209,0
0,873,-461,1334,-233,-239,6,313.09302325581393,43,83,0,0,1348,556,-778,0
0,275,-830,1105,-268,-194,-74,319.38235294117646,34,1,-75,0,1109,-13,-1118,0
1,201,249,-48,-449,-314,-135,272.2857142857143,14,0,-219,-408,0,-101,-53,1
1,665,-300,965,-206,-264,58,472.95238095238096,21,65,0,-8,969,357,-608,0
0,222,235,-13,-534,-531,-3,73.70370370370371,27,9,-121,-21,261,-85,-72,0
0,1540,1446,94,-158,-203,45,99.7843137254902,51,202,-18,0,494,1233,1139,1
0,1055,1070,-15,-90,-102,12,104.2127659574468,47,208,0,357,-103,764,779,1
0,1883,1826,57,-75,-62,-13,159.98461538461538,65,279,-25,1059,-2,1592,1535,1
0,184,420,-236,-286,-134,-152,197.85714285714286,14,0,-85,0,-297,-132,104,1
0,1390,684,706,-229,-172,-57,190.6216216216216,37,6,-61,0,708,1065,359,1
1,608,116,492,-232,-257,25,269.5925925925926,27,47,-9,0,761,235,-257,0
1,544,500,44,-170,-199,29,125.0,4,31,-1,-10,42,232,188,1
1,723,-624,1347,-253,-239,-14,366.3243243243243,37,66,-12,-3,1355,409,-938,0
0,796,-459,1255,-262,-220,-42,274.3695652173913,46,88,-39,-6,1259,502,-753,0
0,583,-408,991,-226,-274,48,282.2857142857143,35,53,-3,0,997,276,-715,0
0,755,-819,1574,-211,-210,-1,369.30232558139534,43,130,-4,0,1570,457,-1117,0
0,1163,409,754,-183,-193,10,188.25641025641025,39,64,0,-1,752,854,100,1
1,1139,-1549,2688,-169,-168,-1,460.8235294117647,68,139,-23,-3,3129,859,-1829,0
0,1210,2156,-946,-341,-161,-180,303.1,30,0,-191,0,-945,876,1822,1
0,710,-895,1605,-196,-226,30,326.8979591836735,49,100,0,-6,1608,401,-1204,0
1,729,-416,1145,-208,-239,31,306.0810810810811,37,70,0,-5,1137,440,-705,0
0,728,-418,1146,-191,-244,53,209.8148148148148,54,59,0,0,1150,450,-696,0
1,610,-16,626,-246,-199,-47,259.15384615384613,26,33,-60,0,696,418,-208,0
0,1207,428,779,-237,-196,-41,247.96774193548387,31,0,-51,0,779,916,137,1
1,1228,589,639,-212,-332,120,426.0,15,127,-6,0,640,916,277,1
0,34,256,-222,-842,-546,-296,126.18181818181819,22,0,-305,5,-249,-315,-93,1
1,751,-572,1323,-204,-308,104,398.97435897435895,39,168,0,0,1530,420,-903,0
1,954,489,465,-259,-293,34,385.0833333333333,12,39,-8,0,468,664,199,1
1,1119,572,547,-212,-358,146,426.53846153846155,13,139,0,0,546,807,260,1
0,40,507,-467,-267,-276,9,242.8421052631579,19,8,-18,0,-484,-342,125,1
0,204,250,-46,-479,-529,50,201.0909090909091,22,58,-387,163,-46,-136,-90,1
0,1399,477,922,-173,-235,62,296.2258064516129,31,62,0,0,931,1092,170,1
1,717,80,637,-225,-257,32,423.1333333333333,15,79,0,-1,641,389,-248,1
1,728,-218,946,-288,-312,24,414.0869565217391,23,11,-25,-9,950,434,-512,0
1,767,359,408,-388,-628,240,364.92857142857144,14,295,0,0,400,491,83,1
1,1254,623,631,-245,-348,103,425.2,15,103,-6,0,623,968,337,1
1,749,400,349,-196,-272,76,380.2,10,127,-2,-6,349,457,108,1
0,419,382,37,-271,-258,-13,190.16666666666666,6,0,-17,0,120,26,-11,1
1,765,509,256,-220,-313,93,288.8,10,91,-1,-6,262,459,203,1
0,878,204,674,-222,-576,354,241.90625,32,357,-18,0,689,595,-79,1
0,1540,220,1320,-133,-576,443,87.1875,16,447,0,1449,0,1217,-103,1
0,252,-221,473,-551,-512,-39,162.27777777777777,18,43,-369,474,-3,-88,-561,0
0,998,1174,-176,-157,-166,9,116.42857142857143,7,63,0,-186,90,696,872,1
0,1438,302,1136,-279,-519,240,275.1666666666667,42,249,0,0,1144,1132,-4,1
0,13,445,-432,-290,-243,-47,222.55555555555554,18,0,-47,0,-432,-307,125,1
0,26,-603,629,-289,-271,-18,55.714285714285715,7,0,-57,688,0,-330,-959,0
1,1179,704,475,-229,-286,57,430.72727272727275,11,64,0,0,477,878,403,1
1,1443,1238,205,-233,-214,-19,253.625,8,1,-19,0,204,1138,933,1
1,867,596,271,-217,-269,52,122.95238095238095,21,48,-5,-1,272,608,337,1
1,878,128,750,-223,-306,83,425.1111111111111,18,80,-1,-2,749,575,-175,1
0,34,590,-556,-473,-180,-293,272.2173913043478,23,0,-293,0,-568,-297,259,1
0,1194,590,604,-270,-242,-28,108.3157894736842,19,36,-14,801,0,856,252,1
0,16,1729,-1713,-705,-238,-467,382.6304347826087,46,1,-505,0,-1720,-325,1388,0
0,1156,897,259,-190,-178,-12,142.06666666666666,15,48,0,489,0,805,546,1
0,8,-1278,1286,-283,-185,-98,338.02702702702703,37,4,-103,0,1295,-286,-1572,0
0,497,-512,1009,-307,-188,-119,234.72093023255815,43,0,-119,-4,1014,240,-769,0
0,121,-497,618,-141,39,-180,276.8095238095238,21,18,0,0,601,-126,-744,0
0,695,478,217,-243,-270,27,157.07142857142858,14,41,0,427,-2,222,5,1
0,508,-400,908,-187,-189,2,9.5,2,59,-5,923,0,175,-733,0
1,887,-375,1262,-306,-337,31,472.5925925925926,27,33,0,-10,1261,617,-645,0
0,261,249,12,-546,-513,-33,73.75,16,3,-107,147,-4,-91,-103,1
0,378,-458,836,-231,-238,7,292.7241379310345,29,0,-13,0,854,78,-758,0
0,1242,387,855,-258,-181,-77,274.96774193548384,31,3,-72,0,864,972,117,1
1,821,603,218,-268,-345,77,358.8235294117647,17,77,-3,812,-1,493,275,1
1,1013,-628,1641,-279,-305,26,390.8809523809524,42,43,0,0,1641,713,-928,0
1,736,5,731,-282,-340,58,432.6470588235294,17,52,0,-2,734,450,-281,1
1,883,527,356,-214,-335,121,345.90909090909093,11,124,0,0,355,589,233,1
0,9,370,-361,-249,-211,-38,11.0,1,0,-39,-383,0,-264,97,1
0,439,-433,872,-199,-202,3,310.57142857142856,28,31,-3,0,880,140,-732,0
1,1282,580,702,-221,-340,119,451.875,16,118,0,0,703,1024,322,1
0,1494,428,1066,-248,-249,1,291.3888888888889,36,0,-39,0,1061,1201,135,1
0,928,-1074,2002,-242,-184,-58,430.7826086956522,46,20,-65,-8,2000,636,-1366,0
0,227,189,38,-454,-433,-21,133.07692307692307,13,20,-173,0,152,-68,-106,1
0,1942,842,1100,-217,-178,-39,301.64864864864865,37,23,-29,0,1127,1625,525,1
0,1046,-1158,2204,-247,-180,-67,444.61224489795916,49,45,-81,0,2198,722,-1482,0
0,1239,487,752,-184,-143,-41,364.15,20,24,0,0,756,965,213,1
0,1337,503,834,-164,-69,-95,70.0,1,38,0,846,0,1030,196,1
1,543,-131,674,-365,-256,-109,377.3888888888889,18,1,-8,-4,684,299,-375,0
1,932,-431,1363,-195,-269,74,629.4090909090909,22,75,0,-7,1367,637,-726,0
1,924,-102,1026,-212,-186,-26,547.2631578947369,19,47,0,0,1028,642,-384,0
0,282,-681,963,-590,-227,-363,277.7567567567568,37,0,-358,0,966,-20,-983,0
0,1143,483,660,-150,-158,8,324.23809523809524,21,14,-15,0,697,844,184,1
0,426,-624,1050,-221,-138,-83,268.02564102564105,39,35,-90,0,1053,126,-924,0
0,155,-270,425,-619,-504,-115,144.72413793103448,29,8,-127,-4,423,-145,-570,0
1,1546,954,592,-184,-125,-59,262.1304347826087,23,27,-18,-14,590,1240,648,1
1,1880,1650,230,-133,-178,45,215.45454545454547,11,45,-2,-8,229,1565,1335,1
1,220,-323,543,-536,-489,-47,223.48,25,35,-46,0,544,-89,-632,0
0,1293,456,837,-225,-182,-43,303.6666666666667,27,0,-38,0,840,986,149,1
1,992,-415,1407,262,48,214,520.0,27,17,-29,0,1407,720,-687,0
0,1142,503,639,-241,-153,-88,218.75862068965517,29,24,-88,0,640,816,177,1
1,975,690,285,-185,-293,108,311.8,10,108,-6,-5,286,649,364,1
0,746,-621,1367,-223,-125,-98,416.02941176470586,34,124,-103,0,1375,456,-911,0
1,453,114,339,-191,-258,67,292.53846153846155,13,60,-18,-8,370,116,-223,1
1,77,-262,339,-623,-588,-35,205.0625,16,6,-35,0,339,-221,-560,0
1,954,-208,1162,-164,-357,193,567.7619047619048,21,204,0,-7,1166,646,-516,0
0,251,409,-158,-492,-283,-209,175.07142857142858,14,0,-210,0,-158,-35,123,1
1,1851,1245,606,-182,-177,-5,226.65384615384616,26,33,-7,0,610,1547,941,1
1,718,146,572,-152,-322,170,301.6666666666667,33,175,0,-8,900,424,-148,0
0,615,494,121,-173,-155,-18,153.625,8,0,-15,0,141,304,183,1
0,54,-993,1047,-290,-181,-109,423.375,24,0,-109,0,1047,-266,-1313,0
1,454,394,60,-205,-198,-7,129.75,4,1,-7,0,60,134,74,1
1,176,-702,878,-580,-567,-13,467.63157894736844,19,7,-6,0,878,-145,-1023,0
0,339,210,129,-485,-461,-24,66.85714285714286,7,5,-71,204,-3,35,-94,1
0,1523,542,981,-233,-200,-33,254.92307692307693,39,43,-27,0,1008,1201,220,1
0,978,-1991,2969,-174,-216,42,378.5,78,127,0,-1,2980,674,-2295,0
0,763,-1311,2074,-214,-267,53,496.0975609756098,41,76,0,0,2072,481,-1593,0
0,15,18,-3,-699,-676,-23,8.0,1,4,-253,28,-7,-323,-320,0
1,1864,-133,1997,-174,-235,61,543.0540540540541,37,90,-1,0,2009,1569,-428,0
0,1389,480,909,-130,-152,22,47.0,3,39,-1,952,0,1083,174,1
0,1622,482,1140,-173,-163,-10,299.4102564102564,39,48,-40,0,1166,1312,172,1
1,1010,-298,1308,-191,-825,634,444.75,36,633,0,-3,1552,688,-620,0
1,874,-431,1305,-265,-565,300,390.4102564102564,39,325,0,0,1520,570,-735,0
0,273,-781,1054,-349,-282,-67,314.7878787878788,33,7,-75,0,1060,-43,-1097,0
1,1166,693,473,-248,-270,22,370.6923076923077,13,16,-7,-10,468,851,378,1
0,1037,496,541,-187,-183,-4,61.5,2,5,-26,545,-27,718,177,1
0,1865,490,1375,-162,-155,-7,396.42857142857144,35,17,-36,0,1397,1544,169,1
0,1592,460,1132,-278,-163,-115,315.1666666666667,36,0,-125,0,1135,1277,145,1
1,877,-534,1411,-179,-234,55,570.8,25,69,0,-10,1411,575,-836,0
1,376,-89,465,-265,-462,197,180.3793103448276,29,215,-4,0,480,94,-371,0
1,919,-817,1736,-161,-270,109,486.6111111111111,36,121,-3,-6,1734,620,-1116,0
0,1938,496,1442,-186,-153,-33,337.6190476190476,42,0,-50,0,1442,1623,181,1
1,869,259,610,-114,-177,63,422.93333333333334,15,5,-24,-6,624,575,-35,1
1,887,68,819,-171,-457,286,154.21052631578948,19,294,-9,1104,-1,601,-218,0
1,859,21,838,-206,-455,249,360.7241379310345,29,255,0,0,1020,560,-278,0
1,826,55,771,-248,-471,223,138.33333333333334,18,225,0,990,0,510,-261,0
1,796,194,602,-182,-318,136,315.82758620689657,29,136,0,-10,915,493,-109,0
0,436,1061,-625,-283,-144,-139,259.3333333333333,36,0,-86,319,-617,113,738,1
1,1045,767,278,-158,-277,119,278.27272727272725,11,111,-1,0,293,746,468,1
0,1317,255,1062,-188,-593,405,296.63157894736844,38,399,0,0,1070,1041,-21,1
1,973,753,220,-145,-205,60,301.7142857142857,7,57,-6,0,226,648,428,1
0,470,-446,916,-203,-156,-47,301.7741935483871,31,45,-50,-3,942,145,-771,0
1,609,270,339,-185,-256,71,252.66666666666666,12,83,-28,0,354,279,-60,1
1,553,149,404,-103,-265,162,378.75,12,163,-3,-15,402,238,-166,1
0,883,-1027,1910,-220,-195,-25,397.125,48,70,-20,-1,1912,623,-1287,0
1,536,-386,922,-73,-119,46,477.2,20,75,0,0,927,232,-690,0
1,1399,714,685,-237,-357,120,475.0,15,118,-1,-23,685,1125,440,1
1,599,622,-23,-206,-184,-22,186.4,30,52,-26,505,-21,273,296,1
0,453,-468,921,-190,-218,28,254.1578947368421,38,53,0,0,968,124,-797,0
0,474,-191,665,-167,-369,202,260.2142857142857,28,250,-13,-11,690,201,-464,0
0,686,-581,1267,-146,-156,10,289.52272727272725,44,77,-26,0,1297,344,-923,0
1,411,160,251,-229,-276,47,92.5,4,47,-125,249,-52,93,-158,1
0,170,-2012,2182,-512,-175,-337,444.06,50,6,-320,-31,2185,-160,-2342,0
0,699,-452,1151,-261,-164,-97,309.8421052631579,38,91,-92,-10,1161,406,-745,0
1,1152,1093,59,-200,-219,19,277.84615384615387,13,78,-3,404,-1,838,779,1
1,1035,-885,1920,-198,-205,7,441.4318181818182,44,125,0,-8,1920,716,-1204,0
1,999,-300,1299,-213,-302,89,519.24,25,89,-1,-7,1299,725,-574,0
1,603,-520,1123,-295,-275,-20,320.7435897435897,39,15,-20,0,1295,321,-802,0
0,613,-482,1095,-191,-160,-31,296.43589743589746,39,29,-32,0,1136,295,-800,0
0,3,552,-549,-509,-157,-352,211.19354838709677,31,0,-354,0,-550,-331,218,1
1,503,215,288,-196,-234,38,211.35714285714286,14,36,-20,0,289,178,-110,1
1,250,-447,697,-535,-609,74,380.89473684210526,19,68,-18,-26,699,-65,-762,0
0,1022,484,538,-293,-209,-84,215.96296296296296,27,14,-93,0,565,752,214,1
1,411,-1418,1829,-250,-224,-26,476.2307692307692,39,67,-5,0,1868,144,-1685,0
1,906,-553,1459,-277,-203,-74,524.3571428571429,28,1,-58,0,1460,588,-871,0
1,1652,1152,500,-177,-204,27,202.25,24,35,0,0,499,1396,896,1
1,943,-67,1010,-148,-295,147,448.8695652173913,23,164,0,0,1011,642,-368,0
1,1816,888,928,-99,-271,172,444.3809523809524,21,213,-8,0,912,1518,590,1
1,246,-581,827,-496,-663,167,419.4,20,169,0,-1,828,-68,-895,0
1,537,-374,911,-266,-277,11,420.1818181818182,22,72,0,0,923,267,-644,0
0,1141,568,573,-177,-177,0,139.4390243902439,41,8,-31,0,578,872,299,1
0,1855,217,1638,-258,-573,315,302.4193548387097,62,341,-27,0,1748,1590,-48,1
1,1122,583,539,-171,-262,91,433.53846153846155,13,91,0,0,540,798,259,1
1,435,141,294,-154,-230,76,252.0,13,78,-9,-23,296,111,-183,1
1,1062,473,589,-227,-309,82,30.0,1,78,-7,589,-17,708,119,1
0,2081,1059,1022,-215,-228,13,271.6756756756757,37,52,-1,0,1012,1766,744,1
1,431,-485,916,-109,-114,5,24.0,1,136,0,912,-26,151,-765,0
0,152,521,-369,-305,-183,-122,213.66666666666666,18,0,-122,0,-377,-153,216,1
0,556,427,129,-220,-240,20,268.04761904761904,21,71,-3,-5,586,298,169,0
0,481,447,34,-210,-182,-28,51.875,8,1,-45,-4,43,152,118,1
1,787,-839,1626,-162,-194,32,361.0444444444444,45,98,0,0,1624,469,-1157,0
1,459,161,298,-163,-239,76,278.27272727272725,11,93,0,0,294,142,-156,1
1,1845,1178,667,-137,-190,53,262.0769230769231,26,74,0,0,667,1536,869,1
1,910,-250,1160,-199,-294,95,515.304347826087,23,112,0,-10,1165,646,-514,0
0,203,-452,655,-397,-185,-212,16.0,4,2,-220,664,-2,-97,-752,0
1,499,431,68,-248,-218,-30,42.5,6,4,-33,-16,61,207,139,1
1,1052,573,479,-160,-260,100,420.8333333333333,12,100,-5,-12,480,733,254,1
1,1052,365,687,-243,-353,110,414.2352941176471,17,107,-1,0,689,728,41,1
0,496,325,171,-201,-339,138,113.46153846153847,13,181,0,-1,180,190,19,1
0,1800,1342,458,-58,-58,0,122.97297297297297,37,72,-6,0,456,1528,1070,1
0,1058,769,289,-69,-33,-36,141.52631578947367,19,38,-2,-9,293,786,497,1
0,554,-483,1037,-318,-193,-125,305.65714285714284,35,6,-89,-2,1065,293,-744,0
0,487,-470,957,-186,-7,-179,242.15,40,97,-170,0,959,200,-757,0
0,455,399,56,-260,-195,-65,223.80769230769232,26,36,-78,-9,568,183,127,0
0,1692,250,1442,-355,-584,229,383.02564102564105,39,241,-15,0,1453,1415,-27,1
0,1373,-614,1987,-195,-126,-69,393.05882352941177,51,149,0,0,1997,1050,-937,0
0,307,494,-187,-331,-122,-209,1.0,1,0,-141,-183,0,-16,171,1
1,523,-604,1127,-210,-255,45,345.06060606060606,33,75,-1,0,1135,193,-934,0
1,1078,-832,1910,-207,-251,44,478.725,40,61,-13,0,1914,756,-1154,0
0,1389,459,930,-188,-188,0,273.5833333333333,36,134,0,0,965,1075,145,1
1,492,-1363,1855,-220,-129,-91,411.44444444444446,45,61,-27,0,1848,173,-1682,0
1,555,-254,809,290,14,276,383.1363636363636,22,64,-3,-9,825,261,-548,0
0,504,-452,956,-241,-205,-36,276.52941176470586,34,37,-2,0,965,162,-794,0
0,502,1383,-881,-282,-123,-159,7.0,1,0,-163,-881,0,176,1057,1
0,718,-242,960,-246,-354,108,304.57575757575756,33,277,-16,-4,950,415,-545,0
0,315,-562,877,-197,-118,-79,319.5,28,37,-61,0,906,-18,-895,0
0,1709,684,1025,-127,-173,46,161.33333333333334,63,99,0,0,1029,1413,388,1
1,880,-202,1082,-154,-275,121,337.6875,32,126,-4,-3,1089,562,-520,0
0,593,508,85,-91,-90,-1,29.333333333333332,3,13,-12,89,-67,281,196,1
0,456,360,96,-285,-332,47,66.33333333333333,9,45,-9,151,-24,151,55,1
1,214,3,211,-511,-509,-2,119.26315789473684,19,22,-44,-19,225,-74,-285,1
0,734,-1178,1912,-198,-69,-129,334.91525423728814,59,170,-130,-4,1921,454,-1458,0
0,447,-778,1225,-80,-164,84,254.9607843137255,51,277,0,0,1256,167,-1058,0
0,34,2074,-2040,-785,-181,-604,491.6621621621622,74,0,-597,1574,-2056,-273,1767,0
0,23,955,-932,-559,-214,-345,61.9375,16,14,-350,-1057,15,-257,675,1
1,721,349,372,-210,-264,54,334.5833333333333,12,53,0,-16,377,388,16,1
1,495,488,7,-108,-76,-32,48.0,3,0,-33,20,-31,180,173,1
0,631,-1287,1918,-210,-111,-99,395.75,48,31,-70,0,1916,321,-1597,0
0,655,-499,1154,-228,-147,-81,34.6,5,33,-83,1154,-16,355,-799,0
1,1419,713,706,-238,-176,-62,306.2608695652174,23,12,-51,0,700,1103,397,1
1,567,481,86,-211,-318,107,324.0,22,115,0,0,744,279,193,0
0,41,495,-454,-285,-101,-184,253.44444444444446,18,0,-174,0,-450,-306,148,1
1,1457,878,579,-276,-190,-86,214.96153846153845,26,8,-69,0,575,1172,593,1
1,1822,1506,316,-234,-219,-15,215.46666666666667,15,5,-17,0,323,1504,1188,1
0,565,526,39,-111,-72,-39,48.75,8,16,-30,-28,55,240,201,1
1,933,-1041,1974,-204,-243,39,434.15555555555557,45,64,-2,-5,1976,619,-1355,0
1,283,-237,520,-549,-580,31,233.22727272727272,22,62,0,-5,515,-31,-551,0
0,1468,704,764,-178,-131,-47,205.02702702702703,37,44,-16,0,771,1154,390,1
0,481,852,-371,-257,-206,-51,239.45833333333334,24,61,-43,-370,587,183,554,0
0,1173,711,462,-84,-146,62,178.0,25,84,0,0,469,877,415,1
0,1236,1968,-732,-237,-176,-61,266.18518518518516,27,15,-63,0,-740,916,1648,1
0,203,1039,-836,-512,-176,-336,334.25925925925924,27,16,-329,0,-836,-114,722,1
0,354,474,-120,-286,-288,2,45.5,2,13,-15,-143,0,42,162,1
0,675,530,145,-163,-209,46,113.46153846153847,13,51,-13,-7,148,362,217,1
0,1041,-1179,2220,-188,-249,61,408.6181818181818,55,151,0,0,2234,728,-1492,0
1,1072,518,554,-202,-316,114,382.73333333333335,15,110,-2,0,555,764,210,1
1,883,321,562,-241,-266,25,425.61538461538464,13,23,-5,0,558,557,-5,1
1,1400,526,874,-168,-189,21,313.8888888888889,27,48,-3,0,879,1095,221,1
0,1309,-2,1311,-302,-754,452,329.7142857142857,42,462,0,0,1319,1004,-307,0
0,1250,-739,1989,-217,-231,14,414.9166666666667,48,120,0,-1,1994,968,-1021,0
0,462,-407,869,-214,-215,1,62.5,2,1,-54,872,0,152,-717,0
0,1392,522,870,-244,-193,-51,66.0,1,1,-51,873,-13,1010,140,1
0,764,-1090,1854,-184,-154,-30,435.3333333333333,42,41,-34,-3,1843,458,-1396,0
1,635,-488,1123,-232,-258,26,420.0,10,59,-3,1519,0,333,-790,0
1,771,111,660,-125,-256,131,472.42857142857144,14,109,0,-6,639,438,-222,1
0,204,174,30,-478,-459,-19,148.8181818181818,11,16,-210,0,116,-82,-112,1
0,662,-1009,1671,-194,-156,-38,345.7916666666667,48,63,-38,-6,1661,376,-1295,0
1,472,478,-6,-87,-107,20,67.16666666666667,12,23,-31,-94,5,151,157,1
1,832,242,590,-177,-768,591,471.3,10,559,-3,980,-3,502,-88,0
0,157,-735,892,-495,-233,-262,258.8285714285714,35,0,-267,0,890,-208,-1100,0
1,192,-371,563,-561,-571,10,417.0,14,26,-13,-20,557,-135,-698,0
0,469,-619,1088,-246,-188,-58,327.8857142857143,35,23,-61,0,1114,208,-880,0
1,816,-902,1718,-193,-203,10,327.8679245283019,53,121,0,-3,1725,530,-1188,0
0,556,249,307,-228,-274,46,158.76470588235293,17,47,-3,-5,299,363,56,1
1,891,-155,1046,-167,-597,430,431.44444444444446,27,430,-4,-3,1061,562,-484,0
1,1450,515,935,-186,-193,7,286.15625,32,38,-7,0,924,1052,117,1
1,764,-128,892,-226,-323,97,488.10526315789474,19,96,-3,-1,897,503,-389,0
1,790,192,598,-238,-219,-19,400.8,15,54,0,0,601,516,-82,1
0,947,-231,1178,-296,-459,163,297.1951219512195,41,266,0,0,1204,634,-544,0
0,1560,270,1290,-157,-441,284,20.0,1,357,0,1304,0,1272,-18,1
1,561,558,3,-181,-244,63,249.5909090909091,22,96,-18,-14,536,279,276,1
1,1582,908,674,-124,-198,74,429.6875,16,70,0,0,676,1272,598,1
1,1901,1118,783,-171,-118,-53,299.1923076923077,26,26,-2,0,791,1614,831,1
1,786,365,421,-201,-305,104,358.7692307692308,13,95,0,-13,433,527,106,1
0,1204,-14,1218,-184,-781,597,343.71794871794873,39,595,-1,0,1216,901,-317,0
0,293,878,-585,-490,-176,-314,287.9583333333333,24,4,-319,0,-596,-25,560,1
1,559,420,139,-225,-271,46,217.0,7,46,-1,-11,139,235,96,1
1,535,398,137,-73,-121,48,167.57894736842104,19,95,-3,425,-1,216,79,1
1,927,-342,1269,-268,-302,34,410.80645161290323,31,50,-18,-1,1299,647,-622,0
0,504,-441,945,59,-42,101,86.0,1,152,-4,976,-8,161,-784,0
1,1112,505,607,-195,-327,132,410.625,16,201,0,-12,600,811,204,1
1,656,-500,1156,-180,-135,-45,311.5,40,128,-11,-1,1217,329,-827,0
0,1594,534,1060,-269,-19,-250,325.0,33,0,-93,0,1078,1274,214,1
1,1778,1250,528,-126,16,-142,197.88888888888889,27,36,-26,0,538,1482,954,1
0,1373,586,787,-205,-77,-128,253.0,30,8,-20,0,782,1061,274,1
1,759,-211,970,-194,-262,68,513.95,20,114,0,0,1000,462,-508,0
0,216,-1260,1476,-522,-42,-480,368.8780487804878,41,0,-360,0,1480,-108,-1584,0
1,1015,504,511,-210,-213,3,394.85714285714283,14,119,-8,0,529,713,202,1
1,264,639,-375,-546,-585,39,337.72727272727275,11,35,-1,3,-379,-32,343,1
0,607,-498,1105,-149,150,-299,41.0,1,189,-11,1158,-1,236,-869,0
1,964,-834,1798,-60,53,-113,526.0588235294117,34,245,-8,-6,1773,736,-1062,0
1,731,418,313,-216,-255,39,120.46666666666667,15,78,-7,487,-1,428,115,1
1,455,60,395,-284,-280,-4,303.46153846153845,13,7,0,0,396,215,-180,1
0,872,-618,1490,-238,-152,-86,336.29545454545456,44,45,-36,0,1486,592,-898,0
1,1172,545,627,-232,-254,22,397.0625,16,20,-9,0,629,862,235,1
0,766,-738,1504,-178,-181,3,326.4782608695652,46,125,-6,0,1502,453,-1051,0
1,956,389,567,-167,-295,128,395.26666666666665,15,125,-14,0,563,643,76,1
0,474,-612,1086,-231,-122,-109,61.0,1,8,-34,1060,-3,224,-862,0
0,1288,493,795,-167,-161,-6,269.3333333333333,30,81,-5,0,805,1006,211,1
1,278,656,-378,-467,-253,-214,208.25,20,1,-213,3,-377,-39,339,1
0,722,-364,1086,-193,-275,82,51.0,2,90,0,1115,0,436,-650,0
0,1426,862,564,-165,-157,-8,180.46666666666667,30,5,-9,0,564,1134,570,1
1,850,364,486,-279,-347,68,394.0,13,64,-5,-15,484,545,59,1
1,891,-921,1812,-170,-236,66,414.52272727272725,44,142,0,-9,1826,588,-1224,0
0,409,-539,948,-207,-75,-132,279.38235294117646,34,17,-37,0,961,114,-834,0
1,443,87,356,-252,-280,28,273.6923076923077,13,26,0,-2,354,135,-221,1
1,550,287,263,-224,-298,74,248.63636363636363,11,66,0,-7,242,237,-26,1
1,865,413,452,-218,-300,82,384.6666666666667,12,72,-4,-11,447,539,87,1
1,1247,724,523,-225,-183,-42,259.8095238095238,21,47,-2,-6,538,943,420,1
1,716,-528,1244,-239,-339,100,503.88,25,94,0,-10,1245,470,-774,0
0,224,-1868,2092,-453,-108,-345,446.4583333333333,48,0,-295,0,2107,-99,-2191,0
1,726,-494,1220,-171,-188,17,292.8809523809524,42,126,-2,-4,1223,448,-772,0
1,786,794,-8,-152,-134,-18,130.0,1,3,-19,-5,9,482,490,1
1,649,624,25,-91,114,-205,132.0,1,1,-25,0,15,359,334,1
0,699,192,507,-170,-495,325,200.14285714285714,28,318,0,0,502,412,-95,1
1,472,-359,831,-196,-105,-91,55.333333333333336,3,21,-27,866,0,120,-711,0
0,534,-590,1124,-203,32,-235,314.5945945945946,37,86,-56,-9,1155,271,-853,0
0,383,-448,831,-121,58,-179,344.52,25,138,-5,-11,833,120,-711,0
1,550,726,-176,-295,-57,-238,377.0487804878049,41,33,-221,-186,1621,287,463,0
1,1005,-367,1372,-179,-253,74,416.6969696969697,33,113,0,-7,1379,766,-606,0
0,963,-432,1395,-167,-204,37,355.4102564102564,39,116,-4,-2,1399,658,-737,0
1,1400,809,591,-173,-73,-100,216.37037037037038,27,21,-20,0,591,1121,530,1
0,1722,1276,446,-142,-38,-104,197.22727272727272,22,26,-6,0,459,1437,991,1
1,681,-524,1205,-235,-138,-97,251.51063829787233,47,76,-71,-8,1177,430,-775,0
1,574,335,239,-184,-278,94,203.8181818181818,11,90,-18,0,241,251,12,1
0,526,637,-111,-122,35,-157,42.0,1,0,-30,-162,0,205,316,1
0,231,243,-12,-498,-368,-130,132.08695652173913,23,32,-169,116,-11,-87,-75,1
1,1939,1965,-26,-97,66,-163,17.0,6,4,-25,2,-35,1621,1647,1
1,597,233,364,-277,-532,255,311.5,24,385,0,-2,698,252,-112,0
0,543,473,70,-220,-193,-27,86.8,15,21,-24,-4,179,227,157,1
1,1006,366,640,-215,-304,89,16.0,1,92,-16,631,-4,668,28,1
0,739,202,537,-193,-464,271,256.1666666666667,24,292,-12,0,554,458,-79,1
1,1818,1075,743,-168,-119,-49,243.6551724137931,29,59,0,0,718,1494,751,1
0,176,-480,656,-267,-226,-41,281.04347826086956,23,8,-47,0,663,-175,-831,0
0,382,-438,820,-301,-60,-241,252.46875,32,3,-102,-3,810,84,-736,0
0,230,-206,436,-584,-376,-208,170.08333333333334,24,3,-69,0,417,-68,-504,0
0,375,-418,793,-215,22,-237,258.8,30,42,-61,0,795,74,-719,0
0,463,-486,949,-95,-217,122,296.3125,32,162,-1,-1,966,174,-775,0
0,258,-1550,1808,-546,-205,-341,450.5609756097561,41,0,-344,0,1811,-35,-1843,0
1,566,-390,956,-28,-193,165,287.24242424242425,33,76,-10,-1,957,249,-707,0
1,1267,710,557,-167,-241,74,349.1875,16,74,0,-13,560,952,395,1
1,573,1773,-1200,-203,-196,-7,320.3783783783784,37,18,-11,0,-1200,247,1447,1
0,1046,-913,1959,282,-37,319,328.79661016949154,59,115,-2,0,1947,781,-1178,0
0,864,566,298,-154,-144,-10,97.12,25,19,-14,0,298,561,263,1
1,975,567,408,-211,-299,88,351.4166666666667,12,84,-14,-1,410,656,248,1
1,2257,1358,899,-197,-100,-97,45.5,4,125,-8,904,-76,1947,1048,1
1,645,-491,1136,-93,-131,38,307.6756756756757,37,88,-48,-1,1129,336,-800,0
1,278,-521,799,-497,-573,76,2.0,1,82,0,798,-7,-58,-857,0
1,580,1815,-1235,-166,-195,29,308.525,40,51,-1,1,-1246,274,1509,1
1,1272,504,768,-158,-300,142,437.0,18,135,0,-12,757,887,119,1
0,545,-279,824,-185,-426,241,282.3,30,239,0,-10,835,245,-579,0
1,523,560,-37,-206,-162,-44,99.0,22,87,0,201,-14,183,220,1
1,317,-536,853,-575,-552,-23,523.625,16,53,0,-1,828,11,-842,0
0,1805,1963,-158,-127,-12,-115,90.46666666666667,15,0,-22,0,-168,1484,1642,1
1,1316,474,842,-225,-306,81,486.47058823529414,17,150,0,-13,799,989,147,1
0,1396,579,817,-111,-141,30,218.97368421052633,38,144,0,0,818,1067,250,1
1,182,-661,843,-365,-248,-117,356.9230769230769,13,0,-202,1287,0,-184,-1027,0
0,670,-625,1295,-260,-142,-118,447.58620689655174,29,31,-126,0,1299,374,-921,0
1,1062,300,762,-204,-242,38,362.57142857142856,21,106,0,0,767,780,18,1
1,1567,972,595,-221,-223,2,244.04347826086956,23,8,-12,0,597,1262,667,1
1,536,532,4,-254,-244,-10,280.3478260869565,23,36,-3,-6,671,201,197,0
1,755,-188,943,-205,-147,-58,470.45,20,72,-22,-9,929,479,-464,0
0,256,-267,523,-502,-498,-4,126.1219512195122,41,70,-9,-8,529,-95,-618,0
0,896,-1275,2171,-211,-137,-74,442.44897959183675,49,66,-85,0,2179,576,-1595,0
1,546,-410,956,-193,-230,37,302.28125,32,104,-4,0,963,243,-713,0
0,456,-477,933,-113,-221,108,299.65625,32,154,-1,-17,959,169,-764,0
1,798,340,458,-173,-325,152,371.3076923076923,13,152,0,-6,457,515,57,1
0,448,-429,877,-166,-133,-33,56.0,1,105,0,908,0,148,-729,0
1,1607,890,717,-140,-103,-37,278.4,25,104,-4,-10,670,1340,623,1
1,266,340,-74,-256,-232,-24,280.23333333333335,30,39,-84,-78,841,-35,39,0
0,524,-1328,1852,-257,-73,-184,28.0,1,102,-185,1861,-6,204,-1648,0
1,617,-421,1038,-285,-251,-34,314.3636363636364,33,80,-31,0,1033,325,-713,0
1,509,-436,945,-182,-204,22,294.6969696969697,33,102,0,0,949,203,-742,0
1,745,81,664,-201,-310,109,420.8125,16,108,0,-2,665,455,-209,1
0,570,-357,927,-229,-185,-44,309.43333333333334,30,28,-44,-2,938,291,-636,0
0,477,-648,1125,-197,-138,-59,14.0,1,50,-55,1130,-8,140,-985,0
1,416,287,129,-220,-251,31,276.3888888888889,18,73,-7,-8,506,103,-26,0
1,1354,367,987,-237,-314,77,498.05,20,82,-8,0,992,1023,36,1
1,743,286,457,-231,-276,45,342.92857142857144,14,48,0,-4,457,457,0,1
1,1325,1857,-532,-221,257,-478,264.36842105263156,19,0,-114,0,-525,968,1500,1
1,490,468,22,-183,-197,14,255.35714285714286,14,73,-10,355,-2,182,160,1
1,2018,2006,12,-77,330,-407,133.0,1,0,-30,14,-3,1691,1679,1
1,433,416,17,-106,314,-420,184.5,2,3,-43,0,32,115,98,1
0,157,231,-74,-407,-376,-31,65.18181818181819,11,0,-34,4,-83,-168,-94,1
1,562,-484,1046,-150,-145,-5,325.8709677419355,31,33,-13,-2,1045,238,-808,0
1,1410,657,753,-175,-191,16,268.64285714285717,28,34,0,-3,754,1110,357,1
0,484,495,-11,-246,-262,16,222.17391304347825,23,75,0,529,0,145,156,0
0,753,707,46,-178,-171,-7,48.45454545454545,11,5,-6,-29,45,444,398,1
0,706,-649,1355,-253,-235,-18,327.9756097560976,41,28,-26,0,1355,397,-958,0
1,571,142,429,-228,-300,72,25.666666666666668,3,83,-3,428,-7,280,-149,1
0,1151,502,649,-185,-157,-28,209.83333333333334,30,28,-3,-9,637,832,183,1
1,539,-252,791,-197,-258,61,379.0,21,61,-2,-5,791,211,-580,0
0,902,-1076,1978,-179,-84,-95,345.7758620689655,58,112,-91,0,1992,577,-1401,0
1,485,442,43,-246,-239,-7,46.6,5,11,-5,-4,46,157,114,1
1,571,-23,594,-316,-488,172,61.666666666666664,3,172,0,620,0,215,-379,0
0,772,-920,1692,-240,-139,-101,344.55102040816325,49,102,-106,0,1696,466,-1226,0
0,1988,472,1516,-203,-177,-26,312.8125,48,17,-30,0,1533,1667,151,1
0,301,257,44,-513,-500,-13,100.82352941176471,17,9,-181,191,-1,-17,-61,1
1,761,-174,935,-260,-322,62,484.6,20,69,0,0,940,446,-489,0
0,652,-1189,1841,-261,-169,-92,359.8235294117647,51,21,-95,0,1847,327,-1514,0
1,1087,-1204,2291,-242,-251,9,449.29411764705884,51,83,-2,-8,2290,779,-1512,0
0,631,-708,1339,-207,-233,26,373.8285714285714,35,34,-9,-9,1323,466,-873,0
0,554,-1142,1696,-275,-142,-133,367.8666666666667,45,9,-144,0,1695,242,-1454,0
1,292,335,-43,-103,-70,-33,37.333333333333336,9,9,-35,-107,9,138,181,1
0,553,-771,1324,-217,-128,-89,48.5,2,33,-104,1338,0,261,-1063,0
0,2015,-1495,3510,-119,-136,17,513.3676470588235,68,118,0,-6,3513,1703,-1807,0
1,695,697,-2,-52,295,-347,153.0,1,3,-23,1,-18,387,389,1
0,552,2294,-1742,-321,144,-465,402.69767441860466,43,0,-141,0,-1760,244,1986,1
1,770,665,105,-219,-247,28,212.26666666666668,15,72,0,413,0,445,340,1
1,675,-386,1061,-256,-204,-52,91.0,2,24,-58,1094,0,439,-622,0
0,952,1504,-552,-62,-25,-37,203.3846153846154,26,9,-20,3,-558,648,1200,1
0,674,-797,1471,-250,-152,-98,352.3095238095238,42,45,-19,-5,1506,348,-1123,0
0,304,501,-197,-314,-57,-257,167.1875,16,0,-173,0,-244,22,219,1
0,702,-641,1343,-192,-217,25,322.4047619047619,42,119,-6,-7,1345,373,-970,0
0,886,-1180,2066,-241,-237,-4,436.531914893617,47,58,-8,-4,2069,547,-1519,0
1,1264,10,1254,-277,-617,340,281.6304347826087,46,340,-2,0,1253,911,-343,1
0,270,198,72,-423,-428,5,89.14285714285714,14,77,-43,-49,88,-57,-129,1
0,1363,20,1343,-154,-658,504,47.0,2,566,0,1366,0,1052,-291,0
1,815,-563,1378,-254,-254,0,558.96,25,21,-1,-3,1382,548,-830,0
0,1008,1162,-154,-289,-142,-147,121.0,1,0,-89,-170,0,692,846,1
1,988,623,365,-224,-658,434,499.22727272727275,22,443,-1,1409,-8,628,263,0
0,268,-571,839,-584,-272,-312,297.7,30,0,-287,-13,821,-54,-893,0
1,314,-92,406,-459,-406,-53,244.8125,16,0,-51,0,408,-8,-414,0
1,1184,463,721,-222,-313,91,437.5882352941176,17,121,-3,0,719,874,153,1
1,457,483,-26,-113,-98,-15,81.0,3,15,0,0,-24,175,201,1
1,375,28,347,-397,-383,-14,190.47058823529412,17,0,-17,0,347,50,-297,1
1,891,1,890,-230,-274,44,508.6111111111111,18,45,-18,0,895,617,-273,1
0,477,-446,923,-184,-162,-22,281.9117647058824,34,108,-30,0,950,199,-724,0
1,318,158,160,-443,-415,-28,184.125,8,0,-34,0,151,-24,-184,1
0,277,-344,621,-516,-480,-36,164.57894736842104,57,43,-347,0,606,-56,-677,0
1,839,372,467,-77,-320,243,329.06666666666666,15,236,-1,-14,476,548,81,1
1,1928,1368,560,-219,-245,26,302.05263157894734,19,28,-5,-12,566,1639,1079,1
0,421,-542,963,-184,-151,-33,294.45454545454544,33,57,-34,0,969,132,-831,0
1,38,-162,200,-664,-471,-193,133.83333333333334,12,150,-197,-10,186,-242,-442,0
1,1255,-983,2238,-229,-193,-36,399.5,56,93,-23,0,2247,957,-1281,0
1,269,-730,999,-493,-255,-238,419.24,25,1,-234,-3,996,-90,-1089,0
0,547,-539,1086,-58,-75,17,274.4736842105263,38,167,-11,0,1076,207,-879,0
0,882,-505,1387,-203,-178,-25,402.6578947368421,38,24,-27,0,1528,543,-844,0
1,920,339,581,-223,-343,120,380.3125,16,120,-11,-9,581,644,63,1
1,945,304,641,-209,-407,198,205.26315789473685,19,198,-3,1017,-5,664,23,0
0,454,-491,945,-130,-116,-14,45.666666666666664,3,128,0,949,-2,167,-778,0
0,519,-476,995,-160,-132,-28,276.3333333333333,36,73,-32,-1,1009,212,-783,0
1,858,318,540,-157,-275,118,384.73333333333335,15,112,-6,-15,541,578,38,1
0,241,-295,536,-477,-524,47,51.666666666666664,3,99,-3,572,-3,-86,-622,0
0,1434,1134,300,-135,-90,-45,126.26086956521739,23,40,-40,0,298,1090,790,1
1,3,-158,161,-500,-488,-12,157.0,10,1,-12,0,161,-291,-452,0
1,8,-188,196,-480,-469,-11,195.1,10,0,-11,-3,196,-283,-479,0
1,3,-65,68,-496,-496,0,130.6,5,1,0,-1,68,-272,-340,0
0,385,400,-15,-245,-199,-46,185.3684210526316,19,25,-42,-12,361,111,126,1
0,529,699,-170,-165,-45,-120,77.9090909090909,22,43,-66,0,-179,247,417,1
0,1442,899,543,-155,-81,-74,149.43243243243242,37,13,-31,0,565,1126,583,1
0,429,1279,-850,-110,-122,12,240.77777777777777,36,126,0,0,-862,147,997,1
0,686,2178,-1492,-121,-55,-66,352.35714285714283,42,29,0,0,-1504,404,1896,1
1,679,350,329,-230,-336,106,132.5,4,110,-6,380,0,366,37,1
1,1286,670,616,-250,-260,10,229.26923076923077,26,30,-17,0,617,999,383,1
1,580,346,234,-213,-363,150,129.88235294117646,17,148,-5,0,236,284,50,1
0,228,890,-662,-452,-228,-224,240.58620689655172,29,0,-214,0,-675,-86,576,1
0,767,-634,1401,-276,-294,18,315.8888888888889,45,98,-7,-9,1403,475,-926,0
1,2,201,-199,-705,-474,-231,129.52631578947367,19,0,-180,0,-200,-310,-111,1
1,776,290,486,-195,-275,80,228.0,7,83,-29,639,0,468,-18,1
1,461,612,-151,-228,-272,44,169.88,25,44,-26,0,-439,157,308,1
0,18,199,-181,-739,-394,-345,160.72,25,0,-312,0,-300,-290,-109,1
0,1491,1336,155,-154,-92,-62,98.33333333333333,15,53,-29,0,181,1186,1031,1
0,18,600,-582,-486,-199,-287,64.5,2,1,-294,-589,13,-285,297,1
1,1221,420,801,-271,-633,362,635.5,14,373,0,0,799,911,110,1
1,2023,1476,547,-185,-263,78,333.1764705882353,17,79,0,0,550,1720,1173,1
1,1019,-285,1304,-226,-335,109,376.52941176470586,17,109,-12,1911,-3,722,-582,0
1,257,-2173,2430,-506,-182,-324,423.1034482758621,58,0,-312,-2,2426,-21,-2451,0
1,562,313,249,-213,-398,185,184.375,16,150,0,0,235,267,18,1
1,865,683,182,-225,-256,31,156.58333333333334,12,34,0,-6,179,548,366,1
0,726,562,164,-243,-273,30,113.07142857142857,14,49,0,0,166,452,288,1
0,1336,420,916,-178,-179,1,210.48837209302326,43,42,-20,0,962,1036,120,1
1,1028,31,997,-204,-583,379,347.88235294117646,34,385,-8,-8,1137,738,-259,0
1,1348,885,463,-192,-220,28,242.8421052631579,19,11,-11,-21,438,1060,597,1
1,770,-1218,1988,-227,-243,16,307.875,64,122,0,0,1985,473,-1515,0
1,1336,454,882,-173,-165,-8,230.44736842105263,38,46,-8,0,882,1044,162,1
0,1161,246,915,-283,-437,154,226.7608695652174,46,181,0,0,1032,873,-42,1
0,719,-1286,2005,-193,-182,-11,318.56451612903226,62,137,-1,0,1987,454,-1551,0
0,242,203,39,-510,-503,-7,234.33333333333334,36,0,-231,108,-735,-31,-70,1
1,688,481,207,-241,-294,53,209.66666666666666,9,74,-3,398,0,358,151,1
0,752,-922,1674,-250,-169,-81,362.75555555555553,45,18,-83,0,1669,470,-1204,0
1,1347,600,747,-207,-207,0,300.0,25,16,-12,-2,748,1045,298,1
0,1093,772,321,-185,-193,8,49.0,3,60,0,315,-50,819,498,1
1,468,-476,944,-242,-236,-6,455.4761904761905,21,17,0,0,944,142,-802,0
1,776,-1495,2271,-203,-311,108,438.7307692307692,52,162,-1,0,2273,480,-1791,0
1,236,-307,543,-464,-453,-11,232.20833333333334,24,68,-17,0,538,-60,-603,0
1,744,-1405,2149,-200,-332,132,439.0,49,119,0,-3,2161,464,-1685,0
0,709,413,296,-195,-325,130,202.625,16,139,-7,-14,302,392,96,1
1,649,-403,1052,-271,-196,-75,330.96875,32,24,-71,-5,1052,344,-708,0
1,727,776,-49,-262,-325,63,140.44444444444446,9,99,-6,-52,105,408,457,1
1,794,-584,1378,-152,85,-237,315.44444444444446,45,192,-1,0,1405,485,-893,0
1,340,-657,997,-291,-214,-77,267.4054054054054,37,41,-26,0,999,43,-954,0
1,403,410,-7,-113,-109,-4,24.0,1,3,-4,-14,0,153,160,1
1,234,-747,981,-610,-505,-105,447.1304347826087,23,0,-25,-6,1003,-61,-1042,0
1,543,-234,777,-236,-311,75,422.36842105263156,19,66,-7,-11,787,269,-508,0
1,3,185,-182,-460,-468,8,149.72727272727272,11,9,-14,0,-178,-322,-140,1
1,1361,398,963,-218,-313,95,406.5416666666667,24,95,0,0,961,1081,118,1
0,603,-470,1073,-266,-182,-84,285.64864864864865,37,2,-89,0,1084,303,-770,0
1,720,-439,1159,-239,-222,-17,282.780487804878,41,53,-15,-2,1165,434,-725,0
0,545,-328,873,-216,-153,-63,281.38709677419354,31,13,-69,0,882,279,-594,0
0,1025,895,130,-31,-58,27,84.92857142857143,14,20,-3,-10,134,726,596,1
1,1125,519,606,-206,-362,156,395.9375,16,134,-7,-5,605,826,220,1
1,181,-501,682,-498,-228,-270,54.5,2,0,-276,678,-20,-104,-786,0
0,1092,537,555,-247,-246,-1,206.73076923076923,26,25,-3,0,556,759,204,1
1,10,122,-112,-469,-469,0,141.125,8,3,-7,7,-113,-298,-186,1
0,1047,-785,1832,-160,-179,19,446.0243902439024,41,108,0,-6,1835,747,-1085,0
0,664,-498,1162,-239,-157,-82,329.4166666666667,36,48,-84,0,1178,371,-791,0
0,99,1337,-1238,-680,-167,-513,380.6216216216216,37,0,-514,0,-1246,-200,1038,1
1,445,355,90,-195,-253,58,290.3333333333333,9,56,-20,-138,102,146,56,1
0,219,-463,682,-432,-154,-278,283.03846153846155,26,0,-282,0,694,-80,-762,0
0,217,-229,446,-514,-495,-19,211.66666666666666,21,6,-24,0,453,-125,-571,0
1,1448,1393,55,-141,-143,2,110.25,4,10,-9,-4,50,1147,1092,1
1,1486,546,940,-239,-244,5,347.51851851851853,27,17,-12,0,948,1180,240,1
1,811,-816,1627,-260,-234,-26,432.8421052631579,38,30,-16,-3,1641,492,-1135,0
0,602,1314,-712,-90,-118,28,224.375,32,6,-41,12,-719,299,1011,1
1,980,401,579,-242,-377,135,408.0,15,135,0,-9,576,704,125,1
0,1303,467,836,-329,-68,-261,245.94117647058823,34,0,-157,-1,845,992,156,1
1,1511,-752,2263,-127,-601,474,654.6111111111111,36,474,0,-2,2262,1197,-1066,0
0,6,1,5,-743,-750,7,158.88888888888889,9,7,-219,66,0,-275,-280,0
0,1126,857,269,-237,-142,-95,89.63636363636364,11,52,-17,365,0,836,567,1
1,767,116,651,-257,-316,59,391.4117647058824,17,58,0,0,648,470,-181,1
0,777,-886,1663,-249,-157,-92,52.0,3,131,-69,1663,-82,469,-1194,0
0,747,-602,1349,-108,-254,146,394.2857142857143,35,186,0,-1,1381,415,-934,0
1,297,-312,609,-609,-618,9,371.3529411764706,17,17,-5,0,626,-27,-636,0
1,969,509,460,-228,-343,115,360.35714285714283,14,114,-25,-12,461,656,196,1
1,1107,-690,1797,-231,-69,-162,355.94117647058823,51,113,0,0,1810,782,-1015,0
0,876,961,-85,-179,-149,-30,279.45,20,131,-30,-66,524,562,647,1
0,737,-415,1152,-226,-71,-155,412.7931034482759,29,4,-162,-10,1166,367,-785,0
1,536,-488,1024,-180,-187,7,277.8918918918919,37,59,-2,0,1029,222,-802,0
1,310,-669,979,-488,-131,-357,404.1081081081081,37,0,-251,-2,1429,2,-977,0
1,845,193,652,-269,-454,185,476.73333333333335,15,269,-3,0,658,548,-104,1
0,262,234,28,-535,-475,-60,140.66666666666666,12,3,-294,152,0,-55,-83,1
0,423,-409,832,-242,-201,-41,271.93333333333334,30,0,-44,0,828,115,-717,0
0,266,-1536,1802,-496,-192,-304,486.7368421052632,38,0,-301,-3,1818,-49,-1851,0
0,541,-3,544,-207,-454,247,253.8695652173913,23,256,-12,0,555,298,-246,0
1,785,-42,827,-162,-277,115,438.7894736842105,19,117,0,-2,830,479,-348,0
1,897,-740,1637,-175,-150,-25,401.5365853658537,41,119,0,-10,1628,594,-1043,0
1,713,-600,1313,-209,-237,28,398.06060606060606,33,71,-6,-1,1315,403,-910,0
1,490,415,75,-136,38,-174,121.0,3,3,-30,1,-29,217,142,1
1,445,511,-66,-148,0,-148,90.33333333333333,3,0,-9,0,38,75,141,1
1,11,-50,61,-650,-483,-167,92.5,4,0,-23,4,-43,-262,-323,0
1,832,-1193,2025,-200,-225,25,491.9268292682927,41,89,0,-5,2023,506,-1519,0
1,423,230,193,-294,-329,35,230.77777777777777,9,33,-4,-4,196,147,-46,1
1,889,78,811,-139,-603,464,348.03333333333336,30,517,0,-4,954,596,-215,0
0,410,-1039,1449,-304,-178,-126,352.4418604651163,43,5,-54,-1,1527,44,-1405,0
1,741,-428,1169,-211,-274,63,524.2173913043479,23,68,0,-5,1176,438,-731,0
0,593,-231,824,-340,-361,21,281.8965517241379,29,184,0,0,818,299,-525,0
1,1329,230,1099,-221,-335,114,504.6363636363636,22,110,0,0,1099,996,-103,1
0,553,-503,1056,-186,-203,17,294.72222222222223,36,92,-3,0,1062,132,-924,0
0,780,290,490,-425,-427,2,256.6111111111111,18,47,0,0,480,492,2,1
1,1524,1135,389,-222,-212,-10,235.875,16,0,-14,0,388,1227,838,1
1,1177,619,558,-266,-118,-148,278.42105263157896,19,0,-39,0,550,887,329,1
0,1245,456,789,-211,-134,-77,255.0,30,28,-13,0,793,923,134,1
1,679,-774,1453,-322,-145,-177,305.2916666666667,48,0,-175,-16,1461,369,-1084,0
0,1043,213,830,-353,-317,-36,49.0,1,107,0,877,0,698,-132,1
1,1627,882,745,-242,-239,-3,22.0,1,67,-14,746,-40,1303,558,1
0,1182,1168,14,-85,-43,-42,34.0,1,35,-7,0,16,893,879,1
0,1412,1501,-89,-135,-4,-131,121.0,6,0,-65,0,-90,1088,1177,1
1,809,73,736,-254,-309,55,445.7647058823529,17,57,0,-3,732,487,-249,1
1,478,-164,642,-268,-333,65,341.875,8,66,0,895,0,157,-485,0
1,1081,854,227,-237,-687,450,330.42105263157896,19,456,0,0,507,753,526,1
0,738,-896,1634,-265,-179,-86,378.27906976744185,43,20,-86,0,1634,454,-1180,0
0,1340,472,868,-257,-220,-37,225.6216216216216,37,1,-54,0,869,1013,145,1
1,1048,-257,1305,-315,-326,11,470.85714285714283,28,40,-1,0,1310,745,-560,0
1,69,291,-222,-284,-289,5,488.4782608695652,23,63,-16,887,-220,-245,-23,0
1,1041,739,302,-174,-414,240,211.05555555555554,18,249,-4,0,301,712,410,1
0,2009,1209,800,-134,-170,36,233.91176470588235,34,44,-1,0,808,1688,888,1
1,31,177,-146,-328,-450,122,224.75,8,3,-19,8,-172,-273,-127,1
0,334,501,-167,-260,-84,-176,40.0,1,0,-71,-177,0,37,204,1
1,518,469,49,-222,-262,40,125.8,5,33,0,-12,51,255,206,1
0,534,190,344,-216,-375,159,202.76190476190476,21,240,0,0,373,241,-103,1
0,487,-384,871,-183,-152,-31,52.5,2,79,-33,899,0,244,-627,0
1,560,296,264,-196,-175,-21,187.92307692307693,13,16,-10,0,264,301,37,1
1,545,262,283,-188,-225,37,45.0,1,37,-3,286,-38,126,-157,1
1,883,156,727,-257,-267,10,414.1578947368421,19,89,-3,1508,-2,596,-131,0
1,397,445,-48,-85,-95,10,60.4,15,33,-10,12,-65,94,142,1
1,3,54,-51,-709,-668,-41,178.71428571428572,7,58,0,10,-108,-225,-174,0
1,493,300,193,-199,-120,-79,8.0,2,24,-4,219,-27,106,-87,1
1,461,61,400,-221,-290,69,328.0833333333333,12,71,0,-11,399,179,-221,1
0,811,1724,-913,-191,-163,-28,304.58620689655174,29,5,-38,0,-916,491,1404,1
1,934,-327,1261,-200,-250,50,571.8181818181819,22,136,0,0,1246,658,-603,0
0,375,-526,901,-265,-152,-113,52.666666666666664,3,38,-101,931,0,66,-835,0
0,658,-1216,1874,-129,-110,-19,91.5,6,147,-28,1941,-10,419,-1455,0
0,782,-246,1028,-265,-444,179,195.5818181818182,55,344,0,-17,975,529,-499,0
1,244,284,-40,-403,-425,22,71.5,2,32,-11,-54,20,-36,4,1
0,522,-453,975,-355,-118,-237,282.02777777777777,36,10,-169,0,1011,192,-783,0
1,462,62,400,-183,-238,55,310.53846153846155,13,52,-5,-2,393,200,-200,1
0,411,-581,992,-330,-138,-192,255.94871794871796,39,4,-198,0,985,149,-843,0
0,1625,291,1334,-223,-451,228,338.35714285714283,42,357,0,0,1381,1289,-45,1
1,283,-676,959,-291,-207,-84,306.2903225806452,31,0,-86,0,959,-43,-1002,0
0,32,229,-197,-748,-526,-222,138.0,20,0,-244,14,-226,-260,-63,1
1,548,-184,732,-224,-280,56,340.2857142857143,21,56,-16,-15,726,290,-442,0
0,388,365,23,-71,-87,16,100.63636363636364,11,37,-1,50,-62,160,137,1
0,492,-621,1113,-238,-170,-68,36.0,1,2,-134,1111,0,264,-849,0
1,873,-226,1099,-205,-356,151,411.48148148148147,27,151,0,-9,1100,587,-512,0
1,920,126,794,-215,-468,253,107.0,12,281,0,939,0,583,-211,0
1,517,149,368,-196,-249,53,322.53846153846155,13,64,-9,-7,402,196,-172,1
0,276,-392,668,-483,-168,-315,274.82142857142856,28,0,-308,0,724,-45,-713,0
1,499,72,427,-199,-251,52,326.15384615384613,13,58,0,-3,411,215,-212,1
1,1900,1008,892,-185,-146,-39,272.969696969697,33,68,-33,0,891,1589,697,1
0,77,-225,302,-646,-630,-16,165.33333333333334,18,1,-31,0,312,-229,-531,0
0,494,-433,927,-133,-143,10,256.56756756756755,37,100,-15,0,948,195,-732,0
0,468,-499,967,-229,-244,15,41.0,3,67,-10,1000,0,195,-772,0
1,598,254,344,-220,-503,283,304.4,15,278,-15,-33,338,284,-60,1
1,435,-361,796,-228,-281,53,35.666666666666664,3,65,-32,793,-23,169,-627,0
1,730,-157,887,-224,-277,53,345.9230769230769,26,102,0,-4,887,463,-424,0
1,851,171,680,-202,-337,135,400.875,16,149,-3,-6,606,525,-155,1
0,345,-419,764,-233,-239,6,23.75,4,57,0,875,0,53,-711,0
1,320,711,-391,-279,-276,-3,179.0,16,25,-24,-394,290,19,410,1
0,539,-1066,1605,-133,-304,171,337.02127659574467,47,185,-5,-24,1601,266,-1339,0
1,496,183,313,-186,-258,72,9.0,1,76,-1,316,-26,167,-146,1
1,783,-93,876,-193,-296,103,497.0,19,117,-7,-1,931,423,-453,0
1,507,253,254,-178,-249,71,159.5,12,76,-31,-10,245,241,-13,1
0,315,-147,462,-442,-368,-74,209.17391304347825,23,97,0,0,493,33,-429,0
1,555,370,185,-147,-93,-54,78.11764705882354,17,53,-3,-10,186,273,88,1
1,426,404,22,-22,51,-73,39.72727272727273,11,34,0,-42,23,144,122,1
0,468,-554,1022,-230,-187,-43,246.02439024390245,41,70,-46,0,1028,146,-876,0
1,993,-327,1320,-162,-322,160,513.2307692307693,26,165,-1,0,1318,708,-612,0
0,38,-610,648,-233,-205,-28,261.75,24,1,-133,0,642,-251,-899,0
1,483,129,354,-183,-322,139,327.775,40,150,0,0,1308,185,-169,0
1,951,597,354,-308,-291,-17,118.0,19,25,-27,348,0,654,300,1
1,1050,529,521,-320,-166,-154,383.2307692307692,13,98,-2,-15,464,736,215,1
1,804,-285,1089,-264,-378,114,549.9047619047619,21,151,-11,-23,1100,485,-604,0
0,54,1173,-1119,-284,-217,-67,277.225,40,1,-84,0,-1131,-233,886,1
0,1247,214,1033,-140,-573,433,293.3157894736842,38,415,-1,-7,1048,924,-109,1
0,1402,616,786,-191,-163,-28,18.0,1,52,-19,798,0,1038,252,1
1,1019,618,401,-160,-223,63,330.15384615384613,13,72,-6,-9,399,706,305,1
1,969,556,413,-144,-94,-50,220.38888888888889,18,13,-4,-7,402,666,253,1
0,637,-562,1199,-157,-171,14,240.22,50,95,-20,-8,1206,276,-923,0
0,787,-539,1326,-201,-76,-125,342.2564102564103,39,33,-140,0,1328,450,-876,0
1,980,390,590,-184,-267,83,410.8,15,78,0,-1,602,652,62,1
0,639,-514,1153,-255,-210,-45,235.64583333333334,48,26,-62,-3,1162,283,-870,0
1,1828,860,968,-198,-324,126,516.6842105263158,19,125,-3,-5,965,1462,494,1
1,1088,387,701,-169,-449,280,429.7368421052632,19,346,-5,-6,721,777,76,1
1,588,-657,1245,-214,-245,31,424.0689655172414,29,31,-12,-19,1241,265,-980,0
0,866,-729,1595,-238,-236,-2,348.4888888888889,45,63,-8,-6,1582,568,-1027,0
1,440,-480,920,-186,-197,11,288.5625,32,46,0,0,921,128,-792,0
0,1515,743,772,-169,-170,1,247.16666666666666,30,17,-5,0,773,1221,449,1
1,1015,480,535,-136,-221,85,392.5,14,84,-6,0,534,715,180,1
1,1053,456,597,-206,-731,525,478.0,18,523,-22,1378,-10,667,70,0
1,268,-153,421,-513,-553,40,343.5833333333333,12,40,-4,-20,394,-34,-455,0
0,402,-528,930,-244,-127,-117,363.28,25,14,-119,0,934,91,-839,0
1,557,601,-44,-106,-91,-15,66.5,4,0,-23,-71,0,246,290,1
1,526,457,69,-56,-71,15,24.1,10,69,-2,-12,93,183,114,1
0,198,-1877,2075,-552,-116,-436,370.30357142857144,56,0,-389,-12,2055,-76,-2151,0
0,265,-865,1130,-512,-203,-309,27.0,1,0,-325,1155,-12,-91,-1221,0
0,634,-1227,1861,-239,-98,-141,427.86046511627904,43,30,-126,0,1859,278,-1583,0
0,705,-941,1646,-171,-149,-22,369.15909090909093,44,90,-3,0,1659,405,-1241,0
0,1196,505,691,-174,39,-213,247.79310344827587,29,47,-1,-17,711,892,201,1
1,398,390,8,27,52,-25,136.66666666666666,6,0,-131,0,45,130,122,1
1,798,371,427,-196,-419,223,230.14285714285714,21,222,-12,-11,428,468,41,1
0,415,-667,1082,-218,-132,-86,284.79487179487177,39,13,-94,0,1119,84,-998,0
0,8,468,-460,-441,-188,-253,197.96296296296296,27,0,-270,0,-471,-308,152,1
1,575,-60,635,-174,-253,79,320.8,20,77,-26,-4,641,154,-481,0
1,56,581,-525,-262,-63,-199,66.0,3,0,-194,-549,0,-295,230,1
0,585,-910,1495,-291,-116,-175,317.40425531914894,47,27,-170,0,1495,234,-1261,0
0,115,-820,935,-368,-164,-204,255.0,36,0,-146,0,928,-226,-1161,0
0,864,-1091,1955,-187,-73,-114,435.93333333333334,45,95,-108,-2,1960,536,-1419,0
0,660,667,-7,-132,-33,-99,75.5,2,0,-48,0,-17,306,313,1
0,1340,559,781,-153,-77,-76,237.87878787878788,33,41,-23,0,787,1043,262,1
0,1219,-1134,2353,-191,-164,-27,489.875,48,67,-31,0,2357,911,-1442,0
1,601,-589,1190,-223,-215,-8,5.5,2,64,0,1199,-10,253,-937,0
0,510,498,12,-191,-187,-4,43.0,1,3,-9,20,-9,179,167,1
1,1045,388,657,-230,-331,101,417.9375,16,100,0,0,660,747,90,1
0,138,-444,582,-507,-160,-347,248.68,25,4,-315,-6,576,-145,-727,0
1,808,-1017,1825,-210,-237,27,406.3777777777778,45,101,0,0,1825,510,-1315,0
0,568,600,-32,-172,-83,-89,75.16666666666667,6,0,-62,0,-44,253,285,1
0,172,542,-370,-251,-52,-199,96.0,1,3,-180,-386,0,-184,186,1
1,454,82,372,-174,-197,23,341.0,10,72,-3,0,334,177,-195,1
1,993,523,470,-252,-261,9,346.2142857142857,14,45,0,-5,466,712,242,1
0,188,-598,786,-516,-152,-364,250.44117647058823,34,0,-318,0,815,-128,-914,0
1,252,-736,988,-231,-131,-100,444.04545454545456,22,19,-18,0,989,-77,-1065,0
0,527,-551,1078,-227,-195,-32,57.0,1,29,-30,1088,0,185,-893,0
0,1389,1333,56,-166,-124,-42,93.07692307692308,13,45,-2,0,129,1062,1006,1
0,1278,530,748,-192,-178,-14,250.58620689655172,29,4,-20,0,755,940,192,1
0,1664,906,758,-284,-121,-163,244.53333333333333,30,18,-60,0,732,1352,594,1
0,360,657,-297,-272,-46,-226,49.666666666666664,3,0,-129,-306,0,-147,150,1
0,438,-521,959,-329,-96,-233,358.3333333333333,27,8,-146,0,981,-69,-1028,0
0,470,-554,1024,-252,-176,-76,328.6774193548387,31,4,-74,0,1024,-44,-1068,0
0,1008,1319,-311,-104,16,-120,138.1304347826087,23,0,-33,0,-347,641,952,1
1,685,634,51,-172,-161,-11,59.8,5,3,-5,-7,52,226,175,1
0,542,-551,1093,-273,-66,-207,306.75,36,13,-62,-7,1097,240,-853,0
0,158,-581,739,-480,-79,-401,231.71428571428572,35,0,-292,0,764,-154,-893,0
0,484,-494,978,-205,-169,-36,247.6,40,113,-9,0,969,177,-801,0
1,963,326,637,-192,-160,-32,318.52,25,67,0,-5,798,701,64,1
1,796,389,407,-201,-260,59,330.0833333333333,12,57,0,0,401,480,73,1
1,472,-163,635,-181,-266,85,350.4,20,95,-1,-8,691,156,-479,0
0,1785,491,1294,-159,-141,-18,318.7317073170732,41,68,-14,-3,1313,1499,205,1
0,1204,-214,1418,-357,-447,90,378.39473684210526,38,180,0,0,1425,883,-535,0
1,1050,-459,1509,-211,-305,94,506.56666666666666,30,96,0,-9,1511,769,-740,0
1,503,46,457,-202,-187,-15,352.54545454545456,11,59,-1,824,0,193,-264,0
0,10,3,7,-796,-674,-122,225.5,6,0,-506,-21,49,-305,-312,0
0,804,-466,1270,-200,-227,27,408.825,40,83,-18,-4,1643,489,-781,0
1,810,-801,1611,-244,-227,-17,363.59090909090907,44,68,-19,0,1613,500,-1111,0
1,602,374,228,-62,-187,125,76.1,10,184,-5,204,-136,313,85,1
0,17,579,-562,-466,-3,-463,252.24137931034483,29,13,-426,2,-646,-272,290,1
1,858,-278,1136,-199,-286,87,457.5263157894737,19,89,-2,2008,-9,557,-579,0
0,39,-567,606,-283,-71,-212,296.4,20,0,-160,0,611,-404,-1010,0
1,568,521,47,-172,-137,-35,146.33333333333334,3,19,0,-4,52,125,78,1
1,789,227,562,-220,-289,69,374.8,15,69,-1,-4,555,503,-59,1
0,468,254,214,-228,-320,92,165.2941176470588,17,99,0,0,280,158,-56,1
1,571,-1254,1825,-250,-216,-34,323.7142857142857,56,25,-16,-10,1826,268,-1557,0
0,560,399,161,-148,-200,52,288.0,20,104,-1,-7,584,269,108,0
0,1875,-487,2362,-246,-156,-90,426.3454545454546,55,94,-40,-2,2357,1580,-782,0
0,1327,860,467,-67,113,-180,120.86486486486487,37,34,-14,0,470,986,519,1
0,612,2066,-1454,-112,46,-158,333.16279069767444,43,44,0,0,-1458,276,1730,1
0,487,1260,-773,-96,46,-142,214.25714285714287,35,60,-4,0,-776,151,924,1
0,502,-446,948,-309,3,-312,279.5833333333333,36,10,-172,0,999,180,-768,0
1,1335,-1715,3050,-156,-177,21,229.2,10,112,-25,3267,0,982,-2068,0
0,517,1002,-485,-48,-42,-6,164.9655172413793,29,50,-25,5,-500,164,649,1
0,161,459,-298,-270,-91,-179,150.15,20,0,-86,0,-303,-154,144,1
0,498,501,-3,-200,-218,18,173.21428571428572,14,51,0,-8,249,203,206,1
0,477,337,140,-264,-319,55,83.1,10,61,0,218,0,139,-1,1
0,149,267,-118,-586,-447,-139,130.83333333333334,12,0,-137,0,-128,-184,-66,1
1,532,307,225,-194,-219,25,222.0909090909091,11,73,0,0,227,273,48,1
0,337,-514,851,-309,-132,-177,316.5925925925926,27,11,-175,0,843,-119,-970,0
1,599,524,75,-168,-189,21,148.0,4,23,0,-16,67,143,68,1
1,1260,328,932,-209,-297,88,495.5263157894737,19,84,-4,0,928,929,-3,1
0,1434,248,1186,-288,-486,198,259.9166666666667,48,265,0,0,1218,1144,-42,1
1,298,377,-79,-234,-203,-31,198.69230769230768,13,5,-31,174,-79,6,85,1
0,461,-511,972,-229,-73,-156,255.15384615384616,39,33,-64,0,989,142,-830,0
0,462,262,200,-233,-321,88,223.66666666666666,15,98,0,0,339,150,-50,1
1,1115,281,834,-211,-315,104,246.2941176470588,34,137,-3,0,835,705,-129,1
0,1030,-217,1247,-189,-339,150,350.77777777777777,36,156,0,-9,1263,722,-525,0
0,242,1473,-1231,-425,-67,-358,330.92105263157896,38,0,-289,0,-1232,-91,1140,1
0,0,1674,-1674,-644,-11,-633,390.3777777777778,45,0,-549,0,-1676,-316,1358,1
0,789,716,73,-178,21,-199,61.38461538461539,13,54,-103,0,95,503,430,1
0,477,-477,954,-285,-114,-171,289.2121212121212,33,2,-171,0,959,46,-908,0
1,578,539,39,-190,-192,2,135.0,2,4,-5,0,39,147,108,1
1,822,484,338,-266,-290,24,290.8333333333333,12,26,0,-2,337,506,168,1
0,1482,523,959,-209,-240,31,296.3939393939394,33,43,0,0,986,1181,222,1
1,407,-13,420,-234,-439,205,217.63636363636363,22,201,-11,-6,429,135,-285,0
0,1248,-1367,2615,-206,-69,-137,465.4107142857143,56,78,-94,0,2621,947,-1668,0
0,455,-449,904,-238,-193,-45,275.85714285714283,35,20,-50,-94,906,181,-723,0
1,170,17,153,-592,-614,22,259.14285714285717,7,25,0,-35,158,-137,-290,1
0,484,-430,914,-222,-218,-4,232.9189189189189,37,37,-34,-2,913,202,-712,0
0,605,483,122,-227,-190,-37,216.38095238095238,21,58,-6,583,-1,312,190,1
1,984,631,353,-176,-253,77,358.55555555555554,9,93,0,0,351,659,306,1
0,478,-393,871,-231,-258,27,18.0,1,44,0,885,0,195,-676,0
1,758,565,193,-174,-294,120,295.875,8,116,0,-8,198,447,254,1
1,1016,-1017,2033,-162,-253,91,539.3421052631579,38,162,-4,-2,2033,694,-1339,0
0,178,197,-19,-437,-561,124,190.5,2,129,0,0,-40,-124,-105,1
0,1385,638,747,-329,-243,-86,231.84375,32,4,-88,0,753,1068,321,1
0,1506,-357,1863,-165,-257,92,8.5,2,128,0,1881,-3,1222,-641,0
1,724,497,227,-94,-280,186,359.5,8,183,-1,0,232,428,201,1
0,504,792,-288,-295,-158,-137,220.35714285714286,14,0,-149,0,-295,235,523,1
0,14,216,-202,-743,-515,-228,124.71428571428571,21,0,-176,4,-219,-254,-52,1
0,1465,609,856,-210,-202,-8,253.03030303030303,33,9,-3,0,857,1138,282,1
0,1395,546,849,-228,-222,-6,256.3636363636364,33,12,-15,-8,856,1087,238,1
0,143,520,-377,-264,-152,-112,286.07142857142856,14,0,-130,0,-404,-109,268,1
0,54,-358,412,-340,-183,-157,267.52941176470586,17,1,-158,0,447,-224,-636,0
0,6,-483,489,-260,-146,-114,241.0909090909091,22,2,-131,0,532,-265,-754,0
0,138,-396,534,-257,-228,-29,288.6,20,9,-30,0,583,-133,-667,0
0,347,-728,1075,-268,-157,-111,344.80645161290323,31,18,-122,0,1083,54,-1021,0
0,1430,198,1232,-163,-547,384,2.0,1,386,0,1240,0,1141,-91,1
1,197,200,-3,-538,-159,-379,90.0,3,0,-22,-10,26,-133,-130,1
1,1800,1922,-122,-76,298,-374,153.11111111111111,9,24,-21,0,-154,1423,1545,1
0,207,-628,835,-222,-201,-21,329.32,25,12,-30,0,844,-80,-915,0
0,420,-556,976,-111,-201,90,290.7027027027027,37,199,-26,0,1006,148,-828,0
1,485,-376,861,-216,-109,-107,305.3225806451613,31,124,-112,0,920,213,-648,0
0,448,16,432,-199,-612,413,225.20833333333334,24,418,0,0,447,136,-296,1
0,482,794,-312,-250,-136,-114,201.375,16,0,-111,0,-329,191,503,1
1,786,654,132,-213,-287,74,246.28571428571428,7,73,-3,-12,144,484,352,1
1,848,71,777,-187,-320,133,481.47058823529414,17,129,0,-18,782,580,-197,1
0,584,815,-231,-296,-35,-261,168.92307692307693,13,0,-116,0,-220,290,521,1
1,816,568,248,-156,-285,129,315.125,8,113,0,-7,232,517,269,1
0,941,-514,1455,-230,-221,-9,379.0263157894737,38,58,-17,0,1453,631,-824,0
0,1291,589,702,-225,-200,-25,217.34375,32,13,-9,0,723,987,285,1
0,317,-641,958,-403,-172,-231,101.0,12,0,-209,949,-92,34,-924,0
1,791,-1178,1969,-243,-197,-46,537.3783783783783,37,98,-42,-7,1971,497,-1472,0
0,517,-365,882,-191,-257,66,293.258064516129,31,78,0,-7,904,236,-646,0
0,1158,921,237,-187,-183,-4,174.30769230769232,13,5,-9,0,243,848,611,1
0,412,-517,929,-146,-157,11,286.30555555555554,36,122,0,0,1005,128,-801,0
0,498,-400,898,-227,-240,13,305.9032258064516,31,92,0,0,923,214,-684,0
0,823,666,157,-253,-82,-171,109.11764705882354,17,5,-168,-5,169,533,376,1
0,427,-509,936,-150,-121,-29,317.0625,32,129,-25,-5,951,137,-799,0
0,550,-374,924,-209,-215,6,287.45454545454544,33,86,0,0,966,260,-664,0
1,1311,438,873,-159,-304,145,435.23809523809524,21,145,-3,-17,881,1014,141,1
1,904,-486,1390,-192,-228,36,376.6458333333333,48,48,-63,-4,1837,616,-774,0
0,443,-467,910,-292,-150,-142,233.12820512820514,39,0,-143,0,904,96,-814,0
1,741,-757,1498,-205,-239,34,394.13157894736844,38,90,0,0,1495,415,-1083,0
1,474,-392,866,-243,-248,5,346.0,25,30,0,0,866,164,-702,0
1,1946,991,955,-222,-277,55,362.61538461538464,26,60,-4,0,956,1653,698,1
1,726,391,335,-207,-354,147,139.08695652173913,23,143,0,-8,333,405,70,1
1,849,599,250,-202,-267,65,98.08333333333333,12,62,-36,247,-121,532,282,1
1,966,-353,1319,-180,-337,157,510.1923076923077,26,157,0,0,1316,635,-684,0
0,1086,435,651,-230,-111,-119,227.92857142857142,28,0,-117,0,647,775,124,1
1,539,382,157,-257,-230,-27,380.3529411764706,17,36,-27,786,0,204,47,0
1,715,-620,1335,-233,-203,-30,364.97727272727275,44,44,-41,0,1622,396,-939,0
0,243,828,-585,-532,-249,-283,226.0344827586207,29,0,-281,0,-585,-33,552,1
1,1443,-451,1894,-218,-167,-51,484.7435897435897,39,42,-43,0,1888,1145,-749,0
0,353,-490,843,-280,-168,-112,267.6774193548387,31,0,-107,0,838,-10,-853,0
1,864,668,196,-153,-168,15,299.48,25,81,-1,-5,745,534,338,1
0,1249,435,814,-219,-128,-91,243.2941176470588,34,26,-95,0,827,952,138,1
1,838,-654,1492,-224,-240,16,45.0,1,67,-17,1495,-8,548,-944,0
0,625,211,414,-426,-494,68,197.61904761904762,21,100,0,0,437,316,-98,1
0,71,283,-212,-640,-462,-178,111.38888888888889,18,0,-194,0,-209,-239,-27,1
0,248,202,46,-527,-521,-6,119.0,12,11,-13,-4,163,-68,-114,1
0,410,0,410,-532,-720,188,230.21052631578948,19,204,0,0,418,121,-289,0
0,449,-416,865,-206,-239,33,261.93939393939394,33,79,-3,-1,876,162,-703,0
1,949,-476,1425,-144,-238,94,291.72727272727275,11,99,-4,1716,0,604,-821,0
0,836,-750,1586,-230,-169,-61,377.64285714285717,42,49,-59,0,1590,548,-1038,0
1,719,-505,1224,-223,-247,24,407.9,30,85,0,-5,1224,437,-787,0
1,338,318,20,-275,-272,-3,112.33333333333333,3,7,-1,0,44,47,27,1
0,521,845,-324,-229,-137,-92,210.0,16,0,-113,0,-337,218,542,1
1,670,645,25,-214,-221,7,140.5,2,7,0,0,25,376,351,1
1,564,-197,761,-234,-423,189,297.2307692307692,26,187,0,0,759,239,-522,0
1,439,446,-7,-242,-242,0,308.4117647058824,17,22,0,-13,530,136,143,0
1,858,-201,1059,-179,-288,109,454.8333333333333,24,126,0,-18,1061,580,-479,0
0,1283,526,757,-301,-141,-160,232.90625,32,0,-156,-2,759,985,228,1
1,1357,422,935,-194,-282,88,424.72727272727275,22,81,-8,0,940,1069,134,1
1,1688,1025,663,-224,-199,-25,348.57894736842104,19,0,-25,0,663,1389,726,1
0,369,882,-513,-279,29,-308,290.52941176470586,17,0,-92,0,-525,60,573,1
1,1476,1078,398,-171,47,-218,199.61904761904762,21,47,0,-3,406,1169,771,1
1,1883,968,915,-248,-127,-121,346.85185185185185,27,20,-48,0,912,1569,654,1
1,1097,649,448,-229,-92,-137,358.0769230769231,13,59,0,0,443,791,343,1
1,1798,835,963,-243,-150,-93,283.45714285714286,35,39,-80,-8,964,1509,546,1
1,628,-725,1353,-330,-347,17,379.04545454545456,44,19,-55,0,1701,337,-1016,0
1,1506,1059,447,-186,-174,-12,281.0,16,0,-12,-2,448,1197,750,1
1,875,-356,1231,-203,-312,109,418.6,10,180,-1,1627,-1,581,-650,0
1,1300,-693,1993,-161,-312,151,204.75,4,196,0,2058,0,979,-1014,0
0,1123,231,892,-376,-498,122,54.25,4,153,-5,949,0,808,-84,1
0,336,310,26,-542,-531,-11,161.41176470588235,17,8,-228,0,212,4,-22,1
0,1441,408,1033,-156,-125,-31,274.47222222222223,36,57,0,-2,1013,1156,123,1
0,714,-797,1511,-224,-113,-111,335.04347826086956,46,71,-115,0,1519,416,-1095,0
0,418,663,-245,-132,-207,75,5.0,1,86,-15,-245,0,120,365,1
0,1022,698,324,-188,-182,-6,55.0,3,0,-22,322,-46,714,390,1
1,124,-623,747,-286,-183,-103,104.6923076923077,13,6,-105,870,0,-202,-949,0
1,1516,973,543,-208,-231,23,256.23809523809524,21,19,-1,0,539,1200,657,1
1,1377,-581,1958,-219,-331,112,482.7317073170732,41,165,0,-2,1975,1073,-885,0
0,661,-872,1533,-311,-168,-143,314.6666666666667,48,12,-110,-7,1528,349,-1184,0
0,999,1527,-528,-136,-119,-17,211.75,24,11,-5,4,-524,617,1145,1
1,506,228,278,-239,-266,27,251.7,10,27,-2,0,282,178,-100,1
1,945,195,750,-254,-337,83,452.29411764705884,17,79,0,-2,752,616,-134,1
0,732,-1013,1745,-257,-128,-129,364.4166666666667,48,2,-136,0,1751,397,-1348,0
1,968,839,129,-190,-230,40,170.625,8,37,-3,-5,130,643,514,1
0,1419,722,697,231,-240,471,230.25806451612902,31,87,0,0,708,1098,401,1
1,869,-479,1348,-272,-294,22,380.74285714285713,35,47,-28,0,1348,556,-792,0
0,260,161,99,-423,-411,-12,276.97058823529414,34,18,-123,106,-936,-75,-174,1
1,625,630,-5,-97,74,-171,74.75,4,6,-24,41,-1,310,315,1
0,14,540,-526,-494,-144,-350,259.08,25,2,-347,0,-580,-280,246,1
0,1168,551,617,-222,-211,-11,183.53125,32,36,-17,0,613,869,252,1
1,1067,268,799,-279,-339,60,108.33333333333333,3,292,-22,856,0,722,-77,1
0,789,-967,1756,-282,-174,-108,362.1666666666667,48,18,-88,-7,1751,426,-1330,0
0,227,144,83,-562,-517,-45,270.7857142857143,28,2,-206,90,-748,-84,-167,1
0,360,443,-83,-264,-262,-2,86.33333333333333,15,25,-5,47,-93,49,132,1
0,659,-512,1171,-265,-241,-24,81.0,2,45,-22,1187,-3,347,-824,0
1,505,448,57,-190,-179,-11,51.0,1,12,-24,55,-23,193,136,1
1,422,-464,886,-230,-181,-49,234.92105263157896,38,38,-50,0,888,102,-784,0
0,1060,859,201,-175,-128,-47,120.75,16,124,0,0,211,737,536,1
0,536,-1192,1728,-246,-15,-231,358.5208333333333,48,32,-73,-3,1732,213,-1515,0
1,540,520,20,-125,49,-174,72.0,2,6,-17,36,-5,203,183,1
1,910,-636,1546,-267,-14,-253,543.6428571428571,28,78,-4,-5,1508,561,-985,0
1,498,413,85,-285,-34,-251,175.33333333333334,3,4,-4,-8,47,149,64,1
0,1,70,-69,-697,-614,-83,153.3,10,35,-297,-98,0,-391,-322,1
0,930,-845,1775,-159,-91,-68,385.5777777777778,45,139,-10,-10,1726,615,-1160,0
1,1091,746,345,-260,-175,-85,263.15384615384613,13,0,-22,0,335,760,415,1
1,13,25,-12,-428,-382,-46,113.5,2,5,-12,2,-19,-386,-374,1
1,482,-426,908,-241,-179,-62,310.4516129032258,31,41,0,-8,969,213,-695,0
1,520,562,-42,-143,-44,-99,90.5,4,36,-8,24,-26,164,206,1
1,793,-1249,2042,-180,21,-201,470.6111111111111,54,77,0,-3,2559,467,-1575,0
0,3,-187,190,-713,-491,-222,85.66666666666667,24,0,-218,0,201,-334,-524,0
0,1043,-1187,2230,-136,-40,-96,321.2647058823529,68,81,-19,0,2220,732,-1498,0
0,476,605,-129,-265,-26,-239,16.0,1,0,-150,-183,0,165,294,1
0,439,-553,992,-221,-29,-192,227.02380952380952,42,34,-29,-1,984,155,-837,0
0,364,384,-20,-524,-382,-142,102.875,8,23,-90,62,-19,16,36,1
0,269,336,-67,-535,-518,-17,104.77272727272727,22,3,-77,114,-84,-93,-26,1
0,1137,-1028,2165,-179,-18,-161,336.953125,64,66,-90,0,2169,815,-1350,0
1,603,-354,957,-193,-165,-28,348.55555555555554,9,86,0,1282,-10,275,-682,0
0,609,-1034,1643,-248,-38,-210,315.0,52,14,-122,0,1654,296,-1347,0
1,595,573,22,-142,-25,-117,71.33333333333333,6,22,-25,-54,8,282,260,1
0,1481,988,493,-159,-55,-104,177.66666666666666,27,11,-26,0,497,1185,692,1
1,508,492,16,-120,-20,-100,34.0,1,5,-39,36,0,194,178,1
1,821,-1932,2753,-188,33,-221,309.7191011235955,89,98,-74,0,2736,532,-2221,0
0,607,493,114,-62,19,-81,55.0,3,98,-12,178,-1,284,170,1
0,654,648,6,-293,-247,-46,44.5,2,0,-36,-24,15,335,329,1
0,757,1335,-578,-296,-41,-255,289.10526315789474,19,0,-85,0,-565,380,958,1
1,1073,1064,9,-106,-61,-45,112.0,1,5,-32,-3,12,717,708,1
1,614,607,7,-136,-130,-6,74.66666666666667,6,0,-6,51,-4,309,302,1
1,618,586,32,-132,7,-139,85.0,4,3,-35,-12,32,194,162,1
0,1209,24,1185,-172,-645,473,385.52941176470586,34,535,0,-6,1231,880,-305,0
0,34,420,-386,-641,-230,-411,212.24,25,0,-358,0,-452,-260,126,1
1,470,474,-4,-105,-2,-103,76.66666666666667,9,10,-29,-61,23,173,177,1
0,1014,586,428,-227,-107,-120,164.0,26,0,-116,0,438,737,309,1
0,1292,-270,1562,-190,-432,242,366.69767441860466,43,254,0,-3,1581,976,-586,0
1,448,493,-45,-230,-206,-24,180.11111111111111,18,81,-13,-49,326,167,212,1
0,840,465,375,-236,-137,-99,183.91666666666666,12,0,-78,353,-240,565,190,1
0,745,-961,1706,-223,-154,-69,360.9148936170213,47,82,-56,0,1718,458,-1248,0
0,430,497,-67,-271,-224,-47,170.7391304347826,23,2,-60,327,-65,137,204,1
1,758,286,472,-250,-286,36,441.72727272727275,11,40,-10,-11,464,451,-21,1
0,430,-394,824,-230,-192,-38,68.0,2,13,-25,852,-1,89,-735,0
1,1245,114,1131,-207,-167,-40,306.69444444444446,36,55,-1,0,1101,1030,-101,1
1,422,145,277,-225,-311,86,291.22222222222223,18,101,-18,-2,533,107,-170,0
0,191,-1058,1249,-224,-164,-60,361.969696969697,33,11,-33,0,1244,-102,-1351,0
0,464,-407,871,-224,-216,-8,7.0,1,19,-11,884,0,154,-717,0
1,962,926,36,-212,-185,-27,318.65384615384613,26,84,-16,855,0,649,613,1
1,779,739,40,-141,-149,8,55.666666666666664,3,14,0,0,29,503,463,1
0,422,277,145,-196,-313,117,228.0,14,117,0,0,309,99,-46,1
1,937,-607,1544,-171,-221,50,402.7368421052632,38,84,-12,-1,1538,633,-911,0
0,696,1439,-743,-269,-225,-44,233.2258064516129,31,39,-1,2,-746,373,1116,1
0,204,-206,410,-560,-479,-81,169.84,25,11,-45,0,439,-114,-524,0
0,423,-808,1231,-243,-196,-47,251.04166666666666,48,61,-36,-2,1223,103,-1128,0
1,1105,287,818,-190,-300,110,33.666666666666664,6,111,-4,810,-68,764,-54,1
0,1250,-1919,3169,-115,-85,-30,498.625,64,201,-36,-7,3178,981,-2188,0
0,992,600,392,-231,-151,-80,181.86363636363637,22,0,-83,0,399,667,275,1
0,446,611,-165,-260,-227,-33,175.52631578947367,19,55,-1,-173,351,135,300,1
0,1457,467,990,-98,-108,10,264.55263157894734,38,73,0,0,1010,1141,151,1
0,424,-486,910,-199,-113,-86,250.13513513513513,37,31,-83,0,920,106,-804,0
1,807,420,387,-205,-276,71,357.8181818181818,11,68,0,-12,382,455,68,1
0,1378,1529,-151,-154,-52,-102,78.73333333333333,15,0,-96,10,-157,1043,1194,1
1,928,698,230,-142,-197,55,173.23076923076923,13,3,-13,-2,224,621,391,1
0,434,-411,845,-234,-257,23,238.77142857142857,35,56,0,-7,846,123,-722,0
1,491,606,-115,-227,-237,10,238.91666666666666,24,37,0,456,-112,186,301,1
1,1933,1298,635,-234,-184,-50,307.6,20,11,-50,0,622,1638,1003,1
0,878,335,543,-131,-230,99,203.30769230769232,26,99,0,-2,538,607,64,1
1,1289,440,849,-203,-200,-3,270.5897435897436,39,31,-32,0,850,956,107,1
0,1,-16,17,-703,-686,-17,146.2,5,53,-346,94,-4,-323,-340,0
0,1062,1041,21,-167,-71,-96,89.11111111111111,18,44,-36,209,0,751,730,1
0,206,196,10,-480,-444,-36,128.875,8,26,-111,-12,61,-77,-87,1
0,1922,1886,36,-69,-4,-65,98.0,13,49,-15,161,0,1611,1575,1
1,690,68,622,-191,-550,359,354.81481481481484,27,413,0,0,881,405,-217,0
0,771,1140,-369,-129,-8,-121,145.65217391304347,23,74,0,3,-362,450,819,1
1,1543,1333,210,-153,-170,17,230.2,10,29,-29,0,216,1238,1028,1
0,333,444,-111,-247,-176,-71,159.55555555555554,9,0,-64,0,-145,42,153,1
1,1095,1053,42,-173,-168,-5,349.5,22,97,-6,813,-9,773,731,1
0,250,-316,566,-491,-536,45,211.60714285714286,28,96,0,0,582,-29,-595,0
1,458,423,35,-117,-43,-74,51.833333333333336,6,8,-9,-12,48,161,126,1
0,1280,-1,1281,-277,-776,499,479.9655172413793,29,523,0,0,1316,966,-315,0
0,750,-278,1028,-216,-330,114,328.09090909090907,33,288,0,0,1022,462,-566,0
0,405,-866,1271,-239,5,-244,354.6857142857143,35,41,-60,0,1255,134,-1137,0
1,455,-1910,2365,-208,-58,-150,490.5833333333333,48,103,-5,0,2361,177,-2188,0
0,236,333,-97,-480,-480,0,121.0,6,12,0,0,-85,-75,22,1
1,1122,693,429,-229,-277,48,317.7142857142857,14,34,-27,-4,425,808,379,1
0,536,-393,929,-220,-127,-93,245.68421052631578,38,48,-16,-7,982,191,-738,0
0,602,302,300,-414,-317,-97,34.0,2,114,0,336,0,283,-17,1
0,172,-118,290,-365,-171,-194,94.75862068965517,29,0,-137,0,297,-100,-390,0
0,457,209,248,-220,-425,205,110.33333333333333,45,270,-27,0,369,166,-82,1
0,253,-255,508,-465,-364,-101,218.95652173913044,23,51,-33,0,524,-42,-550,0
0,28,217,-189,-512,-364,-148,125.3125,16,0,-35,0,-208,-261,-72,1
0,207,250,-43,-571,-446,-125,150.07692307692307,26,33,-294,-43,284,-94,-51,0
1,1154,794,360,-256,-705,449,428.4166666666667,12,491,0,865,-5,808,448,1
1,1529,1174,355,-336,-281,-55,145.04166666666666,24,0,-53,0,353,1246,891,1
0,184,705,-521,-292,-273,-19,303.7,10,22,-19,-521,321,-113,408,0
0,663,770,-107,-208,-65,-143,67.3913043478261,23,14,-155,0,-198,362,469,1
0,60,2070,-2010,-503,-210,-293,334.55,60,13,-302,0,-2010,-241,1769,1
0,14,1248,-1234,-370,-197,-173,228.44444444444446,54,0,-173,0,-1243,-287,947,1
0,177,799,-622,-430,-163,-267,145.27272727272728,11,0,-277,-731,0,-113,509,1
0,1386,-7,1393,-253,-829,576,294.3137254901961,51,586,0,0,1419,1107,-286,0
0,1456,1891,-435,-150,-193,43,165.53846153846155,26,56,-37,2,-441,1136,1571,1
0,1371,445,926,-244,-250,6,286.1290322580645,31,8,-22,0,926,1080,154,1
0,244,-2200,2444,-427,-218,-209,474.61538461538464,52,0,-214,0,2448,-76,-2520,0
1,285,282,3,-486,-363,-123,23.142857142857142,7,9,-16,58,-7,-75,-78,1
1,693,707,-14,-233,-237,4,391.8181818181818,11,129,-4,406,-4,333,347,1
1,464,-510,974,-263,-263,0,287.52941176470586,34,53,-3,0,976,172,-802,0
0,516,992,-476,-84,-83,-1,175.24,25,28,-14,0,-482,201,677,1
0,1542,495,1047,-232,-211,-21,279.57894736842104,38,0,-54,-1,1077,1234,187,1
0,1,-2,3,-822,-757,-65,209.4,5,0,-471,-60,14,-274,-277,0
0,20,16,4,-839,-731,-108,132.71428571428572,7,1,-388,65,0,-287,-291,0
0,230,239,-9,-566,-613,47,150.5,18,25,-244,-13,148,-87,-78,1
0,551,733,-182,-95,17,-112,99.47058823529412,17,9,-27,9,-187,251,433,1
0,299,197,102,-480,-471,-9,83.66666666666667,3,35,-181,224,-1,-22,-124,1
0,188,182,6,-462,-546,84,187.45714285714286,35,94,-275,83,-608,-113,-119,1
0,275,832,-557,-488,-207,-281,239.56,25,8,-256,5,-543,-126,431,1
0,909,-993,1902,-312,-198,-114,350.2962962962963,54,14,-122,-3,1900,558,-1344,0
1,1012,728,284,-209,-263,54,269.2,10,59,0,-8,279,666,382,1
1,696,102,594,-184,-608,424,385.44444444444446,9,492,0,888,0,392,-202,0
0,523,-524,1047,-194,-142,-52,304.8529411764706,34,58,-56,0,1042,172,-875,0
1,998,442,556,-32,-279,247,420.53846153846155,13,103,-11,-12,534,682,126,1
0,500,-525,1025,-171,-129,-42,283.55555555555554,36,68,-38,-3,1019,152,-873,0
1,1002,793,209,-220,-240,20,287.7142857142857,7,23,-13,0,204,626,417,1
0,513,201,312,-242,-371,129,3.0,1,144,0,299,-15,141,-171,1
1,999,460,539,-263,-369,106,394.07142857142856,14,95,-9,-4,531,708,169,1
0,757,-456,1213,-196,-184,-12,71.0,6,40,-27,1223,-2,265,-948,0
1,2128,1506,622,-195,-217,22,276.39130434782606,23,41,-7,-9,632,1817,1195,1
0,514,-478,992,-193,-257,64,83.5,2,70,0,1017,0,154,-838,0
1,1902,1374,528,-254,-329,75,174.67741935483872,31,81,-4,0,535,1617,1089,1
0,250,-1775,2025,-209,-161,-48,336.0,59,3,-49,0,2027,-71,-2096,0
1,1462,1045,417,-217,49,-266,151.84,25,24,-19,0,403,1145,728,1
0,1274,413,861,-273,-155,-118,255.06060606060606,33,37,-84,0,861,1007,146,1
0,231,-188,419,-549,-476,-73,196.56521739130434,23,21,-35,-1,466,-66,-485,0
0,1491,927,564,-180,-63,-117,156.33333333333334,36,52,-1,0,593,1196,632,1
1,836,360,476,-161,-177,16,169.8709677419355,31,93,-9,-3,519,518,42,1
1,351,335,16,-319,-321,2,177.0,1,2,0,0,16,49,33,1
1,1746,1147,599,-191,-211,20,223.37037037037038,27,46,0,-13,597,1432,833,1
1,1224,384,840,-180,-293,113,480.3333333333333,18,113,-12,0,847,911,71,1
0,196,-1791,1987,-455,-120,-335,353.62068965517244,58,0,-343,0,2004,-121,-2108,0
1,878,431,447,-218,-219,1,222.35,20,10,-3,-1,448,610,163,1
0,1302,716,586,-191,-62,-129,229.8,25,34,0,0,592,1013,427,1
0,662,-640,1302,-302,-216,-86,84.05882352941177,17,40,-100,1310,0,315,-987,0
0,1087,967,120,-162,-213,51,110.18181818181819,11,41,-3,-11,121,800,680,1
1,868,-1167,2035,-119,-205,86,388.64814814814815,54,252,0,-1,2036,544,-1491,0
1,983,-417,1400,-186,-290,104,514.3928571428571,28,137,-18,-7,1400,663,-737,0
0,544,-950,1494,-306,59,-365,448.6666666666667,33,33,-163,0,1495,240,-1254,0
1,669,478,191,-224,-238,14,228.5,8,47,0,-2,178,337,146,1
0,509,491,18,-98,-132,34,158.9047619047619,21,180,-5,291,0,174,156,1
1,180,633,-453,-292,-166,-126,133.28571428571428,7,7,-37,-445,102,-165,288,1
1,1120,-409,1529,-213,-280,67,439.8857142857143,35,66,0,0,1556,825,-704,0
0,251,-2216,2467,-425,-178,-247,424.45762711864404,59,0,-242,0,2466,-109,-2576,0
0,140,-1893,2033,-533,7,-540,400.1320754716981,53,9,-481,-17,2047,-205,-2238,0
1,398,568,-170,-274,-184,-90,125.125,16,0,-91,0,-198,66,236,1
0,765,-1159,1924,-260,-114,-146,475.3658536585366,41,38,-83,0,1972,460,-1464,0
0,1652,1530,122,-82,-12,-70,69.9375,16,1,-20,0,167,1347,1225,1
0,228,-2138,2366,-461,-182,-279,414.6842105263158,57,0,-239,0,2363,-111,-2477,0
0,1246,-615,1861,-219,-214,-5,305.3731343283582,67,60,-29,-219,1851,989,-872,0
1,1580,784,796,-194,-189,-5,284.60714285714283,28,35,-8,-9,795,1238,442,1
0,217,-224,441,-497,-457,-40,21.0,1,63,-38,442,-18,-98,-539,0
0,384,-587,971,-294,-209,-85,249.5,38,9,-85,-2,972,60,-911,0
0,356,-543,899,-231,-165,-66,269.5,32,8,-58,0,900,39,-860,0
0,396,-469,865,-280,-153,-127,218.0,42,9,-49,0,907,77,-788,0
1,1005,-260,1265,-209,-306,97,317.5,6,99,0,1428,-3,675,-590,0
0,536,711,-175,-89,-5,-84,88.6,15,0,-36,0,-161,177,352,1
0,790,1238,-448,-211,-33,-178,133.8125,32,3,-122,2,-442,431,879,1
0,692,2097,-1405,-122,-80,-42,327.5952380952381,42,20,-8,0,-1392,333,1738,1
1,737,269,468,-171,-416,245,236.75,24,297,-1,-2,480,451,-17,1
0,493,582,-89,-75,-163,88,38.75,4,119,0,-134,10,56,145,1
1,558,510,48,-141,-183,42,298.7317073170732,41,210,0,1292,-2,242,194,0
0,149,1118,-969,-266,-125,-141,395.5416666666667,24,5,-121,0,-972,-190,779,1
1,37,22,15,-875,-805,-70,80.0,7,81,-64,-34,13,-274,-289,1
1,587,522,65,-131,-169,38,76.14285714285714,14,100,-28,-8,72,219,154,1
0,809,-391,1200,-206,-193,-13,292.575,40,68,0,0,1212,441,-759,0
1,476,480,-4,-212,-199,-13,34.9,10,97,-12,5,-64,154,158,1
1,243,212,31,-454,-248,-206,72.5,14,8,-55,76,-42,-55,-86,1
1,479,502,-23,350,356,-6,1.0,2,26,-58,21,-32,124,147,1
0,1607,663,944,-166,-86,-80,65.75,4,16,-53,958,0,1272,328,1
1,1196,1158,38,-193,-179,-14,97.71428571428571,7,61,0,0,55,828,790,1
0,838,-876,1714,-293,-252,-41,348.6666666666667,48,41,-50,0,1709,506,-1208,0
1,523,519,4,-106,-113,7,140.0,2,9,-78,31,0,193,189,1
0,42,2,40,-729,-737,8,146.0,1,25,-232,-19,45,-260,-300,0
0,773,788,-15,-195,-191,-4,20.8,5,0,-23,-51,3,460,475,1
0,648,1246,-598,-319,-68,-251,290.22727272727275,22,0,-137,0,-680,354,952,1
0,544,-476,1020,-393,-157,-236,72.72727272727273,11,0,-122,978,-70,250,-770,0
0,1383,257,1126,-305,-532,227,56.0,5,253,0,1148,0,1047,-79,1
0,448,565,-117,-253,-55,-198,239.7826086956522,23,48,-55,462,-92,111,228,1
1,940,212,728,-163,-240,77,382.63157894736844,19,63,0,-3,726,633,-95,1
1,1151,1169,-18,-99,-59,-40,23.0,4,0,-35,-48,6,823,841,1
1,912,423,489,-178,-257,79,347.7142857142857,14,97,0,-6,485,561,72,1
1,933,200,733,-201,-215,14,500.26666666666665,15,66,-9,-10,744,594,-139,1
0,515,472,43,-52,57,-109,64.0,1,1,-14,20,-6,193,150,1
1,10,-38,48,-743,-709,-34,49.0,1,0,-13,54,-8,-349,-397,0
0,1396,387,1009,-261,-510,249,238.2826086956522,46,306,0,0,1064,1069,60,1
1,663,686,-23,-180,-107,-73,20.333333333333332,3,0,-26,-69,0,339,362,1
1,0,-16,16,-798,-726,-72,87.4,5,49,-51,30,-9,-342,-358,0
0,315,375,-60,-636,-626,-10,39.0,1,128,-6,-59,18,-65,-5,1
0,181,189,-8,-514,-583,69,136.78947368421052,19,111,-263,-43,206,-108,-100,0
1,344,385,-41,-543,-503,-40,90.8,5,3,-15,34,-32,-7,34,1
1,1294,1300,-6,-172,-87,-85,8.0,1,6,-60,14,-17,943,949,1
1,885,586,299,-295,-155,-140,91.83333333333333,6,0,-115,382,0,534,235,1
1,286,-247,533,-566,-442,-124,184.38709677419354,31,3,-70,0,576,-92,-625,0
0,436,648,-212,-363,-215,-148,168.6,15,0,-145,0,-236,79,291,1
0,857,-1143,2000,-173,-142,-31,343.0877192982456,57,83,-53,-2,1981,574,-1426,0
1,23,22,1,-872,-763,-109,134.5,4,24,-94,-10,39,-346,-347,0
1,778,988,-210,-235,-197,-38,135.46666666666667,15,0,-38,0,-211,444,654,1
0,442,-450,892,-139,-186,47,261.70588235294116,34,149,-5,-7,887,153,-739,0
0,190,871,-681,-507,-149,-358,239.6875,32,0,-360,16,-679,-118,563,1
1,1108,278,830,-169,-360,191,506.2352941176471,17,180,-11,-7,828,831,1,1
1,21,155,-134,-466,-502,36,123.72727272727273,22,31,-1,13,-143,-280,-146,1
0,217,-4,221,-510,-752,242,107.1304347826087,23,256,-153,-1,235,-78,-299,0
1,872,569,303,-219,-239,20,321.8,10,50,0,-7,311,570,267,1
0,63,-216,279,-582,-481,-101,163.0,17,7,-104,0,276,-222,-501,0
1,2053,1190,863,-306,-200,-106,323.51851851851853,27,0,-106,0,862,1746,883,1
0,591,-1201,1792,-261,-153,-108,335.2830188679245,53,3,-106,0,1787,293,-1499,0
0,225,-229,454,-477,-461,-16,201.25,24,73,-18,-8,462,-77,-531,0
0,584,-192,776,-185,-408,223,240.6764705882353,34,254,0,0,783,317,-459,0
0,599,-497,1096,260,167,93,358.6333333333333,30,17,-61,0,1099,311,-785,0
0,348,-397,745,-208,-142,-66,47.0,2,41,-66,778,0,31,-714,0
0,924,1343,-419,-181,-15,-166,164.80851063829786,47,113,-104,347,-424,617,1036,1
0,161,-188,349,-458,-396,-62,120.8076923076923,26,42,-12,-2,360,-127,-476,0
1,653,-798,1451,-242,-248,6,473.258064516129,31,14,-11,-7,1462,365,-1086,0
0,76,2,74,-300,-522,222,118.2,5,256,0,0,87,-212,-286,0
0,183,450,-267,-247,-212,-35,215.76923076923077,13,0,-24,0,-299,-149,118,1
1,1033,338,695,-211,-291,80,426.8235294117647,17,91,-11,-15,696,757,62,1
0,1421,425,996,-142,-98,-44,202.7659574468085,47,99,-42,0,1020,1159,163,1
0,1126,575,551,-414,-193,-221,200.73333333333332,30,6,-81,0,630,845,294,1
1,883,609,274,-298,-284,-14,280.0,10,8,-2,-18,258,632,358,1
1,645,154,491,-220,-320,100,413.8333333333333,12,100,0,-5,484,352,-139,1
1,644,-614,1258,-285,-236,-49,294.9047619047619,42,6,-53,0,1256,375,-883,0
0,358,-598,956,-271,-184,-87,291.75,32,22,-76,0,961,53,-903,0
1,1486,772,714,-260,-183,-77,266.55555555555554,27,0,-66,0,721,1164,450,1
0,1357,218,1139,-316,-508,192,306.57894736842104,38,222,-2,-3,1166,1060,-79,1
0,1317,224,1093,-167,-493,326,279.1666666666667,42,349,0,0,1141,1013,-80,1
1,352,-448,800,-279,-250,-29,317.8076923076923,26,61,-36,0,806,75,-725,0
1,871,-247,1118,-186,-310,124,417.64285714285717,14,152,-8,1678,-3,507,-611,0
0,276,502,-226,-277,-220,-57,95.47826086956522,23,6,-63,1,-235,-40,186,1
0,1205,711,494,-220,-147,-73,177.73333333333332,30,38,-80,0,542,904,410,1
0,238,238,0,-443,-453,10,87.52380952380952,21,19,-115,137,-7,-97,-97,1
1,1096,612,484,-249,-308,59,382.84615384615387,13,56,-9,0,485,787,303,1
1,826,-495,1321,-164,-276,112,358.54347826086956,46,113,-2,-5,1650,528,-793,0
1,1639,490,1149,-208,-55,-153,254.04651162790697,43,22,-13,-5,1142,1332,183,1
0,542,-467,1009,-227,-192,-35,281.30555555555554,36,18,-35,0,1025,261,-748,0
1,616,-1277,1893,-211,-242,31,485.6666666666667,39,48,-5,-4,1892,312,-1581,0
0,204,-252,456,-575,-468,-107,174.65384615384616,26,47,0,0,477,-132,-588,0
1,1586,614,972,-212,-55,-157,285.5882352941176,34,23,-39,0,974,1268,296,1
1,588,651,-63,-175,-102,-73,282.0,18,74,0,429,-62,238,301,1
1,320,-996,1316,-277,-200,-77,410.15625,32,0,-79,0,1317,35,-1281,0
0,480,-500,980,-225,-227,2,304.59375,32,63,-12,0,989,189,-791,0
1,495,491,4,-252,-131,-121,299.23809523809524,21,22,-15,-1,659,222,218,0
1,524,-385,909,-131,-62,-69,243.0810810810811,37,37,-3,0,920,200,-709,0
1,336,-189,525,-490,-376,-114,104.0,11,64,-79,544,0,-14,-539,0
1,1894,1374,520,-250,-267,17,220.95652173913044,23,10,-17,0,521,1570,1050,1
1,1081,251,830,-220,-202,-18,379.27272727272725,22,54,-5,0,834,762,-68,1
1,496,-565,1061,-213,-212,-1,368.6896551724138,29,55,-8,-15,1062,173,-888,0
0,233,311,-78,-477,-404,-73,183.21621621621622,37,44,-31,483,-110,-110,-32,0
1,1133,1211,-78,-219,-175,-44,398.04761904761904,21,77,-19,714,-104,806,884,1
1,278,-1226,1504,-607,-749,142,548.3571428571429,28,156,0,-1,1506,-61,-1565,0
1,1039,-683,1722,-261,-802,541,599.2258064516129,31,543,-4,-11,1717,707,-1015,0
0,118,254,-136,-518,-551,33,134.66666666666666,9,58,0,0,-136,-180,-44,1
0,19,226,-207,-728,-403,-325,195.42105263157896,19,0,-227,132,-211,-293,-86,0
1,923,810,113,-393,-232,-161,89.875,24,0,-164,95,-169,585,472,1
1,915,1317,-402,-542,-46,-496,211.03389830508473,59,0,-394,0,-1216,573,975,1
1,1459,1422,37,-176,-113,-63,154.375,8,19,-6,-102,52,1166,1129,1
0,549,-882,1431,-310,-151,-159,208.3815789473684,76,0,-146,-174,1438,252,-1179,0
0,212,-214,426,-483,-392,-91,126.23076923076923,39,0,-172,-17,438,-85,-511,0
0,595,223,372,-182,-403,221,229.26315789473685,19,213,0,0,406,315,-57,1
0,216,1272,-1056,-449,-6,-443,100.45454545454545,11,0,-440,-1165,0,-97,959,1
0,278,476,-198,-263,-91,-172,158.75,32,0,-155,0,-496,-19,179,1
1,1028,-177,1205,-208,-342,134,529.304347826087,23,132,0,0,1203,711,-494,0
0,456,-479,935,-180,-233,53,255.05405405405406,37,91,-4,-4,954,166,-769,0
0,445,-851,1296,-276,-234,-42,415.741935483871,31,30,-49,0,1304,161,-1135,0
1,1511,686,825,-171,-276,105,88.0,5,107,0,823,-62,1155,330,1
1,1027,-946,1973,-294,-372,78,580.6764705882352,34,78,-10,-5,1972,718,-1255,0
0,663,-1259,1922,-235,-81,-154,321.6,60,69,-56,0,1957,343,-1579,0
0,592,-1961,2553,-308,-33,-275,406.8412698412698,63,31,-177,0,2591,272,-2281,0
1,951,-442,1393,-176,-336,160,572.48,25,167,0,-4,1398,660,-733,0
0,181,206,-25,-264,-485,221,196.2941176470588,17,240,0,275,-30,-109,-84,0
1,572,-1211,1783,-362,-199,-163,256.3835616438356,73,0,-180,-97,1789,258,-1525,0
0,890,782,108,-197,-120,-77,62.333333333333336,9,0,-40,92,-72,543,435,1
0,164,-1041,1205,-288,-39,-249,282.95348837209303,43,0,-191,0,1225,-160,-1365,0
1,741,-1299,2040,-264,-244,-20,393.25,52,64,-23,0,2039,428,-1612,0
1,588,-814,1402,-225,-170,-55,378.4864864864865,37,90,-8,0,1416,245,-1157,0
0,251,231,20,-535,-464,-71,156.8695652173913,23,1,-161,-12,338,-64,-84,0
1,647,-461,1108,-260,-274,14,448.32,25,18,-24,-1,1109,337,-771,0
1,814,491,323,-269,-320,51,317.0,11,40,-14,-5,323,516,193,1
0,510,-586,1096,-215,-196,-19,310.94594594594594,37,56,-53,0,1150,221,-875,0
0,185,1341,-1156,-658,-161,-497,345.77777777777777,36,0,-479,0,-1182,-134,1022,1
0,205,-183,388,-483,-459,-24,187.95454545454547,22,46,-10,-11,416,-107,-495,0
0,800,465,335,-65,-157,92,162.15384615384616,26,120,-13,-67,367,488,153,1
0,656,-850,1506,-222,-138,-84,321.70212765957444,47,43,-56,0,1515,364,-1142,0
0,1068,-19,1087,-196,-807,611,342.3888888888889,36,603,0,-3,1102,766,-321,0
1,1599,968,631,-132,-185,53,302.8181818181818,22,56,0,-4,659,1302,671,1
1,1241,260,981,-139,-253,114,386.6923076923077,26,122,-4,-1,1006,949,-32,1
0,277,-506,783,-270,-156,-114,260.8,30,11,-114,0,783,-15,-798,0
1,599,415,184,-191,-230,39,292.57142857142856,7,57,-1,-2,190,143,-41,1
0,885,1304,-419,-490,-83,-407,267.52941176470586,17,0,-236,0,-430,589,1008,1
0,270,-678,948,-300,-257,-43,298.34375,32,17,-67,0,961,-18,-966,0
1,692,461,231,-282,-253,-29,255.66666666666666,21,13,-15,-8,545,396,165,1
0,2154,-262,2416,-202,-563,361,463.0,53,391,0,-8,2428,1866,-550,0
0,1896,-203,2099,-350,-467,117,387.8545454545455,55,230,-8,-1,2121,1605,-494,0
0,944,-1065,2009,-233,-238,5,283.59154929577466,71,58,-23,-8,2012,623,-1386,0
0,1063,496,567,-236,-183,-53,270.3809523809524,21,14,-58,0,587,769,202,1
0,77,-1173,1250,-461,-164,-297,371.55882352941177,34,0,-297,0,1253,-217,-1467,0
0,1655,-251,1906,-281,-479,198,386.47058823529414,51,282,-8,-10,1928,1343,-563,0
0,1199,601,598,-148,-140,-8,185.16129032258064,31,36,-6,0,598,908,310,1
1,14,544,-530,-757,-261,-496,474.93333333333334,15,4,-489,72,-536,-282,248,0
1,860,-252,1112,-174,-240,66,531.8571428571429,21,123,-10,-1,1114,591,-521,0
0,1,205,-204,-768,-566,-202,163.0,15,1,-200,2,-208,-314,-110,0
0,648,-1146,1794,-247,-122,-125,301.40677966101697,59,59,-122,-7,1795,367,-1427,0
1,186,-215,401,-508,-286,-222,310.6875,16,11,-219,-9,402,-95,-496,0
0,249,421,-172,-410,-235,-175,128.94117647058823,17,0,-180,17,-173,-54,118,1
0,408,401,7,-197,-208,11,215.57142857142858,21,37,0,0,456,114,107,0
0,1851,193,1658,-72,-242,170,315.9230769230769,52,201,-13,0,1641,1547,-111,1
1,424,-85,509,-211,-260,49,376.0,14,52,-26,-13,517,116,-393,0
0,1244,-212,1456,-256,-559,303,69.0,3,303,-3,1491,-8,941,-515,0
0,441,216,225,-253,-417,164,152.1578947368421,19,187,-4,0,243,159,-66,1
0,599,276,323,-190,-370,180,55.0,1,206,0,360,-1,293,-30,1
1,1185,865,320,-217,-128,-89,292.3636363636364,11,3,-9,0,328,885,565,1
1,829,586,243,-186,-308,122,278.8,10,138,-1,-2,241,563,320,1
1,755,801,-46,-299,-194,-105,95.0,8,0,-19,0,-73,456,502,1
0,314,323,-9,-477,-486,9,60.8,20,2,-34,129,-5,-13,-4,1
1,281,307,-26,-523,-518,-5,91.75,4,0,-5,18,-26,-18,8,1
0,1517,775,742,-184,-128,-56,217.5,34,25,-56,-9,739,1253,511,1
0,723,-907,1630,-227,-160,-67,375.9767441860465,43,17,-113,0,1621,452,-1178,0
1,1005,347,658,-223,-325,102,424.5625,16,109,0,-5,657,700,42,1
1,1841,566,1275,-226,-166,-60,354.1666666666667,36,42,0,0,1269,1548,273,1
0,471,-466,937,-223,-160,-63,254.02777777777777,36,19,-3,-5,942,171,-766,0
1,1197,447,750,-173,-245,72,450.8235294117647,17,72,0,0,751,907,157,1
0,169,-1518,1687,-490,-84,-406,352.625,48,0,-335,0,1673,-133,-1820,0
0,470,-426,896,-190,-228,38,302.56666666666666,30,62,0,0,909,134,-762,0
1,978,-1029,2007,-292,-140,-152,457.3181818181818,44,60,-6,0,2014,674,-1333,0
1,1257,-1112,2369,-153,-67,-86,474.4,50,84,-7,0,2377,946,-1423,0
0,900,430,470,-159,-198,39,206.77272727272728,22,48,0,0,469,552,82,1
1,1421,576,845,-206,-248,42,514.8235294117648,17,106,-6,-5,858,1087,242,1
1,1720,1163,557,-177,-141,-36,199.25,28,19,-14,-4,555,1382,825,1
0,252,19,233,-552,-716,164,30.0,1,186,-2,269,-3,-70,-303,0
0,241,-446,687,-533,-169,-364,243.43333333333334,30,6,-255,-6,699,-64,-751,0
0,448,-537,985,-235,-115,-120,282.6857142857143,35,33,-30,0,988,146,-839,0
1,1059,536,523,-187,-268,81,374.2857142857143,14,95,-4,0,516,765,242,1
1,2050,1407,643,-143,-76,-67,212.43333333333334,30,50,-2,0,648,1724,1081,1
0,1728,740,988,-208,-195,-13,207.6304347826087,46,9,-36,0,988,1435,447,1
0,515,-514,1029,-171,-63,-108,279.2432432432432,37,73,0,-10,1043,189,-840,0
0,488,-587,1075,-193,-82,-111,67.0,1,50,-50,1071,-14,204,-871,0
1,867,-374,1241,-171,-202,31,253.875,8,64,0,1446,0,526,-715,0
0,890,-1014,1904,-156,-145,-11,412.54347826086956,46,148,0,0,1899,579,-1325,0
0,526,-537,1063,-213,-7,-206,267.1794871794872,39,0,-63,-3,1064,197,-866,0
0,426,200,226,-235,-241,6,235.3181818181818,22,103,-5,-4,524,136,-90,0
0,1249,-479,1728,-280,-186,-94,374.5217391304348,46,28,-72,-5,1731,970,-758,0
0,8,-212,220,-793,-472,-321,154.55,20,0,-325,-6,227,-258,-478,0
0,1166,269,897,-194,-181,-13,301.46666666666664,30,73,-1,0,922,993,96,1
0,248,-801,1049,-673,-135,-538,287.1463414634146,41,0,-540,-31,1050,-77,-1126,0
1,917,619,298,-203,-253,50,299.8,10,50,-2,-1,297,610,312,1
1,1955,1468,487,-156,-147,-9,247.57894736842104,19,12,-7,0,487,1625,1138,1
0,256,304,-48,-469,-468,-1,118.35714285714286,14,39,-168,100,-55,-55,-7,1
1,1,-1440,1441,-646,-314,-332,458.55882352941177,34,17,-329,-2,1441,-317,-1758,0
0,701,-1121,1822,-270,-185,-85,411.59090909090907,44,78,-88,-2,1827,385,-1437,0
0,1272,1313,-41,-241,-157,-84,99.1875,16,0,-53,26,-111,980,1021,1
1,557,-465,1022,-183,-220,37,260.275,40,109,-22,-3,1024,263,-759,0
0,1601,965,636,-189,-181,-8,166.72972972972974,37,18,-8,-6,640,1314,678,1
0,424,1554,-1130,-530,-135,-395,315.72972972972974,37,0,-418,0,-1140,134,1264,1
1,1996,1506,490,-136,-263,127,260.8421052631579,19,135,0,0,489,1647,1157,1
1,1809,823,986,-159,-163,4,363.962962962963,27,62,0,0,984,1510,524,1
0,6,-606,612,-474,-174,-300,251.53846153846155,26,0,-302,0,613,-289,-901,0
1,1117,-175,1292,-202,-325,123,534.36,25,128,-1,-11,1294,820,-472,0
1,730,312,418,-229,-232,3,333.8333333333333,12,46,0,0,391,449,31,1
1,504,-455,959,-284,-286,2,539.3888888888889,18,6,0,-1,961,199,-760,0
1,442,-308,750,-261,-260,-1,507.6666666666667,15,3,-1,0,752,119,-631,0
0,33,215,-182,-792,-540,-252,10.0,1,0,-253,-193,7,-260,-78,1
0,545,-436,981,-231,-305,74,300.06060606060606,33,78,0,-15,985,252,-729,0
1,1451,365,1086,-261,-387,126,533.047619047619,21,128,0,0,1089,1152,66,1
0,497,490,7,-238,-242,4,155.9,20,31,-8,320,-3,184,177,1
1,1743,1091,652,-174,-180,6,264.36,25,26,-1,-13,654,1445,793,1
0,467,253,214,-368,-490,122,178.83333333333334,12,116,0,0,208,192,-22,1
1,722,-515,1237,-189,-255,66,335.64864864864865,37,127,-2,0,1237,431,-806,0
0,1567,496,1071,-145,-246,101,332.71875,32,106,-2,-8,1076,1276,205,1
1,1479,702,777,-199,-177,-22,227.96969696969697,33,26,-11,0,773,1333,556,1
0,1214,546,668,-98,-114,16,211.875,32,95,0,-4,671,934,266,1
0,1294,955,339,-252,-203,-49,132.2,25,1,-52,0,357,987,648,1
1,220,-481,701,-503,-534,31,438.4375,16,117,-3,-9,685,-113,-814,0
0,290,-545,835,-260,-175,-85,305.77777777777777,27,5,-92,0,838,-11,-846,0
1,249,-10,259,-573,-592,19,277.4,10,51,-4,-9,270,-39,-298,0
0,923,-799,1722,-300,-87,-213,345.16326530612247,49,17,-103,-1,1699,608,-1114,0
1,242,-47,289,-556,-557,1,342.3333333333333,9,33,0,-3,295,-59,-348,0
1,591,-363,954,-182,-285,103,348.92857142857144,28,118,-3,-3,966,281,-673,0
0,1163,440,723,-138,-215,77,179.0,36,109,-26,0,715,862,139,1
0,119,-455,574,-369,-146,-223,245.5,20,0,-235,650,-493,-185,-759,0
1,198,-201,399,-528,-482,-46,226.47368421052633,19,37,-13,-6,423,-126,-525,0
1,1156,603,553,-185,-503,318,319.10526315789474,19,319,0,0,555,846,293,1
1,1847,1180,667,-167,-151,-16,251.85185185185185,27,57,0,0,680,1541,874,1
1,623,10,613,-260,-626,366,282.9142857142857,35,360,0,0,966,308,-305,0
1,739,571,168,-224,-290,66,236.375,8,66,-16,-8,163,464,296,1
0,254,1307,-1053,-475,-255,-220,282.5,38,0,-229,2,-1062,-80,973,1
1,1485,898,587,-233,-310,77,369.125,16,77,0,0,587,1186,599,1
0,1860,524,1336,-233,-186,-47,287.8510638297872,47,56,-14,0,1364,1569,233,1
1,1045,-512,1557,-223,-329,106,546.0689655172414,29,110,-5,0,1559,710,-847,0
0,310,276,34,-512,-529,17,92.35714285714286,14,112,-35,160,0,1,-33,1
0,220,255,-35,-526,-382,-144,181.76,25,1,-62,-18,452,-116,-81,0
0,177,-203,380,-538,-514,-24,129.3125,32,43,-79,-11,389,-124,-504,0
1,1354,1442,-88,-201,-78,-123,122.42857142857143,7,0,-45,0,-79,1001,1089,1
0,640,-512,1152,-210,-151,-59,337.2352941176471,34,33,-53,0,1190,349,-803,0
1,435,28,407,-183,-221,38,329.7857142857143,14,44,-58,-5,441,144,-263,1
0,1553,480,1073,-112,-131,19,280.1162790697674,43,57,-6,0,1215,1249,176,1
0,500,447,53,-157,-185,28,88.42105263157895,19,65,-5,205,-2,176,123,1
0,797,794,3,-33,-44,11,83.10344827586206,29,101,0,206,-40,473,470,1
0,853,-1649,2502,-57,-100,43,395.4923076923077,65,310,-9,0,2518,536,-1966,0
0,830,937,-107,-249,-33,-216,77.88888888888889,9,3,-194,0,-125,547,654,1
0,687,-927,1614,-138,-130,-8,376.2439024390244,41,69,-5,0,1566,398,-1216,0
0,10,-242,252,-736,-405,-331,166.35,20,10,-253,-83,257,-311,-563,0
0,1528,544,984,-202,-73,-129,277.5833333333333,36,15,-57,0,1014,1220,236,1
0,559,-794,1353,-193,-123,-70,347.92105263157896,38,39,-14,0,1339,279,-1074,0
0,725,482,243,-132,47,-179,84.56521739130434,23,78,-19,-18,241,445,202,1
1,766,-159,925,-195,-245,50,66.0,1,124,-3,910,-9,465,-460,0
0,7,-15,22,-757,-731,-26,154.30769230769232,13,0,-482,22,-136,-314,-336,0
0,1,6,-5,-735,-640,-95,175.875,8,10,-455,-9,67,-328,-323,0
1,210,-585,795,-518,-274,-244,322.8421052631579,38,0,-256,0,1175,-79,-874,0
0,236,-86,322,-398,-73,-325,111.0,34,0,-238,0,315,-64,-386,0
0,104,-797,901,-320,-129,-191,5.0,1,3,-104,912,0,-210,-1111,0
1,292,-428,720,-522,-537,15,318.4583333333333,24,185,-10,-7,732,-60,-780,0
1,1517,1034,483,-30,-33,3,196.20833333333334,24,14,0,-7,474,1278,795,1
0,717,-1242,1959,-295,-183,-112,362.0377358490566,53,59,-5,-1,1963,422,-1537,0
0,194,-558,752,-222,-153,-69,280.53846153846155,26,3,-53,0,753,-88,-840,0
0,230,-312,542,-564,-450,-114,174.2,30,2,-42,-4,548,-72,-614,0
1,3,64,-61,-762,-764,2,48.375,8,26,-9,9,-66,-340,-279,0
0,682,-969,1651,-242,106,-348,60.5,4,25,-138,1670,0,404,-1247,0
0,426,-581,1007,-212,-163,-49,98.42105263157895,19,29,-57,1005,-88,156,-851,0
0,895,-891,1786,-184,-165,-19,62.0,2,159,-42,1804,-2,625,-1161,0
1,768,143,625,-165,-386,221,446.46666666666664,15,225,-5,-3,625,478,-147,1
1,640,650,-10,-246,-223,-23,229.89473684210526,19,105,-11,-6,442,341,351,1
1,28,153,-125,-501,-482,-19,177.75,8,5,-6,0,-149,-281,-156,1
1,773,-646,1419,-204,-748,544,566.5862068965517,29,660,-2,-4,1406,517,-902,0
1,284,-56,340,-539,-546,7,248.71428571428572,14,24,-2,-3,340,-15,-355,0
0,200,-218,418,-500,-473,-27,160.75,28,61,-2,0,449,-97,-515,0
0,948,460,488,-300,-220,-80,198.79166666666666,24,7,-73,0,492,686,198,1
0,480,185,295,-188,-407,219,228.65,20,230,0,0,437,210,-85,1
0,251,-220,471,-567,-579,12,227.61904761904762,21,16,-1,0,495,-71,-542,0
1,671,-543,1214,-224,-296,72,531.304347826087,23,78,0,-6,1213,352,-862,0
0,856,-319,1175,-183,-430,247,294.609756097561,41,307,-2,0,1184,598,-577,0
0,537,-621,1158,-225,-200,-25,363.46875,32,74,-28,-4,1158,243,-915,0
1,712,-499,1211,-202,-177,-25,289.0681818181818,44,109,-13,-10,1210,413,-798,0
1,1158,742,416,-196,-425,229,346.42857142857144,14,252,-3,0,406,867,451,1
0,2,-257,259,-757,-475,-282,147.6,10,3,-279,265,-90,-331,-590,0
0,745,-1045,1790,-186,-213,27,403.73333333333335,45,221,0,0,1819,460,-1330,0
0,1500,570,930,-247,-178,-69,76.0,1,27,-24,889,0,1184,254,1
1,10,-37,47,-666,-495,-171,148.16666666666666,6,0,-158,0,82,-290,-337,0
1,527,566,-39,-211,-243,32,191.7058823529412,17,71,0,-33,327,238,277,1
0,1650,1459,191,-141,-185,44,38.0,1,49,0,201,0,1321,1130,1
0,177,-13,190,-385,-719,334,153.0,18,348,-46,0,190,-126,-316,0
1,1749,1241,508,-239,-256,17,249.04761904761904,21,24,-1,-8,514,1451,943,1
0,1439,468,971,-212,-210,-2,237.5121951219512,41,50,-4,0,990,1114,143,1
1,896,-375,1271,-178,-214,36,414.5151515151515,33,137,-5,-7,1352,565,-706,0
0,1961,2111,-150,-82,-52,-30,88.14285714285714,14,20,-14,0,-157,1656,1806,1
0,447,683,-236,-266,-194,-72,150.625,16,0,-55,0,-246,142,378,1
0,699,-1125,1824,-187,-161,-26,377.18367346938777,49,217,0,0,1829,405,-1419,0
1,1277,264,1013,-269,-310,41,431.1666666666667,24,36,-6,0,1015,947,-66,1
1,1189,575,614,-155,-239,84,191.91666666666666,36,115,0,-73,611,865,251,1
0,1256,1073,183,-28,-27,-1,114.07692307692308,13,30,-1,0,182,939,756,1
0,1707,523,1184,-157,-191,34,290.9756097560976,41,89,0,0,1206,1390,206,1
1,1045,607,438,-195,-470,275,343.4,15,278,-17,0,437,774,336,1
1,872,216,656,-228,-698,470,396.4,10,467,-6,966,-6,558,-98,0
0,641,-528,1169,-259,-262,3,266.79545454545456,44,93,-2,-10,1170,367,-802,0
0,141,579,-438,-544,-283,-261,217.47826086956522,23,0,-265,0,-437,-148,290,1
0,251,-184,435,-471,-490,19,124.41176470588235,34,44,-44,-3,436,-37,-472,0
0,486,917,-431,-113,-62,-51,174.17391304347825,23,2,-38,7,-433,202,633,1
1,914,-352,1266,-219,-337,118,556.6521739130435,23,133,-8,-4,1256,626,-640,0
1,725,431,294,-148,-180,32,159.05555555555554,18,36,-1,-1,292,430,136,1
1,486,219,267,-237,-282,45,268.8,10,45,-1,0,272,174,-93,1
1,1046,-360,1406,-266,-331,65,490.17241379310343,29,78,-5,-4,1403,754,-652,0
0,265,421,-156,-459,-136,-323,186.2,5,2,-221,-156,50,-22,134,1
1,794,-182,976,-239,-234,-5,451.0,22,113,0,-3,978,507,-469,0
0,275,440,-165,-483,-279,-204,169.125,8,0,-214,-176,96,-37,128,1
1,784,-58,842,-263,-356,93,456.42105263157896,19,90,-1,-7,839,472,-370,0
0,285,-238,523,-482,-506,24,221.12,25,82,-1,-8,541,-14,-537,0
1,1033,745,288,-225,-288,63,126.38888888888889,18,68,-21,294,0,721,433,1
0,169,-776,945,-309,-261,-48,344.4074074074074,27,22,-84,0,937,-130,-1075,0
1,1067,693,374,-297,-515,218,359.5833333333333,12,217,0,-4,372,791,417,1
0,1169,419,750,271,139,132,196.92105263157896,38,85,-2,0,747,854,104,1
0,909,364,545,-188,-181,-7,176.2,30,24,-13,0,549,598,53,1
0,508,-885,1393,-296,-233,-63,325.8095238095238,42,9,-63,0,1395,218,-1175,0
0,1131,391,740,-257,-261,4,263.32142857142856,28,63,0,0,747,835,95,1
1,750,-393,1143,-221,-338,117,480.1666666666667,24,127,0,0,1143,454,-689,0
0,235,-612,847,-525,-218,-307,75.0,1,0,-311,845,-14,-61,-908,0
1,279,-1263,1542,-523,-658,135,578.925925925926,27,140,-5,-3,1542,-23,-1565,0
1,760,274,486,-206,-325,119,358.5,14,108,0,-1,477,443,-43,1
0,508,0,508,-182,-471,289,231.41666666666666,24,295,0,0,510,144,-364,0
1,978,-81,1059,-177,-315,138,483.3181818181818,22,135,-4,-4,1048,614,-445,0
0,1042,-236,1278,-330,-537,207,315.45238095238096,42,299,0,0,1281,711,-567,0
0,844,945,-101,-230,-167,-63,120.28571428571429,7,0,-63,0,-100,544,645,1
1,770,678,92,-179,-250,71,189.8,5,67,0,-9,87,494,402,1
1,840,667,173,-246,-273,27,201.88888888888889,9,4,-13,-13,166,566,393,1
0,297,-241,538,-447,-496,49,213.8846153846154,26,73,-5,-1,561,-12,-550,0
0,453,-15,468,-228,-480,252,176.06666666666666,15,256,0,662,0,147,-321,0
0,136,-438,574,-260,-156,-104,314.89473684210526,19,8,-111,0,598,-175,-749,0
0,324,490,-166,-248,-174,-74,186.33333333333334,9,0,-77,0,-172,27,193,1
0,32,253,-221,-725,-432,-293,128.04545454545453,22,0,-270,0,-237,-274,-53,1
0,544,-959,1503,-294,-98,-196,400.39473684210526,38,18,-133,-1,1528,220,-1283,0
0,1434,-359,1793,-176,-417,241,398.60869565217394,46,337,-6,-3,1819,1120,-673,0
1,942,-927,1869,-216,-2,-214,327.2241379310345,58,61,-66,0,1886,634,-1235,0
0,641,432,209,-205,-81,-124,98.0,19,24,-7,-6,226,333,124,1
0,846,794,52,-155,-154,-1,139.0625,16,101,-8,-15,215,562,510,1
0,1235,927,308,-36,-39,3,52.2,5,72,-6,388,-15,912,604,1
0,1330,1297,33,-96,-116,20,76.14,50,72,0,-9,404,1056,1023,1
0,129,214,-85,-252,-486,234,98.4375,16,238,-1,27,-88,-181,-96,1
1,769,-1170,1939,-137,-199,62,368.0,53,173,-1,0,1940,466,-1473,0
0,1486,443,1043,-173,-206,33,317.3333333333333,33,68,-3,0,1046,1182,139,1
1,719,273,446,-254,-328,74,361.6923076923077,13,65,-2,-6,448,452,6,1
0,1322,686,636,-131,-144,13,212.93333333333334,30,72,-2,0,644,1020,384,1
0,1345,276,1069,-293,-367,74,346.4516129032258,31,216,0,0,1093,1036,-33,1
1,826,-975,1801,-164,-153,-11,358.2549019607843,51,144,-14,-4,1798,507,-1294,0
1,10,2,8,-661,-629,-32,61.53846153846154,13,12,-37,70,-40,-256,-264,0
0,1541,491,1050,-169,-147,-22,262.84615384615387,39,65,-35,0,1039,1237,187,1
0,1222,448,774,-177,-135,-42,214.28571428571428,35,0,-47,0,763,919,145,1
1,1198,702,496,-317,-350,33,422.0833333333333,12,31,-5,-2,499,875,379,1
0,943,862,81,-106,-125,19,139.4857142857143,35,124,-6,-11,329,631,550,1
1,910,456,454,-175,-275,100,368.61538461538464,13,116,-2,0,458,610,156,1
0,245,-305,550,-555,-472,-83,189.21428571428572,28,15,-23,0,538,-74,-624,0
1,630,-544,1174,-247,-230,-17,371.6666666666667,39,35,-51,0,1464,362,-812,0
1,595,-297,892,-222,-259,37,364.75,16,47,0,1454,-2,252,-640,0
0,311,241,70,-490,-456,-34,116.9375,16,0,-123,234,0,-48,-118,1
0,12,173,-161,-751,-471,-280,133.76190476190476,21,0,-291,0,-168,-293,-132,1
0,770,-766,1536,-239,-234,-5,311.0408163265306,49,50,-30,0,1542,469,-1067,0
0,890,1087,-197,-172,-196,24,93.61111111111111,18,30,0,0,-203,579,776,1
0,231,1033,-802,-500,-255,-245,204.30769230769232,39,0,-256,2,-796,-93,709,1
0,453,507,-54,-254,-83,-171,54.0,3,0,-164,-74,0,98,152,1
1,915,-591,1506,-101,-207,106,355.3720930232558,43,54,-21,-3,1527,603,-903,0
0,293,-495,788,-235,-104,-131,256.46875,32,0,-131,0,830,-29,-817,0
0,1060,469,591,-219,-164,-55,195.46666666666667,30,0,-56,0,598,738,147,1
1,564,223,341,-126,-491,365,196.61764705882354,34,363,-6,-14,581,260,-81,0
1,801,-701,1502,-179,-133,-46,223.3,10,124,-18,1739,0,491,-1011,0
0,1728,2069,-341,-267,-85,-182,205.5625,16,0,-85,0,-347,1395,1736,1
0,1410,1498,-88,-172,-29,-143,16.0,1,0,-59,-100,0,1070,1158,1
0,1024,214,810,-387,-361,-26,296.61538461538464,26,63,0,0,798,714,-96,1
1,1782,1299,483,-133,-152,19,248.0,19,24,0,-5,479,1460,977,1
0,1397,575,822,-177,-53,-124,242.0909090909091,33,53,-22,-5,808,1116,294,1
0,437,-492,929,-99,18,-117,233.5952380952381,42,139,-38,-6,952,148,-781,0
0,1420,207,1213,-180,-457,277,298.8536585365854,41,308,-1,0,1211,1109,-104,1
0,499,-616,1115,-191,-111,-80,54.0,3,82,-33,1134,-9,155,-960,0
0,568,-282,850,-205,-391,186,239.55555555555554,36,184,0,0,850,234,-616,0
1,1512,1062,450,-211,-221,10,347.84615384615387,13,14,0,0,450,1172,722,1
0,1106,1039,67,-117,-178,61,76.71052631578948,38,121,-3,385,-18,726,659,1
0,13,312,-299,-662,-483,-179,53.0,1,0,-246,-312,2,-294,5,1
0,1580,667,913,-109,-224,115,362.0975609756098,41,228,0,-7,1466,1273,360,1
0,1968,1266,702,-204,-207,3,172.425,40,19,-6,0,703,1705,1003,1
0,206,-468,674,-464,-156,-308,208.11428571428573,35,0,-321,-11,682,-81,-755,0
1,1810,911,899,-252,-141,-111,274.8484848484849,33,7,-84,0,898,1478,579,1
1,539,355,184,-239,-254,15,389.2631578947368,19,36,0,907,0,159,-25,0
0,173,-604,777,-522,-237,-285,230.61111111111111,36,0,-285,-7,778,-85,-862,0
1,853,827,26,-75,73,-148,103.0,2,18,-57,0,50,572,546,1
0,446,461,-15,-187,-131,-56,18.0,1,0,-14,6,-14,159,174,1
1,893,383,510,-188,-242,54,378.14285714285717,14,61,0,-12,507,567,57,1
1,759,-1216,1975,-152,-196,44,187.41176470588235,17,100,0,1971,-326,384,-1591,0
1,2025,378,1647,-225,-323,98,574.6896551724138,29,98,-35,0,1650,1732,85,1
0,556,-486,1042,-234,-11,-223,272.35135135135135,37,66,-45,0,1035,280,-762,0
1,145,-38,183,-556,-579,23,279.2857142857143,7,65,0,0,182,-123,-306,0
0,307,-1017,1324,-454,-125,-329,328.25,40,0,-205,0,1315,46,-1278,0
1,1519,915,604,-209,-144,-65,204.16666666666666,30,5,-65,0,605,1194,590,1
0,1009,-1036,2045,-137,-173,36,373.68518518518516,54,125,0,-1,2049,681,-1364,0
1,1454,821,633,-129,-192,63,277.0,23,92,-5,0,627,1143,510,1
1,191,591,-400,-546,-249,-297,212.07407407407408,27,0,-324,0,-511,-112,288,1
0,454,446,8,-104,-44,-60,56.0,1,0,-88,28,0,149,141,1
0,315,-722,1037,-570,-197,-373,272.025,40,0,-287,-2,1064,-2,-1039,0
1,461,-509,970,-209,-404,195,411.9714285714286,35,189,0,0,1468,127,-843,0
0,231,-258,489,-533,-520,-13,166.46428571428572,28,9,-18,0,496,-90,-579,0
1,669,-897,1566,-249,-232,-17,359.69767441860466,43,26,-18,0,1567,427,-1139,0
0,381,451,-70,-307,-210,-97,218.16666666666666,24,0,-101,433,-83,63,133,0
0,215,-205,420,-546,-471,-75,183.14285714285714,21,3,-22,-1,404,-172,-592,0
0,979,607,372,-143,-174,31,171.0,21,59,-7,0,386,679,307,1
0,29,441,-412,-401,-58,-343,197.23076923076923,26,0,-369,0,-426,-254,158,1
1,719,-855,1574,-171,-295,124,379.0238095238095,42,191,-2,-2,1566,431,-1143,0
1,1040,564,476,-297,-254,-43,283.6818181818182,22,9,-37,-19,616,738,262,1
1,865,-513,1378,-146,-297,151,488.9655172413793,29,188,0,-9,1382,558,-820,0
0,610,628,-18,-84,-7,-77,103.33333333333333,9,108,0,-38,45,340,358,1
1,540,-432,972,-142,-170,28,321.43333333333334,30,85,-3,0,971,286,-686,0
0,182,1006,-824,-450,-122,-328,268.8787878787879,33,0,-292,2,-838,-120,704,1
1,603,-284,887,-530,-545,15,255.94285714285715,35,69,0,0,871,298,-589,0
0,790,-514,1304,-193,-132,-61,358.0833333333333,36,82,-6,-8,1296,529,-775,0
0,985,1222,-237,-277,-88,-189,148.0,12,0,-89,0,-199,657,894,1
0,200,-1109,1309,-459,-65,-394,354.1842105263158,38,0,-312,-4,1313,-60,-1369,0
0,1165,243,922,-240,-455,215,230.4390243902439,41,303,0,0,902,881,-41,1
1,532,-326,858,-292,-186,-106,367.2173913043478,23,12,-24,-2,855,254,-604,0
1,571,466,105,-226,-234,8,222.78947368421052,19,65,0,0,428,313,208,1
1,515,-291,806,-251,-49,-202,378.6666666666667,21,7,-29,-2,801,217,-589,0
0,1327,744,583,-215,-230,15,186.5483870967742,31,37,-3,-11,590,1038,455,1
0,8,-2,10,-740,-698,-42,132.85714285714286,14,0,-379,-90,39,-306,-316,0
0,270,1334,-1064,-566,-114,-452,301.8918918918919,37,0,-344,2,-1093,6,1070,1
1,877,286,591,-127,-222,95,433.42857142857144,14,101,-5,0,602,570,-21,1
0,855,938,-83,-237,-211,-26,111.66666666666667,6,0,-23,0,-82,525,608,1
0,732,-952,1684,-275,-166,-109,350.02127659574467,47,7,-109,-2,1699,430,-1254,0
0,409,-525,934,-202,-61,-141,279.3529411764706,34,59,-74,0,933,108,-826,0
1,1206,229,977,-197,-199,2,549.6666666666666,18,69,0,-1,969,905,-72,1
1,229,-274,503,-365,-286,-79,406.22222222222223,18,0,-139,1220,-5,-75,-578,0
1,957,220,737,-165,-318,153,456.0,17,156,-9,-5,740,639,-98,1
0,1995,1232,763,-180,-107,-73,213.5,34,36,-14,0,745,1703,940,1
1,1403,877,526,-182,-47,-135,195.2962962962963,27,41,-13,0,532,1114,588,1
0,864,-1021,1885,-178,-234,56,437.13953488372096,43,135,0,0,1891,568,-1317,0
1,870,495,375,-185,-299,114,318.2307692307692,13,111,-7,-21,369,568,193,1
0,117,-267,384,-438,-401,-37,86.5,12,28,-3,390,-109,-148,-532,0
0,908,-589,1497,-202,-121,-81,125.04,25,84,-80,1713,-6,585,-912,0
1,884,-391,1275,-268,-323,55,563.3913043478261,23,60,-6,-8,1280,592,-683,0
1,1379,916,463,-208,-128,-80,201.6086956521739,23,0,-50,0,469,1083,620,1
0,1299,200,1099,-255,-439,184,282.075,40,293,0,0,1104,996,-103,1
0,239,255,-16,-451,-474,23,107.375,16,32,-112,-11,164,-60,-44,1
0,1622,-184,1806,-362,-352,-10,327.3859649122807,57,246,0,0,1816,1311,-495,0
0,101,-1594,1695,-414,-212,-202,449.39473684210526,38,0,-121,0,1717,-203,-1898,0
0,191,211,-20,-500,-479,-21,138.66666666666666,12,31,-169,-14,131,-134,-114,1
0,25,13,12,-649,-626,-23,217.85714285714286,7,1,-462,-56,7,-272,-284,1
1,1905,1574,331,-198,-86,-112,288.6666666666667,12,2,-19,0,333,1616,1285,1
0,827,-866,1693,-193,-122,-71,351.9166666666667,48,47,-79,0,1700,527,-1166,0
0,661,828,-167,-194,-83,-111,92.85,20,0,-116,0,-177,364,531,1
0,566,492,74,-209,-187,-22,148.92307692307693,26,56,-59,70,-355,269,195,1
0,23,567,-544,-286,-64,-222,224.79166666666666,24,0,-89,0,-552,-323,221,1
1,1736,1302,434,-163,-12,-151,360.25,12,17,-6,0,436,1446,1012,1
0,385,-551,936,-264,-50,-214,240.64102564102564,39,19,-71,0,944,84,-852,0
0,195,-205,400,-527,-469,-58,202.52380952380952,21,41,-26,-1,427,-87,-487,0
0,566,-529,1095,-187,-113,-74,329.2647058823529,34,88,-14,-8,1111,261,-834,0
0,16,270,-254,-695,-404,-291,127.11538461538461,26,0,-238,0,-263,-325,-71,1
0,1830,953,877,-327,-230,-97,254.64705882352942,34,1,-60,0,887,1557,680,1
0,199,230,-31,-553,-403,-150,98.66666666666667,3,0,-55,0,-27,-116,-85,1
1,743,-802,1545,-239,-307,68,468.4848484848485,33,78,0,0,1545,445,-1100,0
0,222,488,-266,-517,-178,-339,169.5,22,0,-286,3,-272,-106,160,1
1,855,-721,1576,-347,-273,-74,355.6136363636364,44,9,-70,-9,1573,558,-1018,0
1,736,-495,1231,-231,-246,15,348.3142857142857,35,50,-1,-7,1228,455,-776,0
0,504,-535,1039,-177,-191,14,349.0,30,86,0,0,1048,197,-842,0
1,630,1,629,-183,-519,336,457.2352941176471,17,430,-3,-12,620,339,-290,1
0,217,210,7,-560,-413,-147,112.66666666666667,9,0,-125,68,-4,-117,-124,1
1,853,-807,1660,-174,-303,129,466.25,16,166,0,2376,0,516,-1144,0
0,479,-596,1075,-177,-239,62,347.38709677419354,31,104,0,0,1076,170,-905,0
1,932,227,705,-289,-325,36,417.7647058823529,17,36,0,-1,700,636,-69,1
1,393,361,32,-278,-75,-203,108.0,3,0,-85,-38,0,77,45,1
1,259,1700,-1441,-520,-238,-282,326.7111111111111,45,0,-274,0,-1439,-62,1379,1
0,1077,300,777,-207,-515,308,243.1764705882353,34,311,0,0,779,773,-4,1
1,551,-1166,1717,-334,-250,-84,356.70212765957444,47,5,-88,-9,1702,247,-1470,0
0,240,518,-278,-533,-191,-342,201.8095238095238,21,2,-346,0,-294,-69,209,1
0,213,-234,447,-492,-490,-2,194.63636363636363,22,33,-2,0,443,-99,-546,0
1,678,-1009,1687,-293,-199,-94,356.6595744680851,47,3,-102,0,1680,386,-1301,0
0,496,-483,979,-241,-185,-56,262.77777777777777,36,41,-20,-5,967,222,-757,0
0,784,-812,1596,-221,-106,-115,349.2888888888889,45,45,-22,0,1613,513,-1083,0
1,418,216,202,-299,-373,74,189.76470588235293,17,77,-5,512,0,134,-68,0
0,1095,950,145,-180,-185,5,331.7826086956522,23,90,-11,0,763,766,621,1
0,1111,5,1106,-184,-740,556,346.0833333333333,36,580,-1,-4,1120,797,-309,0
0,930,-561,1491,-257,-157,-100,309.8333333333333,48,79,-88,0,1493,656,-835,0
0,525,-184,709,-219,-426,207,300.48,25,215,-3,-7,721,255,-454,0
0,2056,1321,735,-127,-101,-26,224.15625,32,5,-31,0,734,1718,983,1
1,1105,710,395,-223,-247,24,375.6666666666667,12,80,-1,-5,421,800,405,1
0,769,510,259,-220,-223,3,203.61904761904762,21,101,-6,675,-10,440,181,1
1,447,577,-130,-129,21,-150,102.66666666666667,3,0,-16,0,-36,85,215,1
0,459,445,14,-187,-180,-7,220.96153846153845,26,83,-25,552,-15,185,171,0
0,592,1313,-721,-347,-223,-124,294.3333333333333,24,0,-113,0,-732,311,1032,1
1,1606,1179,427,-230,-214,-16,234.68421052631578,19,0,-29,-17,422,1277,850,1
0,1211,532,679,-103,-26,-77,214.9,30,0,-86,0,672,932,253,1
1,479,489,-10,-74,-80,6,43.0,3,30,-8,-11,25,192,202,1
0,839,-984,1823,-164,-123,-41,380.04,50,165,-44,0,1864,552,-1271,0
1,512,467,45,-117,-96,-21,26.444444444444443,9,0,-21,-49,46,187,142,1
0,263,486,-223,-407,-127,-280,167.11764705882354,17,0,-189,0,-224,-54,169,1
0,1695,262,1433,-216,-341,125,372.5263157894737,38,141,0,0,1442,1391,-42,1
0,149,-28,177,-528,-732,204,138.05555555555554,18,248,-2,-2,190,-163,-340,0
0,923,-804,1727,-151,-183,32,399.3488372093023,43,113,0,0,1726,609,-1118,0
0,254,-234,488,-529,-507,-22,208.8695652173913,23,25,-22,0,487,-41,-529,0
1,230,44,186,-535,-602,67,266.75,8,56,-3,-6,202,-77,-263,1
1,492,468,24,-191,-154,-37,46.5,2,0,-55,30,-11,197,173,1
1,244,237,7,-554,-534,-20,116.0,5,129,0,14,-52,-91,-98,1
0,606,-1178,1784,-193,-105,-88,410.0681818181818,44,94,-45,0,1795,322,-1462,0
1,415,-35,450,-241,-285,44,329.0,15,44,-9,-28,452,136,-314,0
1,223,496,-273,-481,-377,-104,401.5833333333333,12,5,-325,-706,12,-42,231,1
0,432,435,-3,-291,-328,37,97.75,8,94,-9,4,-65,106,109,1
0,17,-1639,1656,-385,-191,-194,341.1458333333333,48,0,-194,0,1662,-317,-1973,0
1,799,813,-14,-97,-36,-61,64.8,5,31,-1,0,-23,527,541,1
0,990,-805,1795,-248,-300,52,341.3076923076923,52,98,-3,0,1790,695,-1100,0
0,493,-393,886,-222,-249,27,306.41379310344826,29,73,0,0,892,183,-703,0
0,435,-483,918,-214,-250,36,235.44736842105263,38,54,0,0,904,127,-791,0
1,837,322,515,-235,-299,64,380.07142857142856,14,61,0,0,514,566,51,1
1,954,661,293,-197,-262,65,323.6,10,65,0,-2,292,492,199,1
1,188,181,7,-555,-530,-25,100.0,4,72,-17,-14,20,-67,-74,1
1,480,483,-3,-243,-153,-90,94.0,8,73,-53,51,-26,199,202,1
0,1192,189,1003,-373,-486,113,381.4074074074074,27,148,0,0,1032,907,-96,1
0,1098,477,621,-228,-191,-37,245.88,25,1,-58,0,637,813,192,1
0,157,-239,396,-512,-425,-87,198.55,20,16,-48,-9,401,-140,-536,0
0,478,548,-70,-220,-150,-70,176.91304347826087,23,41,-42,326,-82,189,259,1
0,889,455,434,-182,-200,18,192.6818181818182,22,18,0,0,439,595,161,1
0,1251,639,612,-158,-133,-25,198.43333333333334,30,44,0,0,611,986,374,1
1,1324,665,659,-98,-406,308,479.8666666666667,15,325,0,0,649,1046,387,1
1,801,720,81,-218,-168,-50,308.09090909090907,22,103,0,-4,690,487,406,1
1,834,109,725,-161,-624,463,447.85714285714283,7,511,0,960,0,516,-209,0
1,1520,855,665,-354,-281,-73,229.39285714285714,28,0,-94,-4,658,1243,578,1
0,731,1809,-1078,-188,-140,-48,265.5897435897436,39,7,-72,0,-1087,442,1520,1
0,923,-490,1413,-191,-159,-32,369.075,40,45,-27,-5,1483,639,-774,0
1,1172,1223,-51,-210,-303,93,356.6333333333333,30,119,0,1013,-49,859,910,1
1,1649,1005,644,-182,-171,-11,226.41379310344828,29,38,-7,-3,649,1365,721,1
1,914,445,469,-215,-262,47,348.07142857142856,14,45,-5,-14,475,604,135,1
1,922,437,485,-218,-276,58,381.0769230769231,13,53,-6,-3,486,618,133,1
0,471,-293,764,-222,-146,-76,68.0,1,0,-77,806,0,108,-656,0
1,475,325,150,-266,-286,20,205.28571428571428,7,22,0,0,150,148,-2,1
0,11,420,-409,-238,-93,-145,214.10526315789474,19,0,-149,0,-418,-230,179,1
1,571,-616,1187,-296,-130,-166,336.30555555555554,36,45,-110,0,1192,241,-946,0
0,458,445,13,-241,-216,-25,84.10714285714286,28,91,-10,-6,247,181,168,1
0,1208,1135,73,-222,-194,-28,112.35714285714286,14,62,-10,-15,183,931,858,1
0,1502,1421,81,-140,-140,0,51.4,5,31,-2,143,-7,1187,1106,1
1,790,-1052,1842,-163,-78,-85,390.36170212765956,47,46,-50,-7,1837,509,-1333,0
0,2040,1288,752,-234,-198,-36,246.86666666666667,30,11,-32,-1,756,1749,997,1
1,878,-238,1116,-219,-255,36,551.25,20,50,-9,0,1106,553,-563,0
0,386,-537,923,-235,-218,-17,329.82142857142856,28,61,-22,0,921,41,-882,0
0,1550,511,1039,-226,-128,-98,254.38095238095238,42,34,-63,0,1084,1196,157,1
0,678,-609,1287,-208,-106,-102,307.075,40,87,-7,0,1267,348,-939,0
1,312,-146,458,-493,-564,71,411.5833333333333,12,151,0,0,458,-45,-503,0
0,424,-524,948,-228,-171,-57,292.84375,32,19,-69,0,943,90,-858,0
0,1285,616,669,-188,-199,11,158.78571428571428,42,30,-8,0,688,960,291,1
0,1245,1973,-728,-203,-146,-57,244.63333333333333,30,13,-55,6,-738,867,1595,1
1,397,-537,934,-207,-189,-18,253.72972972972974,37,80,-18,0,939,110,-824,0
1,825,-880,1705,-176,-157,-19,365.2173913043478,46,79,-18,0,1690,553,-1152,0
1,744,-520,1264,-166,-302,136,372.8235294117647,34,140,-2,-7,1266,443,-821,0
1,449,-445,894,-159,-165,6,273.27272727272725,33,70,0,-3,896,155,-739,0
1,829,541,288,-204,-237,33,332.77777777777777,9,36,-8,-1,289,530,242,1
0,646,631,15,-245,-228,-17,334.0,21,94,-3,-1,703,340,325,0
0,1447,-265,1712,-250,-393,143,51.0,1,383,0,1767,0,1143,-569,0
1,1602,1283,319,-142,-157,15,215.06666666666666,15,88,0,-10,311,1296,977,1
1,749,644,105,-237,-256,19,169.7058823529412,17,86,0,-9,264,459,354,1
0,275,-266,541,-491,-443,-48,227.43478260869566,23,61,-37,0,533,-49,-590,0
1,1565,1325,240,-228,-129,-99,113.94736842105263,19,0,-45,0,229,1284,1044,1
1,672,-559,1231,-197,-225,28,317.6046511627907,43,71,-15,0,1399,379,-852,0
1,186,-330,516,-522,-465,-57,300.72222222222223,18,40,-61,0,518,-111,-627,0
1,514,533,-19,-207,-220,13,179.08333333333334,24,54,0,395,-29,202,221,1
0,1513,795,718,-250,-162,-88,162.67441860465115,43,0,-92,-5,718,1215,497,1
0,232,189,43,-457,-312,-145,198.63636363636363,11,1,-227,-5,107,-66,-109,1
0,611,-958,1569,-228,-79,-149,332.06382978723406,47,40,-58,0,1587,273,-1296,0
0,29,263,-234,-772,-465,-307,131.8695652173913,23,0,-305,9,-246,-252,-18,1
1,1374,948,426,-284,-161,-123,146.17857142857142,28,17,-40,-16,401,1107,681,1
1,693,496,197,-402,-264,-138,166.1875,16,18,-38,-2,278,413,216,1
1,427,-349,776,-217,-240,23,297.34615384615387,26,40,0,-1,775,166,-610,0
0,384,-1062,1446,-253,-127,-126,341.8095238095238,42,7,-75,0,1460,100,-1346,0
0,911,1418,-507,-102,-98,-4,12.0,1,26,0,-511,17,626,1133,1
0,700,-860,1560,-267,-183,-84,288.6296296296296,54,14,-86,-1,1580,415,-1145,0
0,1466,409,1057,-230,-254,24,304.94117647058823,34,59,-1,0,1057,1171,114,1
1,116,245,-129,-582,-528,-54,183.28571428571428,7,0,-54,0,-127,-189,-60,1
0,1112,1362,-250,-56,-18,-38,20.0,1,23,0,-272,0,811,1061,1
1,1218,847,371,-268,-187,-81,169.76190476190476,21,6,-80,0,373,928,557,1
0,1321,264,1057,-344,-472,128,371.2758620689655,29,145,0,0,1085,1012,-45,1
1,439,-949,1388,-275,-184,-91,329.95238095238096,42,6,-88,0,1389,152,-1236,0
1,1436,1128,308,-264,-234,-30,105.92,25,2,-30,0,311,1176,868,1
1,653,15,638,-215,-592,377,316.16,25,378,0,0,716,303,-335,0
1,1451,988,463,-452,-55,-397,217.91666666666666,12,2,-22,0,262,1201,738,1
1,223,85,138,-477,-532,55,211.83333333333334,6,52,-11,-6,140,-20,-158,1
1,1807,835,972,-214,-456,242,415.4,25,252,-4,-35,968,1508,536,1
0,177,382,-205,-254,-62,-192,161.96875,32,0,-176,6,-289,-79,126,1
1,1633,1016,617,-222,-299,77,318.04761904761904,21,160,-13,-2,644,1295,678,1
1,661,546,115,-212,-268,56,292.375,16,73,-25,575,-10,343,228,1
1,729,777,-48,-228,-217,-11,115.0,8,44,0,-47,88,422,470,1
1,566,515,51,-254,-221,-33,297.05555555555554,18,8,-30,572,-7,272,221,0
1,1435,1067,368,-303,-237,-66,177.8421052631579,19,1,-70,0,371,1127,759,1
0,37,-20,57,-622,-652,30,61.875,8,33,-1,-21,53,-279,-336,0
0,437,532,-95,-103,-86,-17,22.0,2,0,-29,-129,0,145,240,1
1,963,-230,1193,-223,-234,11,516.304347826087,23,34,-2,-3,1179,682,-511,0
0,12,259,-247,-821,-553,-268,149.45454545454547,22,7,-296,5,-251,-318,-71,0
0,152,686,-534,-313,-125,-188,252.7,20,0,-73,0,-529,-152,382,1
1,1137,-881,2018,-180,-238,58,408.2040816326531,49,100,0,0,2010,874,-1144,0
0,259,-669,928,-520,-275,-245,310.93548387096774,31,0,-256,0,931,-31,-959,0
1,510,470,40,-247,-248,1,11.0,1,19,-20,53,-23,191,151,1
1,423,385,38,-93,-114,21,80.66666666666667,6,25,-11,-11,49,125,87,1
0,840,-484,1324,-262,-208,-54,404.7878787878788,33,43,-54,0,1347,554,-770,0
1,582,551,31,-200,-199,-1,93.0,2,17,0,0,34,238,207,1
1,1093,-415,1508,-221,-335,114,561.3703703703703,27,117,0,-9,1504,793,-715,0
1,537,-27,564,-219,-593,374,495.0769230769231,13,385,0,1076,0,230,-334,0
0,467,-489,956,-253,-169,-84,253.3846153846154,39,47,-84,0,965,169,-787,0
0,836,-715,1551,-253,-182,-71,370.2857142857143,42,44,-69,0,1562,530,-1021,0
1,1043,144,899,-209,-352,143,505.0,18,141,-1,0,901,757,-142,1
1,124,683,-559,-604,-640,36,618.6666666666666,9,37,0,0,-558,-173,386,1
1,451,-608,1059,-197,-22,-175,288.6111111111111,36,62,-56,0,1032,157,-902,0
0,123,513,-390,-300,-181,-119,193.95238095238096,21,1,-119,0,-410,-157,233,1
1,452,339,113,-191,-209,18,35.0,1,18,-28,126,0,171,58,1
0,466,-484,950,-184,-197,13,304.4516129032258,31,70,0,-5,959,166,-784,0
0,315,12,303,-246,-495,249,121.5625,16,288,0,379,0,33,-270,0
1,955,636,319,-244,-280,36,287.0,10,52,-5,0,297,661,342,1
0,213,217,-4,-511,-507,-4,170.23076923076923,13,11,-225,-12,125,-100,-96,1
0,196,185,11,-393,-564,171,154.1818181818182,11,196,-123,57,-13,-153,-164,1
1,952,60,892,-214,-289,75,480.7368421052632,19,31,-7,-6,903,646,-246,1
0,344,-223,567,-452,-395,-57,43.0,1,31,-26,557,-1,43,-524,0
0,453,-512,965,-233,-217,-16,273.9142857142857,35,42,-7,-3,976,149,-816,0
1,909,512,397,-217,-297,80,343.9166666666667,12,97,-1,-7,392,581,184,1
0,200,1718,-1518,-310,-58,-252,378.4390243902439,41,12,-256,0,-1519,-162,1356,1
0,929,-1006,1935,-194,-170,-24,369.2830188679245,53,143,-1,0,1938,636,-1299,0
0,581,-531,1112,-221,-197,-24,319.5882352941176,34,40,-24,0,1111,276,-836,0
1,1415,835,580,-240,-226,-14,231.68,25,7,-1,-4,590,1104,524,1
1,1183,991,192,-203,-183,-20,167.75,12,1,-14,-1,201,866,674,1
0,760,-836,1596,-209,-192,-17,338.72340425531917,47,112,-12,0,1596,459,-1137,0
0,164,252,-88,-452,-506,54,83.6875,16,63,-123,50,-88,-188,-100,1
1,1023,-334,1357,-197,-330,133,348.5833333333333,12,146,0,1762,0,670,-687,0
1,992,-247,1239,-236,-341,105,506.64,25,101,-4,-10,1238,691,-548,0
0,730,-775,1505,-252,-169,-83,353.90697674418607,43,77,-63,0,1521,424,-1081,0
1,793,265,528,-125,-217,92,379.35714285714283,14,85,-4,-1,520,495,-33,1
0,751,1449,-698,-96,-13,-83,247.25925925925927,27,6,-25,1,-695,434,1132,1
0,29,461,-432,-278,-269,-9,261.0,15,0,-22,0,-430,-320,112,1
0,100,206,-106,-181,-473,292,221.16666666666666,12,377,-10,0,-115,-245,-139,1
0,3,71,-68,-754,-678,-76,177.77777777777777,18,0,-504,0,-148,-371,-303,0
0,1322,554,768,-189,-131,-58,218.0857142857143,35,45,-17,0,780,984,216,1
0,149,197,-48,-416,-517,101,135.33333333333334,12,128,-70,51,-46,-162,-114,1
0,1052,-869,1921,-203,-188,-15,393.9375,48,45,-6,0,1919,711,-1210,0
0,462,-355,817,-196,-97,-99,65.4,5,36,-12,883,-7,98,-719,0
0,531,499,32,-94,-217,123,245.66666666666666,24,174,0,-2,597,189,157,0
0,897,237,660,-256,-532,276,314.4,35,316,0,-4,1066,576,-84,0
1,26,-168,194,-407,-378,-29,233.88888888888889,9,9,-19,-7,194,-309,-503,0
0,1340,-726,2066,-197,-168,-29,445.19565217391306,46,50,-21,-3,2082,1005,-1061,0
0,899,169,730,-410,-524,114,294.625,24,145,0,0,724,601,-129,1
1,173,-1145,1318,-554,-326,-228,340.7631578947368,38,12,-120,-5,1282,-139,-1457,0
0,1045,-737,1782,-195,-81,-114,457.42105263157896,38,71,-26,0,1767,751,-1031,0
1,1033,-1426,2459,-214,-234,20,221.2,5,71,0,2558,0,739,-1720,0
0,1706,1572,134,363,-62,425,87.15384615384616,13,1,-14,0,136,1407,1273,1
1,1131,281,850,-194,-316,122,480.55555555555554,18,115,-3,-4,847,813,-37,1
0,172,225,-53,-552,-505,-47,303.94736842105266,38,0,-207,4,-1174,-175,-122,1
0,1752,531,1221,-219,-143,-76,276.4651162790698,43,61,-49,0,1214,1427,206,1
1,769,-214,983,-249,-334,85,443.69444444444446,36,83,0,-8,1604,442,-541,0
0,1167,777,390,-178,-136,-42,152.70833333333334,24,0,-47,0,391,859,469,1
0,1313,901,412,-149,-96,-53,162.5,24,0,-56,0,415,999,587,1
0,500,468,32,-201,-182,-19,237.3181818181818,22,42,-1,0,522,164,132,0
0,1123,1074,49,-99,79,-178,52.4,5,64,-2,-1,64,798,749,1
1,1633,682,951,-217,-274,57,374.8529411764706,34,54,-62,0,1285,1297,346,1
0,837,327,510,-342,-511,169,241.45454545454547,22,169,0,0,527,496,-14,1
0,579,-420,999,-184,-250,66,269.1666666666667,36,86,0,0,1017,296,-703,0
0,746,-1222,1968,-193,-154,-39,418.3829787234043,47,152,-29,0,1967,451,-1517,0
1,988,-576,1564,-265,-366,101,112.5,2,176,0,1579,0,695,-869,0
0,77,242,-165,-545,-498,-47,161.3,10,0,-35,0,-174,-211,-46,1
1,2006,1601,405,-232,-257,25,251.5,16,32,0,0,405,1696,1291,1
0,511,-679,1190,-181,-31,-150,266.97727272727275,44,46,-63,0,1199,188,-1002,0
1,561,537,24,-49,-36,-13,69.0,4,5,-22,68,0,205,181,1
0,1176,442,734,-264,-91,-173,222.85294117647058,34,11,-97,0,747,861,127,1
0,411,493,-82,-244,-198,-46,194.05555555555554,18,49,-38,274,-76,118,200,1
1,1539,915,624,-260,-258,-2,250.08333333333334,24,18,-5,0,625,1208,584,1
1,1934,1397,537,-233,-240,7,227.52173913043478,23,10,-14,0,538,1627,1090,1
0,496,522,-26,-176,-173,-3,174.57142857142858,21,65,-9,350,-15,197,223,1
0,655,-309,964,-200,-327,127,69.0,1,160,-6,992,0,356,-608,0
0,365,-512,877,-187,-97,-90,48.333333333333336,3,64,-84,888,0,52,-825,0
0,996,1142,-146,-71,-215,144,70.23809523809524,21,175,0,26,-183,715,861,1
0,1064,965,99,-147,-74,-73,82.33333333333333,3,41,-50,93,-31,783,684,1
0,202,-237,439,-506,-463,-43,197.69565217391303,23,27,-45,-1,450,-112,-551,0
0,471,245,226,-264,-438,174,192.06666666666666,15,177,-7,0,257,155,-71,1
0,378,171,207,-225,-327,102,251.5,10,128,0,0,243,155,-52,1
0,511,665,-154,-194,-133,-61,208.29166666666666,24,79,-18,334,-162,205,359,1
0,497,551,-54,-254,-217,-37,183.28571428571428,21,37,-36,341,-52,197,251,1
1,816,-26,842,-205,-506,301,191.0222222222222,45,299,0,-1,845,471,-371,0
1,858,-334,1192,-238,-337,99,516.7826086956521,23,114,0,-1,1180,548,-644,0
1,676,25,651,-198,-282,84,414.1875,16,83,-8,-5,651,339,-312,1
0,629,-981,1610,-182,-236,54,344.9130434782609,46,122,0,0,1610,305,-1305,0
0,268,2085,-1817,-473,-99,-374,356.4230769230769,52,0,-247,0,-1836,-108,1709,1
0,1041,2039,-998,-204,-165,-39,295.74285714285713,35,111,-30,6,-1004,690,1688,1
1,922,576,346,-247,-283,36,325.8181818181818,11,36,-3,0,347,574,228,1
1,626,659,-33,-148,-99,-49,53.2,5,10,-65,-72,6,325,358,1
1,696,-372,1068,-175,-223,48,464.82608695652175,23,83,-7,0,1063,352,-716,0
1,908,-332,1240,-186,-246,60,391.0,39,77,0,0,1553,591,-649,0
0,72,-260,332,-549,-390,-159,164.14285714285714,21,24,-77,0,326,-263,-595,0
0,257,211,46,-491,-447,-44,85.66666666666667,15,2,-103,139,-5,-60,-106,1
1,800,-1103,1903,-322,-356,34,409.7826086956522,46,30,-20,-3,1893,471,-1432,0
0,189,-535,724,-273,-98,-175,33.5,2,2,-188,735,0,-149,-873,0
1,975,512,463,-158,-98,-60,231.2,20,24,-5,-7,463,633,170,1
1,1966,1012,954,-265,-215,-50,307.46666666666664,30,40,-5,0,937,1644,690,1
0,230,438,-208,-457,-193,-264,200.66666666666666,12,0,-250,1,-208,-82,126,1
1,280,-128,408,-509,-580,71,402.27272727272725,11,94,0,-4,422,-51,-459,0
1,767,-435,1202,-151,-302,151,379.475,40,170,0,-8,1494,465,-737,0
1,1793,1309,484,-123,-145,22,273.52941176470586,17,20,0,0,490,1482,998,1
0,218,11,207,-517,-723,206,165.07692307692307,13,225,-195,-1,221,-120,-327,1
1,874,87,787,-205,-358,153,453.0,18,146,-3,-1,783,592,-195,1
0,573,-494,1067,-180,-168,-12,268.0769230769231,39,85,-23,0,1062,302,-765,0
1,751,-162,913,-179,-576,397,341.625,8,433,-25,1099,-17,449,-464,0
0,1051,491,560,-140,-235,95,240.91304347826087,23,92,0,0,560,583,23,1
1,330,-392,722,-241,-206,-35,57.166666666666664,6,0,-39,760,0,12,-710,0
1,759,-73,832,-227,-298,71,447.1578947368421,19,78,0,-10,821,482,-350,0
0,519,-544,1063,-267,-218,-49,298.6111111111111,36,11,-60,0,1070,214,-849,0
0,510,-635,1145,-164,-134,-30,307.6578947368421,38,68,-25,0,1158,208,-937,0
0,465,-562,1027,-229,-135,-94,258.7692307692308,39,24,-16,0,1039,154,-873,0
1,416,-387,803,-246,-274,28,72.0,3,20,-10,829,0,138,-665,0
0,550,-744,1294,-169,-211,42,301.74418604651163,43,95,-1,-12,1296,259,-1035,0
0,690,1652,-962,-244,-99,-145,310.64516129032256,31,13,-92,0,-962,370,1332,1
0,607,-276,883,-222,-399,177,232.8684210526316,38,201,0,0,881,301,-582,0
1,954,-59,1013,-67,-285,218,517.85,20,216,-9,0,1017,691,-322,0
1,519,957,-438,216,-255,471,353.2916666666667,24,11,-24,423,-422,188,626,1
1,1779,1360,419,-258,-214,-44,177.41379310344828,29,20,-5,-107,423,1474,1055,1
1,887,548,339,-221,-220,-1,152.56521739130434,23,32,-2,-11,340,612,273,1
0,840,840,0,-149,-192,43,86.60526315789474,38,144,-4,-11,354,547,547,1
0,1205,1064,141,-67,-80,13,91.70370370370371,27,117,-13,390,-13,879,738,1
0,1433,623,810,-166,-5,-161,257.8125,32,48,-45,0,832,1121,311,1
0,559,-1470,2029,-228,25,-253,413.38775510204084,49,6,-82,0,2058,253,-1776,0
0,1022,-833,1855,-240,-160,-80,318.91379310344826,58,27,-92,-5,1862,713,-1142,0
1,1978,1351,627,-173,-101,-72,289.95652173913044,23,35,0,0,670,1662,1035,1
1,796,318,478,-228,-316,88,414.0833333333333,12,101,-2,0,481,483,5,1
1,930,215,715,-155,-306,151,469.5,16,152,0,-5,715,648,-67,1
0,754,-973,1727,-155,-149,-6,392.6818181818182,44,120,-7,0,1727,454,-1273,0
0,429,-559,988,-197,-130,-67,294.4,35,95,-36,0,1004,118,-870,0
0,245,393,-148,-264,-262,-2,276.90909090909093,11,6,-4,-161,315,-53,95,0
1,530,-226,756,-148,-214,66,304.36,25,91,0,-16,753,226,-530,0
0,1190,276,914,-294,-485,191,263.02777777777777,36,237,0,0,920,865,-49,1
0,1022,282,740,-379,-300,-79,312.8333333333333,24,92,0,0,763,726,-14,1
1,20,215,-195,-468,-476,8,146.6153846153846,13,8,-1,0,-196,-280,-85,1
0,268,-214,482,-498,-420,-78,226.0952380952381,21,23,-5,0,498,-40,-522,0
0,1361,-20,1381,-235,-785,550,335.90909090909093,44,544,0,-2,1386,1027,-354,0
1,286,34,252,-552,-690,138,380.875,8,166,0,-2,252,-28,-280,1
0,1975,300,1675,-342,-507,165,52.5,2,213,0,1715,0,1630,-45,1
0,1539,6,1533,-236,-782,546,326.0,50,556,0,0,1544,1229,-304,0
0,235,-14,249,-528,-801,273,153.0,21,280,0,0,262,-97,-346,0
0,982,-1091,2073,-213,-136,-77,449.55555555555554,45,40,-42,0,2067,677,-1396,0
1,216,-142,358,-571,-550,-21,337.4,10,26,-19,-5,352,-89,-447,0
0,386,-486,872,-189,-189,0,277.09375,32,53,-8,0,895,93,-779,0
0,196,-31,227,-533,-796,263,146.22727272727272,22,277,-5,-2,229,-130,-357,0
0,145,4,141,-580,-773,193,144.66666666666666,18,243,0,0,146,-162,-303,1
1,2170,1699,471,-191,-218,27,237.1,20,45,0,0,471,1713,1242,1
1,1306,2098,-792,-127,-123,-4,273.7142857142857,28,40,-20,4,-783,978,1770,1
0,188,-232,420,-534,-529,-5,120.0,36,42,-14,-8,448,-113,-533,0
0,847,557,290,-82,-21,-61,107.79166666666667,24,21,-17,0,284,538,248,1
1,1390,487,903,-196,-112,-84,305.16129032258067,31,30,-48,0,947,1081,178,1
0,778,-749,1527,-197,-169,-28,374.65,40,53,-31,0,1523,471,-1056,0
0,1016,-1147,2163,-198,-97,-101,430.42,50,51,-72,-3,2177,688,-1475,0
1,2176,1971,205,-239,-183,-56,229.88888888888889,9,0,-20,0,204,1873,1668,1
0,989,-871,1860,-220,-189,-31,53.0,1,173,-44,1862,-9,643,-1217,0
1,931,721,210,-298,-291,-7,250.66666666666666,9,51,-6,-3,211,590,380,1
1,470,506,-36,-171,-187,16,11.5,2,95,-14,-38,19,129,165,1
1,1730,1476,254,-182,-198,16,263.0,10,18,0,-12,255,1418,1164,1
0,673,-1150,1823,-204,-121,-83,349.921568627451,51,50,-88,-3,1802,370,-1453,0
1,2,-1,3,-711,-566,-145,103.66666666666667,3,1,-22,-1,29,-294,-297,0
0,280,683,-403,-509,-187,-322,172.14814814814815,27,3,-322,0,-406,-3,400,1
1,2079,1392,687,-203,-171,-32,197.47058823529412,34,2,-39,0,683,1768,1081,1
0,1249,488,761,-201,-148,-53,235.59375,32,0,-52,-2,784,921,160,1
1,255,161,94,-494,-304,-190,49.666666666666664,3,0,-196,127,-39,-102,-196,1
1,1108,535,573,-151,-261,110,419.14285714285717,14,112,0,0,572,792,219,1
0,278,250,28,-512,-491,-21,95.2,15,0,-58,197,0,-40,-68,1
0,582,633,-51,-271,-196,-75,91.0,6,0,-72,0,-53,281,332,1
0,226,-213,439,-467,-466,-1,133.67741935483872,31,24,-1,-1,450,-93,-532,0
1,1404,-360,1764,-170,-702,532,564.4545454545455,33,532,-1,-9,1758,1076,-688,0
0,45,-482,527,-397,-181,-216,276.7,20,0,-218,0,534,-261,-788,0
1,403,-164,567,-424,-317,-107,249.16666666666666,12,0,-215,564,-241,103,-464,0
0,191,199,-8,-526,-460,-66,84.33333333333333,12,2,-14,95,-17,-75,-67,1
0,1223,226,997,-274,-409,135,51.0,2,160,0,1035,0,949,-48,1
0,462,484,-22,-144,-135,-9,90.6,20,63,-23,-19,200,169,191,1
0,441,431,10,-175,-187,12,101.19047619047619,21,90,0,221,-4,165,155,1
0,885,956,-71,-62,-89,27,102.31818181818181,22,100,0,162,-78,609,680,1
0,1238,1699,-461,-228,-166,-62,225.78947368421052,19,0,-69,0,-459,908,1369,1
1,1329,974,355,-141,-126,-15,412.5,12,126,-6,833,0,944,589,1
0,954,-1311,2265,-219,-181,-38,447.68,50,90,-33,0,2254,675,-1590,0
1,608,-526,1134,-177,-265,88,502.30434782608694,23,111,-2,-4,1135,337,-797,0
0,1283,478,805,-178,-13,-165,212.75675675675674,37,54,-38,-1,825,976,171,1
1,986,-71,1057,-179,-294,115,495.1363636363636,22,211,-5,-17,1047,710,-347,0
1,739,37,702,-220,-228,8,484.25,16,92,-2,-13,743,399,-303,1
1,265,-163,428,-544,-509,-35,387.27272727272725,11,84,0,-3,405,0,-428,0
0,253,165,88,-521,-559,38,269.77777777777777,27,41,-295,-577,87,-7,-95,1
0,450,-438,888,-111,-126,15,275.1515151515151,33,106,0,-5,917,173,-715,0
1,490,-725,1215,-283,-340,57,454.6666666666667,27,55,-2,-2,1214,190,-1025,0
1,1056,-553,1609,-168,-228,60,574.8214285714286,28,193,-5,-1,1592,765,-844,0
1,1623,1047,576,-153,-187,34,198.41379310344828,29,50,-8,0,572,1358,782,1
0,320,-142,462,-576,-569,-7,22.0,1,56,-28,517,-5,-89,-551,0
1,1477,602,875,-168,-59,-109,73.81818181818181,11,78,-52,908,0,1145,270,1
0,1132,-225,1357,-245,-648,403,316.8222222222222,45,426,-32,-8,1351,812,-545,0
1,652,-225,877,-278,-118,-160,590.5333333333333,15,8,0,0,877,334,-543,0
1,645,-402,1047,-306,-147,-159,501.04761904761904,21,3,-4,-19,1031,361,-686,0
0,872,-1165,2037,-208,-162,-46,342.4406779661017,59,108,-50,0,2034,560,-1477,0
1,1111,1988,-877,-192,-141,-51,196.97727272727272,44,8,-61,0,-886,784,1661,1
1,381,418,-37,-190,-48,-142,40.0,4,0,-27,-68,0,80,117,1
1,1016,604,412,-192,-136,-56,399.45454545454544,11,86,0,0,423,715,303,1
0,1083,398,685,-203,-224,21,197.72727272727272,33,43,-6,0,681,763,78,1
0,516,-759,1275,-263,-204,-59,367.45454545454544,33,22,-103,0,1228,251,-1024,0
1,889,575,314,-228,-306,78,302.27272727272725,11,74,-9,-9,315,583,269,1
1,897,-636,1533,-170,-296,126,410.3157894736842,38,136,0,-9,1535,628,-905,0
0,1506,995,511,-179,-167,-12,160.3793103448276,29,22,-12,0,510,1207,696,1
1,1509,1463,46,-105,17,-122,9.666666666666666,3,20,-11,16,-3,1218,1172,1
1,595,575,20,-164,83,-247,78.66666666666667,3,0,-36,20,-18,315,295,1
1,1931,1520,411,-207,-9,-198,198.0,22,1,-14,-14,422,1635,1224,1
0,673,494,179,-129,-33,-96,87.0,1,81,0,215,0,330,151,1
0,1330,2059,-729,-189,94,-283,228.125,32,4,-134,0,-738,987,1716,1
0,1369,-6,1375,-232,-662,430,310.6875,48,595,0,0,1383,1100,-275,0
0,1208,403,805,-146,-141,-5,187.26315789473685,38,83,-2,0,774,900,95,1
0,844,1471,-627,-104,61,-165,214.85185185185185,27,0,-92,0,-602,555,1182,1
0,619,-47,666,-79,-374,295,312.26666666666665,30,398,-1,-223,666,311,-355,0
0,1887,616,1271,-135,44,-179,304.05,40,19,-109,0,1251,1579,308,1
0,730,-867,1597,-212,-111,-101,332.1041666666667,48,32,-80,0,1607,415,-1182,0
1,443,463,-20,-98,-66,-32,85.5,2,0,-11,3,-20,164,184,1
0,1226,220,1006,-290,-438,148,223.16,50,223,0,0,1095,959,-47,1
1,881,-841,1722,-191,-280,89,458.1578947368421,38,124,0,-20,1725,614,-1108,0
1,318,53,265,-515,-485,-30,41.0,1,63,0,244,0,-12,-277,1
1,217,265,-48,-485,-377,-108,74.4,5,4,-16,-67,4,-87,-39,1
1,276,1364,-1088,-539,-284,-255,291.775,40,0,-266,14,-1089,-52,1036,1
1,70,748,-678,-305,-209,-96,238.27586206896552,29,6,-93,0,-680,-230,448,1
0,459,446,13,-111,-98,-13,73.66666666666667,12,17,-8,48,-62,159,146,1
1,260,286,-26,-568,-494,-74,76.33333333333333,3,0,-32,0,-31,-33,-7,1
0,1414,-10,1424,-108,-716,608,26.0,5,630,0,1429,0,1101,-323,0
0,29,1473,-1444,-758,-186,-572,328.67391304347825,46,0,-528,0,-1456,-283,1161,1
1,705,566,139,-217,-231,14,230.6,5,20,-6,246,0,393,254,1
1,588,655,-67,-150,-117,-33,81.25,4,0,-53,-104,0,279,346,1
1,1080,1114,-34,-125,-120,-5,22.0,1,7,-6,0,-48,769,803,1
1,386,385,1,-96,-87,-9,104.6,10,25,-41,-53,33,119,118,1
0,1475,1180,295,-257,-265,8,98.66666666666667,30,17,-31,0,311,1208,913,1
0,766,-1405,2171,-281,-159,-122,335.67692307692306,65,60,-119,-8,2169,494,-1677,0
1,380,441,-61,-144,-39,-105,92.84210526315789,19,25,-96,-69,85,121,182,1
1,285,276,9,-423,-362,-61,66.3529411764706,17,1,-52,-83,91,26,17,1
0,1526,496,1030,-154,-110,-44,13.5,2,59,-33,1056,0,1217,187,1
1,796,-550,1346,-250,-272,22,369.6111111111111,36,50,-6,-1,1344,496,-850,0
0,912,-474,1386,-259,-193,-66,343.0975609756098,41,128,-50,-7,1385,595,-791,0
1,1478,-2,1480,-183,-624,441,566.3703703703703,27,456,-3,0,1455,1169,-311,0
0,503,-416,919,-300,-190,-110,363.65384615384613,26,14,-90,0,940,224,-695,0
0,1594,-1020,2614,-310,-227,-83,465.625,56,100,-86,-1,2628,1306,-1308,0
0,1053,427,626,-228,-258,30,204.2,30,70,0,0,633,786,160,1
0,132,-19,151,-542,-749,207,143.28571428571428,14,205,0,0,154,-167,-318,0
0,453,-272,725,-284,-286,2,286.92,25,69,0,-2,727,124,-601,0
0,577,-515,1092,-203,-132,-71,303.5,36,47,-53,-3,1100,300,-792,0
0,642,-802,1444,-209,-228,19,320.8636363636364,44,29,0,-2,1445,358,-1086,0
1,766,458,308,-200,-202,2,290.4,10,74,0,-5,276,500,192,1
0,460,-253,713,-187,-303,116,299.04,25,151,0,0,750,150,-563,0
0,607,-540,1147,-69,-137,68,327.25714285714287,35,58,-19,-6,1149,317,-830,0
0,1484,336,1148,-210,-407,197,350.8529411764706,34,271,0,0,1172,1176,28,1
0,1864,1025,839,-177,-135,-42,274.73333333333335,30,87,0,0,848,1564,725,1
1,1011,-914,1925,-263,-171,-92,497.61538461538464,39,68,-42,0,1942,696,-1229,0
0,446,434,12,-89,-157,68,227.94444444444446,18,39,-50,-14,406,149,137,1
0,300,-246,546,-503,-502,-1,173.83870967741936,31,80,-1,-3,557,-83,-629,0
0,245,-294,539,-575,-545,-30,32.5,2,53,-14,591,0,-63,-602,0
0,456,-635,1091,-166,-171,5,256.1666666666667,42,89,0,0,1071,192,-899,0
1,232,-833,1065,-567,-672,105,491.77272727272725,22,116,0,0,1066,-94,-1159,0
0,439,684,-245,-355,-241,-114,154.8,20,0,-129,0,-263,129,374,1
1,590,468,122,-124,-232,108,107.81818181818181,11,280,0,-1,126,240,118,1
0,1487,1263,224,-131,-113,-18,122.05555555555556,18,12,-17,0,241,1089,865,1
0,108,456,-348,-267,-175,-92,267.57142857142856,14,0,-96,0,-382,-180,168,1
0,428,1323,-895,-276,-129,-147,333.03846153846155,26,0,-146,0,-898,96,991,1
0,471,-420,891,-239,-151,-88,271.8235294117647,34,28,-93,0,919,183,-708,0
1,313,-385,698,-237,-193,-44,285.48148148148147,27,18,-42,0,774,25,-673,0
0,1200,-713,1913,-219,-125,-94,401.5833333333333,48,59,-97,0,1932,937,-976,0
1,1187,893,294,-300,-175,-125,22.0,1,34,-20,400,0,811,517,1
0,301,186,115,-542,-437,-105,106.875,16,0,-54,-13,122,38,-77,1
1,1242,54,1188,-189,-860,671,415.8181818181818,33,672,0,-5,1207,965,-223,1
0,481,184,297,-289,-570,281,56.0,1,295,-6,322,-7,194,-103,1
1,889,-354,1243,-200,-592,392,322.0,41,396,-3,-2,1248,537,-706,0
0,1457,979,478,-217,-189,-28,168.25925925925927,27,2,-23,-5,462,1220,742,1
0,714,-381,1095,-219,-331,112,296.6388888888889,36,153,-1,0,1091,383,-712,0
1,847,-1114,1961,-181,-274,93,579.2941176470588,34,106,0,0,1960,542,-1419,0
0,204,-267,471,-453,-450,-3,173.80645161290323,31,54,-94,-4,464,-122,-593,0
0,223,235,-12,-549,-579,30,79.93333333333334,15,51,-189,-30,156,-83,-71,1
0,1145,1144,1,-103,-125,22,82.41176470588235,17,137,-2,0,131,835,834,1
0,395,368,27,-468,-569,101,179.78571428571428,14,108,-206,-3,190,-89,-116,1
1,1896,1318,578,-236,-228,-8,253.1304347826087,23,17,-10,0,577,1553,975,1
0,168,-1885,2053,-473,-362,-111,401.2352941176471,51,0,-131,0,2064,-153,-2206,0
0,1187,213,974,-254,-549,295,69.92307692307692,13,324,0,1081,0,916,-58,1
0,295,176,119,-457,-498,41,127.22222222222223,9,83,0,0,114,13,-106,1
1,291,355,-64,-515,-443,-72,162.9189189189189,37,145,-35,514,-65,-10,54,0
0,236,2026,-1790,-629,-112,-517,417.6,45,0,-517,0,-1843,72,1862,1
0,473,507,-34,-84,-26,-58,105.42857142857143,7,0,-47,0,-89,309,343,1
0,690,1182,-492,-191,-83,-108,236.86363636363637,22,0,-103,0,-543,526,1018,1
1,965,-317,1282,-197,-346,149,518.96,25,147,0,-1,1280,677,-605,0
1,65,615,-550,-101,-148,47,274.90625,32,29,-62,0,-903,-213,337,1
1,924,-480,1404,-222,-322,100,618.6521739130435,23,102,0,-2,1403,606,-798,0
1,1515,1012,503,-164,-247,83,224.27272727272728,22,97,-3,-13,500,1223,720,1
0,659,-1100,1759,-254,-215,-39,5.0,1,74,-17,1758,0,363,-1396,0
0,1,43,-42,-575,-662,87,184.0,2,176,-201,-26,23,-350,-308,0
1,213,-494,707,-528,-613,85,518.9285714285714,14,87,0,-2,705,-78,-785,0
1,395,-606,1001,-237,-303,66,13.0,1,75,0,979,-11,111,-890,0
1,504,-563,1067,-196,-233,37,340.59375,32,82,0,-3,1079,223,-844,0
0,708,856,-148,-278,-205,-73,131.30769230769232,13,0,-114,0,-162,401,549,1
0,1,-8,9,-739,-748,9,200.5,2,16,-334,61,-9,-328,-337,0
1,1128,212,916,-205,-324,119,500.36842105263156,19,120,0,-13,914,819,-97,1
0,681,-1555,2236,-157,-142,-15,346.75757575757575,66,114,-28,-3,2265,389,-1847,0
0,1478,886,592,-164,-192,28,184.38709677419354,31,39,-2,0,591,1156,564,1
0,157,-601,758,-426,-162,-264,241.36363636363637,33,0,-266,0,756,-121,-879,0
1,782,555,227,-194,-270,76,269.44444444444446,9,75,0,0,227,506,279,1
1,184,-384,568,-463,-250,-213,1.0,1,3,-245,588,-10,-136,-704,0
0,1215,-295,1510,-101,-494,393,377.5853658536585,41,402,0,-1,1521,888,-622,0
1,567,368,199,-195,-261,66,253.44444444444446,9,66,-31,-15,198,300,101,1
1,880,-108,988,-211,-725,514,472.2916666666667,24,512,-2,0,991,626,-362,0
1,956,-575,1531,-245,-275,30,327.0,12,73,-57,1890,-1,615,-916,0
0,418,-516,934,-213,-187,-26,262.65714285714284,35,84,0,0,943,151,-783,0
0,1206,1459,-253,-302,-128,-174,170.66666666666666,15,0,-173,0,-257,913,1166,1
1,1732,1029,703,-210,-74,-136,224.8709677419355,31,5,-14,0,698,1467,764,1
1,832,518,314,-263,-333,70,299.27272727272725,11,55,0,-3,311,554,240,1
1,653,-16,669,-161,-310,149,425.8125,16,113,0,-21,653,417,-252,0
1,737,-527,1264,-187,-304,117,515.24,25,115,0,0,1266,410,-854,0
1,764,-22,786,-172,-547,375,349.5,4,451,-1,857,-7,438,-348,0
1,666,495,171,-219,-137,-82,189.35,20,30,-11,0,418,366,195,1
0,944,706,238,-174,-156,-18,119.0,16,4,-25,0,236,630,392,1
1,661,-769,1430,-211,-71,-140,318.2888888888889,45,24,-42,-5,1428,367,-1063,0
0,569,208,361,-240,-454,214,179.6818181818182,22,223,-9,-8,368,110,-251,1
1,713,-680,1393,-203,-261,58,374.6216216216216,37,85,0,0,1396,395,-998,0
0,385,250,135,-482,-446,-36,79.46153846153847,13,6,-95,227,0,33,-102,1
1,838,-19,857,-173,-562,389,368.55555555555554,27,386,-2,-8,910,529,-328,0
1,790,-597,1387,-166,-224,58,338.8979591836735,49,115,-19,0,1671,505,-882,0
0,248,265,-17,-488,-445,-43,88.06666666666666,15,0,-256,110,-33,-94,-77,1
1,1477,1431,46,-196,-211,15,126.57142857142857,7,17,0,-44,54,1172,1126,1
0,1273,597,676,-119,20,-139,284.875,24,18,-25,0,691,962,286,1
0,265,304,-39,-450,-484,34,77.58823529411765,17,288,0,-56,201,-65,-26,1
1,504,-1117,1621,-228,-179,-49,309.78846153846155,52,57,-38,0,1620,200,-1421,0
0,911,697,214,-96,-28,-68,114.44444444444444,18,1,-19,0,222,601,387,1
0,810,785,25,-188,-108,-80,286.51851851851853,27,99,-31,800,0,482,457,1
1,587,-637,1224,-305,-162,-143,288.42857142857144,42,0,-72,0,1217,296,-928,0
1,575,-583,1158,-234,-166,-68,239.04255319148936,47,35,-26,0,1155,249,-909,0
0,748,1118,-370,-140,11,-151,203.64705882352942,17,0,-92,0,-377,391,761,1
1,1243,1045,198,-99,-196,97,326.2758620689655,29,188,0,0,951,922,724,1
1,651,-942,1593,-206,-158,-48,363.4186046511628,43,60,0,0,1579,357,-1236,0
0,1898,1288,610,-237,-217,-20,182.90625,32,8,-20,0,611,1572,962,1
1,2106,1416,690,-321,-327,6,438.125,16,62,-3,0,682,1789,1099,1
0,247,305,-58,-442,-458,16,164.91666666666666,12,22,-177,-68,118,-87,-29,1
1,749,-581,1330,-174,-233,59,358.02702702702703,37,83,-2,0,1330,415,-915,0
1,266,-369,635,-523,-500,-23,445.0,15,59,-1,-4,643,-41,-676,0
0,299,244,55,-473,-431,-42,110.88888888888889,9,0,-137,99,0,-23,-78,1
0,399,-553,952,-260,-174,-86,326.44736842105266,38,5,-76,-301,955,108,-844,0
1,936,639,297,-161,-243,82,324.7,10,83,-2,-8,294,630,333,1
1,1148,374,774,-219,-358,139,469.3529411764706,17,141,-3,0,774,872,98,1
0,834,-418,1252,-218,-231,13,296.0,42,77,-3,0,1262,530,-722,0
1,961,405,556,-178,-230,52,301.6923076923077,26,61,0,0,797,676,120,1
1,522,-1021,1543,-268,-156,-112,321.4375,48,6,-106,0,1543,281,-1262,0
0,454,-749,1203,-265,-218,-47,316.2631578947368,38,37,-35,0,1218,168,-1035,0
1,229,18,211,-484,-550,66,255.22222222222223,9,77,0,0,212,-48,-259,1
1,421,-260,681,-282,-281,-1,322.85714285714283,21,28,-2,-2,678,136,-545,0
1,847,572,275,-229,-278,49,316.44444444444446,9,49,0,-5,276,580,305,1
1,774,622,152,-237,-302,65,244.57142857142858,7,58,0,-4,161,509,357,1
1,1488,1070,418,-173,-180,7,161.12,25,5,-10,0,413,1197,779,1
0,313,-763,1076,-378,-198,-180,213.66037735849056,53,80,-174,-1,1093,47,-1029,0
0,564,-532,1096,-224,-264,40,299.1666666666667,36,53,-3,-1,1098,302,-794,0
1,728,480,248,-250,-308,58,251.3,10,58,0,-7,254,461,213,1
0,464,-576,1040,-233,-175,-58,287.05405405405406,37,30,-10,0,1074,170,-870,0
0,510,-489,999,-249,-212,-37,290.2647058823529,34,55,-20,0,1005,205,-794,0
0,738,1781,-1043,-190,-120,-70,254.21951219512195,41,36,-55,0,-1049,445,1488,1
1,838,-628,1466,-218,-237,19,529.1428571428571,28,97,0,-10,1458,553,-913,0
0,757,223,534,-147,-444,297,191.76470588235293,17,283,0,817,-14,454,-80,0
0,32,410,-378,-364,-142,-222,233.32,25,0,-194,-1000,0,-207,171,1
1,882,-396,1278,-133,-243,110,498.88461538461536,26,107,-2,-6,1279,565,-713,0
0,294,1058,-764,-503,-10,-493,305.8888888888889,27,0,-361,0,-762,-10,754,1
1,240,-357,597,-600,-604,4,387.8125,16,60,-1,-3,603,-39,-636,0
0,181,835,-654,-284,-62,-222,320.05,20,0,-122,0,-655,-155,499,1
0,821,1145,-324,-75,-160,85,72.16666666666667,6,127,-9,-320,65,528,852,1
0,928,-223,1151,-249,-482,233,199.29268292682926,82,253,-50,-10,1162,635,-516,0
0,784,1377,-593,-73,-75,2,221.2439024390244,41,181,-2,282,-609,496,1089,1
1,848,-351,1199,-217,-204,-13,471.92,25,32,0,-2,1183,583,-616,0
0,816,-1172,1988,-143,-130,-13,394.22,50,132,0,-9,1981,534,-1454,0
0,12,-671,683,-216,-105,-111,273.5833333333333,24,18,-97,0,672,-270,-953,0
0,51,203,-152,-627,-533,-94,123.54545454545455,11,0,-94,0,-153,-257,-105,1
1,936,-267,1203,-163,-274,111,524.9130434782609,23,106,-3,0,1203,656,-547,0
0,573,7,566,-174,-488,314,273.12,25,348,-1,0,651,288,-278,0
1,688,-322,1010,-164,-208,44,508.3,20,76,0,-7,990,434,-576,0
0,690,1663,-973,-293,-195,-98,366.7692307692308,26,6,-100,0,-981,401,1374,1
1,820,-325,1145,-158,-264,106,517.3636363636364,22,113,0,-10,1130,505,-640,0
0,3,181,-178,-554,-537,-17,161.58333333333334,12,0,-20,0,-204,-300,-122,1
0,1011,513,498,-193,-160,-33,138.66666666666666,36,44,0,0,501,693,195,1
0,1901,837,1064,-174,-83,-91,214.95833333333334,48,45,-29,0,1055,1583,519,1
0,143,-208,351,-532,-463,-69,133.32,25,18,-13,0,364,-163,-514,0
0,40,1141,-1101,-448,-156,-292,300.5263157894737,38,0,-290,0,-1110,-347,754,1
1,1873,1562,311,-259,-216,-43,236.64285714285714,14,16,-14,-6,317,1530,1219,1
0,486,1930,-1444,-323,-109,-214,387.5,36,0,-198,0,-1426,151,1595,1
1,919,-250,1169,-203,-264,61,536.5909090909091,22,85,0,0,1167,588,-581,0
0,280,-1699,1979,-452,-131,-321,368.7962962962963,54,0,-311,0,1977,-48,-2027,0
0,264,-260,524,-533,-427,-106,216.56521739130434,23,2,-70,-5,518,-54,-578,0
1,1014,-404,1418,-237,-209,-28,537.4814814814815,27,49,-3,-2,1456,648,-770,0
1,1092,-954,2046,-312,-282,-30,454.6666666666667,45,35,-35,-9,2054,774,-1272,0
0,112,530,-418,-239,-67,-172,175.20833333333334,24,1,-150,0,-442,-239,179,1
1,1239,1897,-658,-257,-231,-26,325.0,24,12,-9,0,-795,952,1610,1
0,251,-2201,2452,-444,-133,-311,395.30645161290323,62,0,-286,0,2457,-59,-2511,0
0,1594,560,1034,-314,-190,-124,279.18918918918916,37,3,-128,-5,1041,1270,236,1
1,692,-359,1051,-190,-241,51,341.4516129032258,31,73,0,0,1051,278,-773,0
0,442,-661,1103,-232,-36,-196,251.3181818181818,44,31,-97,0,1116,134,-969,0
0,228,-261,489,-475,-382,-93,235.85714285714286,21,41,-22,-2,488,-76,-565,0
1,1078,574,504,-269,-204,-65,397.1333333333333,15,9,-17,0,585,759,255,1
0,1067,-274,1341,-260,-520,260,434.51612903225805,31,255,0,0,1352,712,-629,0
1,279,-29,308,-517,-618,101,323.0,10,91,0,-6,300,-49,-357,0
0,162,-766,928,-522,-143,-379,294.38235294117646,34,0,-343,0,948,-154,-1082,0
0,510,-533,1043,-214,-171,-43,281.7837837837838,37,19,-45,0,1054,172,-871,0
1,618,272,346,-189,-264,75,332.72727272727275,11,71,-6,0,346,287,-59,1
1,945,-118,1063,-190,-315,125,537.15,20,122,-6,0,1063,614,-449,0
1,917,-244,1161,-169,-180,11,552.3181818181819,22,116,0,-23,1185,582,-579,0
1,175,-1455,1630,-410,-343,-67,493.6060606060606,33,0,-66,0,1630,-143,-1773,0
1,636,286,350,-238,-306,68,395.6,10,64,-20,-38,350,323,-27,1
1,852,275,577,-199,-340,141,399.06666666666666,15,139,-19,-2,578,535,-42,1
1,1307,1240,67,-174,-201,27,127.25,4,38,0,0,67,972,905,1
1,1013,-816,1829,-241,-235,-6,537.0588235294117,34,65,-10,0,1830,708,-1121,0
0,510,-1410,1920,-214,-163,-51,393.2857142857143,49,86,0,0,1933,193,-1727,0
1,1033,586,447,-221,-283,62,377.9166666666667,12,66,-1,0,446,686,239,1
1,292,-184,476,-535,-577,42,324.4,15,59,-2,-3,473,-42,-518,0
1,961,-669,1630,-245,-293,48,576.483870967742,31,94,-54,-143,1637,629,-1001,0
0,311,698,-387,-494,-196,-298,210.8,20,0,-229,5,-380,-53,334,1
1,1161,-1060,2221,-282,-178,-104,444.3,50,11,-104,-1,2219,833,-1388,0
0,706,-1461,2167,-182,-95,-87,378.2456140350877,57,70,-30,0,2172,397,-1770,0
1,1026,306,720,-207,-333,126,437.05882352941177,17,126,-2,-1,725,705,-15,1
0,273,2131,-1858,-531,-185,-346,425.29545454545456,44,0,-273,2,-1842,-104,1754,1
0,572,-462,1034,-181,-180,-1,312.24242424242425,33,59,-51,-7,1016,293,-741,0
0,451,-577,1028,-105,-235,130,277.7027027027027,37,217,-5,-6,1010,172,-856,0
1,1814,1051,763,-193,-117,-76,281.0,27,0,-11,0,766,1506,743,1
1,160,-225,385,-546,-479,-67,56.75,4,13,-14,410,-20,-149,-534,0
0,232,-230,462,-536,-473,-63,132.0857142857143,35,50,-43,-10,469,-90,-552,0
1,988,307,681,-194,-331,137,450.375,16,137,0,-13,681,674,-7,1
0,1177,566,611,-189,-90,-99,254.03846153846155,26,18,-9,0,672,867,256,1
1,231,-204,435,-552,-510,-42,211.95,20,13,-20,-1,438,-69,-504,0
0,414,1019,-605,-193,-139,-54,225.3846153846154,26,12,-33,4,-616,162,767,1
0,39,249,-210,-598,-523,-75,118.84210526315789,19,0,-47,0,-235,-280,-70,1
1,246,246,0,-524,-467,-57,134.5,2,11,0,-2,34,-86,-86,1
0,1217,439,778,-201,-224,23,265.82142857142856,28,28,0,0,770,881,103,1
1,7,692,-685,-714,179,-893,186.16666666666666,6,0,-516,-644,52,-363,322,0
1,842,855,-13,-76,350,-426,149.0,3,0,-49,-8,28,472,485,1
1,509,507,2,-270,130,-400,115.25,4,1,-23,7,-39,211,209,1
1,530,-791,1321,-264,186,-450,277.1914893617021,47,47,-93,0,1288,196,-1125,0
1,1135,1090,45,-136,266,-402,206.0,1,1,-45,-9,12,801,756,1
1,1180,-451,1631,-199,-641,442,490.97222222222223,36,449,0,-1,1730,907,-724,0
0,997,1126,-129,-66,-75,9,128.04,25,259,-3,-111,232,619,748,1
0,2017,567,1450,-238,-150,-88,286.10526315789474,57,32,-61,0,1653,1639,189,1
0,2,-36,38,-721,-700,-21,119.0,4,29,-288,29,-61,-267,-305,0
0,826,855,-29,-94,-32,-62,122.23333333333333,30,229,-29,252,-51,557,586,1
0,186,-3,189,-326,-382,56,168.78571428571428,14,118,0,0,224,-77,-266,0
1,1229,-1146,2375,-205,-272,67,530.9111111111112,45,110,0,-7,2385,919,-1456,0
0,960,1174,-214,-148,-184,36,113.65217391304348,46,126,-3,-192,513,623,837,1
0,297,311,-14,-432,-427,-5,130.76190476190476,42,28,-33,-2,571,-40,-26,0
0,21,11,10,-806,-754,-52,103.0,1,11,-218,22,-33,-257,-267,0
0,161,-1629,1790,-468,-182,-286,380.9583333333333,48,0,-290,0,1798,-157,-1947,0
1,875,-438,1313,-276,-367,91,509.0,26,97,0,-2,1316,579,-734,0
1,1085,1366,-281,-108,-143,35,143.0,23,48,-10,-605,0,792,1073,1
1,1416,1056,360,-167,-173,6,152.91304347826087,23,8,-21,0,360,1115,755,1
0,8,532,-524,-289,-231,-58,266.2631578947368,19,0,-58,0,-524,-254,270,1
0,1036,-709,1745,-260,-185,-75,347.04,50,41,-77,-1,1752,729,-1016,0
0,590,-475,1065,-206,-137,-69,318.0882352941176,34,43,-67,-9,1073,261,-804,0
0,1182,-1003,2185,-245,-55,-190,100.0,6,82,-96,2202,-67,838,-1347,0
1,1173,248,925,-221,-225,4,252.31578947368422,38,62,0,0,950,847,-78,1
1,1644,594,1050,-154,-159,5,223.75,48,110,0,0,1063,1329,279,1
0,1340,450,890,-146,-118,-28,252.82857142857142,35,45,-21,0,898,1039,149,1
0,1158,21,1137,-314,-562,248,54.0,2,259,-18,1163,-4,866,-271,0
0,1070,-265,1335,-278,-519,241,70.8,5,263,-18,1346,-9,757,-578,0
0,866,380,486,-207,-169,-38,198.8,25,23,-36,-3,495,576,90,1
0,268,226,42,-487,-394,-93,106.5,12,12,-54,0,143,-70,-112,1
0,1010,619,391,-213,-72,-141,205.5,20,36,-53,0,416,672,281,1
1,743,-284,1027,-300,-335,35,548.8421052631579,19,35,0,-4,1028,454,-573,0
0,636,-962,1598,-264,-308,44,409.9230769230769,39,92,0,0,1603,323,-1275,0
0,241,-280,521,-503,-498,-5,196.4814814814815,27,68,-2,-1,521,-72,-593,0
0,1504,207,1297,-171,-518,347,307.68888888888887,45,359,0,0,1345,1150,-147,1
1,12,4,8,-707,-647,-60,105.0,3,1,-19,-1,28,-231,-239,1
1,895,146,749,-152,-293,141,459.3529411764706,17,139,0,0,747,555,-194,1
1,7,15,-8,-687,-516,-171,133.75,4,0,-32,0,46,-225,-217,1
1,2,371,-369,-774,-814,40,332.1666666666667,12,40,-5,15,-369,-313,56,0
0,1394,408,986,-191,-277,86,256.57894736842104,38,85,-18,0,992,1123,137,1
0,619,-988,1607,-179,-121,-58,284.8363636363636,55,64,-54,0,1604,331,-1276,0
0,249,227,22,-565,-464,-101,137.41666666666666,24,14,-368,-2,198,-49,-71,1
0,15,-274,289,-860,-551,-309,7.0,1,0,-317,292,-10,-299,-588,0
0,778,162,616,-218,-408,190,218.25,28,167,-2,0,611,525,-91,1
0,1588,679,909,-165,-131,-34,267.42424242424244,33,26,-29,0,907,1272,363,1
1,12,251,-239,-773,-784,11,292.44444444444446,9,11,-3,0,-254,-259,-20,1
1,1001,-572,1573,-308,-293,-15,450.74285714285713,35,25,-17,-4,1602,695,-878,0
0,21,237,-216,-563,-478,-85,127.46666666666667,15,11,-73,3,-213,-335,-119,1
0,503,951,-448,-91,-56,-35,162.6,25,21,-23,1,-438,147,595,1
0,466,-20,486,-265,-708,443,254.92307692307693,26,476,-1,-1,486,179,-307,0
0,470,1149,-679,-99,-29,-70,12.0,1,1,-58,-695,7,183,862,1
1,16,-253,269,-511,-507,-4,137.57894736842104,19,8,-7,-7,274,-288,-557,0
0,462,-766,1228,-204,-206,2,381.0,32,48,-13,0,1244,158,-1070,0
1,472,488,-16,-98,-76,-22,69.1,10,6,-51,-24,98,176,192,1
0,1501,1243,258,-177,-203,26,167.4,15,55,0,0,266,1228,970,1
0,651,-911,1562,-191,-169,-22,346.97777777777776,45,87,-20,0,1569,395,-1167,0
0,917,1066,-149,-198,-141,-57,113.16666666666667,12,0,-75,0,-151,621,770,1
0,807,1974,-1167,-74,-38,-36,330.0857142857143,35,33,-39,1,-1168,511,1678,1
0,432,189,243,-235,-385,150,216.04166666666666,24,151,0,0,526,178,-65,0
0,740,-680,1420,-251,-142,-109,284.66,50,68,-86,0,1426,483,-937,0
0,181,-542,723,-458,-73,-385,212.52777777777777,36,1,-284,-11,727,-114,-837,0
1,493,451,42,-269,-218,-51,33.8,5,8,0,0,35,180,138,1
0,359,319,40,-459,-463,4,257.34615384615387,26,5,-138,66,-658,-68,-108,1
0,1245,967,278,-69,36,-105,115.72222222222223,18,72,0,522,0,896,618,1
0,26,179,-153,-682,-583,-99,108.70588235294117,17,0,-113,0,-177,-277,-124,1
1,480,-242,722,-250,-297,47,436.6470588235294,17,94,0,-2,719,214,-508,0
1,2032,667,1365,-284,-374,90,456.2,30,93,-14,0,1367,1760,395,1
1,914,476,438,-250,-227,-23,359.0,13,123,-1,0,455,640,202,1
1,1502,623,879,-193,-35,-158,265.74285714285713,35,6,-41,0,941,1183,304,1
1,1575,913,662,-224,-242,18,278.4583333333333,24,68,0,0,666,1273,611,1
1,461,-512,973,-195,-221,26,356.0,27,67,-2,-1,969,184,-789,0
1,799,780,19,-225,-219,-6,160.45454545454547,11,72,0,0,176,522,503,1
1,692,-960,1652,-224,-138,-86,106.35714285714286,14,62,-13,1797,0,384,-1268,0
1,992,300,692,-157,-126,-31,413.1666666666667,18,212,0,-13,697,738,46,1
0,926,-1054,1980,-228,-43,-185,416.78723404255317,47,78,-81,0,1974,639,-1341,0
1,915,-130,1045,-200,-511,311,419.44444444444446,27,359,0,-5,1086,629,-416,0
0,166,259,-93,-570,-436,-134,203.3181818181818,22,28,-20,350,-93,-120,-27,0
1,430,491,-61,-227,-79,-148,200.375,16,47,-9,-55,327,130,191,1
0,205,-159,364,-526,-365,-161,184.83333333333334,18,18,-77,-5,352,-121,-485,0
1,597,-657,1254,-282,-152,-130,376.06060606060606,33,1,-16,-5,1246,286,-968,0
0,515,-465,980,-204,-143,-61,275.7142857142857,35,95,-2,-4,973,208,-772,0
1,1150,-445,1595,-197,-318,121,234.66666666666666,3,140,0,1659,-7,852,-743,0
1,904,32,872,-249,-611,362,501.63157894736844,19,361,-1,0,873,558,-314,1
0,1141,758,383,-233,-177,-56,205.77777777777777,18,0,-59,0,383,802,419,1
1,455,490,-35,-135,-82,-53,54.5,10,14,-21,-28,57,105,140,1
0,569,1179,-610,-227,-182,-45,217.63333333333333,30,27,-28,23,-650,266,876,1
0,218,-191,409,-530,-460,-70,192.95652173913044,23,28,-23,0,445,-132,-541,0
0,810,1592,-782,-226,-141,-85,332.04347826086956,23,0,-94,0,-788,512,1294,1
0,1579,627,952,-143,-151,8,262.8611111111111,36,30,-8,0,971,1266,314,1
1,830,546,284,-68,-269,201,287.3,10,204,0,-3,285,528,244,1
0,190,311,-121,-380,-418,38,137.0,7,59,0,0,-124,-148,-27,1
1,732,422,310,-147,-286,139,369.77777777777777,9,132,-6,-1,310,429,119,1
0,767,-277,1044,-171,-424,253,266.74418604651163,43,298,0,-2,1077,484,-560,0
1,846,-394,1240,-224,-391,167,288.75,44,260,0,0,1242,542,-698,0
1,409,438,-29,-67,-62,-5,51.4,10,28,-51,-60,24,128,157,1
0,557,-502,1059,-231,-164,-67,25.666666666666668,3,37,-81,1128,0,231,-828,0
0,161,-249,410,-605,-594,-11,200.95,20,0,-15,0,417,-209,-619,0
1,88,-410,498,-275,-418,143,223.36363636363637,22,214,0,0,490,-195,-693,0
1,1115,416,699,-244,-364,120,424.0,17,97,-4,0,711,805,106,1
1,722,-379,1101,-245,-293,48,106.33333333333333,6,58,0,1100,-69,397,-704,0
1,755,309,446,-171,-366,195,358.2142857142857,14,178,-3,-4,454,468,22,1
1,216,-146,362,-485,-533,48,380.2,10,49,0,-4,366,-111,-473,0
1,1070,-134,1204,-193,-629,436,517.48,25,440,-6,0,1207,770,-434,0
0,183,-1407,1590,-554,-89,-465,352.70212765957444,47,0,-424,-1,1587,-130,-1720,0
0,1650,1061,589,-209,-161,-48,195.6206896551724,29,3,-49,0,592,1321,732,1
0,200,-202,402,-519,-508,-11,133.67857142857142,28,21,-3,-2,396,-127,-529,0
0,966,-817,1783,-181,-182,1,334.8679245283019,53,105,0,0,1791,681,-1102,0
0,234,-263,497,-585,-374,-211,221.3913043478261,23,14,-53,-2,510,-40,-537,0
1,1599,850,749,-214,-120,-94,220.3235294117647,34,63,-1,-11,748,1299,550,1
0,904,940,-36,-112,-4,-108,114.8,10,104,-10,-23,108,624,660,1
0,161,-448,609,-501,-144,-357,25.0,1,0,-353,636,0,-148,-757,0
1,0,1183,-1183,-791,-259,-532,355.43589743589746,39,0,-510,64,-1191,-294,889,0
1,1018,635,383,-226,-388,162,361.42857142857144,14,247,-27,-44,391,694,311,1
0,650,1432,-782,-404,-53,-351,284.44827586206895,29,0,-291,0,-800,366,1148,1
0,461,-1093,1554,-223,-72,-151,318.68,50,118,-60,-3,1588,147,-1407,0
0,587,870,-283,-94,20,-114,137.68421052631578,19,41,-23,2,-311,299,582,1
1,2024,413,1611,-172,-486,314,516.75,32,317,0,0,1618,1680,69,1
1,530,415,115,-232,-193,-39,217.8,20,56,-5,-8,442,184,69,1
1,848,758,90,-178,-148,-30,246.4,25,146,-2,-11,598,532,442,1
1,845,-109,954,-283,-280,-3,417.25,20,49,-28,1788,0,483,-471,0
1,278,-244,522,-477,-458,-19,317.11764705882354,17,84,0,0,523,-46,-568,0
0,3,-492,495,-216,-84,-132,247.7,20,0,-132,0,505,-338,-833,0
1,441,-213,654,-253,-343,90,232.85714285714286,28,90,-7,-8,661,115,-539,0
0,819,271,548,-349,-348,-1,55.6,5,129,0,604,0,479,-69,1
0,119,-250,369,-568,-521,-47,207.33333333333334,18,2,-49,0,386,-213,-582,0
1,729,-1119,1848,-204,-158,-46,348.7647058823529,68,6,-57,-3,2392,401,-1447,0
0,800,-833,1633,-268,-239,-29,379.57142857142856,42,8,-51,0,1631,472,-1161,0
1,674,-1044,1718,-219,-175,-44,296.9375,16,10,-51,2193,0,306,-1412,0
0,50,-236,286,-578,-389,-189,277.5208333333333,48,3,-308,282,-1308,-331,-617,0
1,504,406,98,-200,-212,12,277.76190476190476,21,67,-2,-1,583,195,97,0
1,1430,762,668,-286,-212,-74,244.03703703703704,27,0,-71,0,665,1107,439,1
0,437,-786,1223,-233,-59,-174,376.40625,32,5,-68,0,1227,117,-1106,0
1,1504,951,553,-246,-146,-100,236.1818181818182,22,1,-39,0,533,1222,669,1
1,501,407,94,-241,-191,-50,258.05882352941177,17,56,0,0,457,196,102,1
1,1007,-754,1761,-231,-224,-7,534.3030303030303,33,82,-5,0,1760,696,-1065,0
1,949,133,816,-241,-266,25,376.6326530612245,49,60,-39,0,1841,613,-203,0
0,346,539,-193,-187,-74,-113,149.23076923076923,13,0,-114,0,-204,-2,191,1
0,822,655,167,-224,-76,-148,131.54545454545453,11,0,-66,0,157,512,345,1
0,139,256,-117,-356,-461,105,120.0,3,119,-35,-117,32,-180,-63,1
1,558,604,-46,-203,-193,-10,223.625,16,57,-30,-53,371,262,308,1
1,1318,914,404,-236,-207,-29,144.34615384615384,26,6,-29,0,402,1030,626,1
0,258,474,-216,-315,-163,-152,142.7058823529412,17,0,-160,0,-230,-13,203,1
0,738,-1393,2131,-211,-100,-111,299.15714285714284,70,38,-86,0,2131,422,-1709,0
1,691,-761,1452,-223,-264,41,406.3611111111111,36,90,0,-3,1452,394,-1058,0
1,853,-112,965,-185,-297,112,321.41379310344826,29,121,-2,0,970,602,-363,0
0,475,603,-128,-274,-136,-138,148.4,10,0,-142,0,-132,121,249,1
1,640,-567,1207,-176,-252,76,379.72222222222223,36,167,-1,-142,1206,322,-885,0
0,465,558,-93,-281,-206,-75,94.55555555555556,9,0,-78,0,-96,86,179,1
1,1100,857,243,-296,-335,39,246.6,10,45,0,0,244,773,530,1
1,2033,1517,516,-148,-172,24,196.48,25,35,-2,0,516,1719,1203,1
0,226,-303,529,-532,-477,-55,160.38709677419354,31,17,-64,-1,525,-73,-602,0
0,894,-2147,3041,-171,-133,-38,112.33333333333333,18,157,-43,3226,0,602,-2439,0
0,906,-1119,2025,-197,-172,-25,391.98039215686276,51,154,0,-1,1998,594,-1431,0
0,705,308,397,-170,-291,121,183.77272727272728,22,155,0,804,-2,415,18,0
0,756,356,400,-211,-269,58,227.9,20,94,0,856,0,463,63,0
1,774,647,127,-157,-897,740,508.65,20,746,0,997,0,444,317,0
0,4,6,-2,-671,-746,75,190.0909090909091,11,68,-453,62,-17,-270,-268,0
1,593,-899,1492,-267,-189,-78,394.86842105263156,38,19,-66,-2,1491,268,-1224,0
0,240,-316,556,-527,-537,10,253.4090909090909,22,41,-3,-6,565,-46,-602,0
0,260,566,-306,-495,-188,-307,208.1578947368421,19,0,-299,0,-286,-69,237,1
1,8,114,-106,-477,-475,-2,127.14285714285714,7,2,-9,0,-114,-303,-197,1
1,983,-584,1567,-210,-289,79,564.6071428571429,28,90,0,-9,1559,670,-897,0
0,252,-268,520,-523,-414,-109,22.0,1,36,-46,550,-7,-82,-602,0
0,174,-315,489,-545,-431,-114,247.4,20,38,-44,0,487,-139,-628,0
0,169,229,-60,-556,-471,-85,91.66666666666667,6,11,-30,-76,54,-154,-94,1
0,213,451,-238,-381,-68,-313,279.25,12,0,-315,0,-251,-98,140,1
1,482,-36,518,-216,-251,35,335.0,16,35,-13,-15,514,163,-355,0
1,1162,-314,1476,-182,-264,82,523.6071428571429,28,89,0,0,1467,848,-628,0
0,219,265,-46,-406,-498,92,132.9,10,93,-136,-57,73,-106,-60,1
0,629,493,136,-81,-116,35,73.42857142857143,14,30,0,0,131,304,168,1
1,2101,1245,856,-173,20,-193,240.15151515151516,33,23,-9,0,829,1772,916,1
0,1654,1177,477,-294,-240,-54,182.96153846153845,26,1,-55,-5,480,1293,816,1
1,1924,1115,809,-252,-154,-98,157.59615384615384,52,0,-98,0,824,1574,765,1
0,116,289,-173,-473,-534,61,87.06666666666666,15,75,-1,2,-166,-188,-15,1
1,1794,1975,-181,-112,-14,-98,123.92857142857143,14,9,-86,16,-180,1501,1682,1
1,505,64,441,-244,-459,215,160.33333333333334,18,217,-10,678,-1,220,-221,0
1,257,-161,418,-526,-627,101,400.09090909090907,11,108,0,0,416,-42,-460,0
1,958,651,307,-193,-233,40,322.8,10,40,0,-1,310,630,323,1
0,214,227,-13,-482,-505,23,188.55555555555554,9,61,-159,-26,81,-84,-71,1
1,384,-1017,1401,-356,-256,-100,346.2,40,1,-93,0,1401,34,-1367,0
0,148,-199,347,-567,-444,-123,59.0,1,14,-26,358,0,-139,-486,0
1,952,-734,1686,-246,-340,94,467.52777777777777,36,90,-2,-1,1688,621,-1065,0
1,256,-721,977,-428,-213,-215,271.5,36,2,-209,-7,960,-66,-1043,0
0,68,-1790,1858,-361,-143,-218,323.7142857142857,56,0,-164,0,1847,-240,-2098,0
0,391,-753,1144,-210,-56,-154,317.4,35,80,-45,0,1128,137,-1007,0
0,4,-536,540,-448,-64,-384,172.05714285714285,35,1,-384,-1,554,-307,-847,0
1,458,397,61,-215,-219,4,180.5,4,26,-16,-23,58,174,113,1
0,8,-194,202,-788,-414,-374,169.7058823529412,17,0,-294,0,201,-274,-476,0
0,169,253,-84,-592,-512,-80,194.52941176470588,17,160,-78,182,-84,-114,-30,0
1,460,-417,877,-248,-321,73,155.14285714285714,7,71,-1,996,0,185,-692,0
0,1354,205,1149,-291,-390,99,336.8529411764706,34,194,0,0,1139,1069,-80,1
0,382,-508,890,-231,-232,1,266.6764705882353,34,86,0,0,914,105,-785,0
1,539,-341,880,-141,-268,127,485.0,19,128,0,-6,884,279,-601,0
0,445,-741,1186,-240,-79,-161,294.875,40,4,-174,-2,1194,135,-1051,0
0,605,145,460,-190,-469,279,203.68,25,287,-26,0,461,363,-97,1
0,459,476,-17,-161,-110,-51,61.9,10,1,-49,-56,1,155,172,1
0,209,-948,1157,-517,2,-519,306.8536585365854,41,2,-372,-18,1186,-97,-1254,0
1,711,-560,1271,-199,-209,10,373.51428571428573,35,105,-26,-24,1277,406,-865,0
1,441,475,-34,-148,-102,-46,76.07692307692308,13,0,-48,-87,26,136,170,1
0,184,-249,433,-508,-510,2,148.89285714285714,28,14,-7,0,439,-145,-578,0
1,756,-831,1587,-227,-144,-83,383.0,42,84,-83,-9,1586,441,-1146,0
1,934,511,423,-217,-275,58,261.29411764705884,17,70,-3,0,429,661,238,1
1,595,583,12,-196,-186,-10,17.666666666666668,3,49,-21,56,0,283,271,1
1,477,471,6,-97,-102,5,46.0,2,69,-10,8,-18,182,176,1
0,697,-1071,1768,-336,-173,-163,292.3333333333333,60,3,-114,0,1780,420,-1348,0
1,481,495,-14,-112,-27,-85,86.0,3,42,0,13,-38,101,115,1
1,2062,1525,537,-217,-138,-79,290.5263157894737,19,39,0,0,561,1679,1142,1
0,1228,414,814,-246,-129,-117,204.3846153846154,39,7,-47,0,799,895,81,1
0,731,763,-32,-200,27,-227,85.0,4,6,-17,0,-51,428,460,1
0,680,-2025,2705,-179,-134,-45,431.4516129032258,62,127,-48,0,2706,384,-2321,0
1,2008,1591,417,-271,-240,-31,261.75,16,6,-44,0,415,1691,1274,1
0,180,-19,199,-590,-700,110,103.5,20,133,0,0,201,-128,-327,0
0,316,666,-350,-498,-188,-310,219.05,20,0,-261,2,-374,-48,302,1
1,987,-1027,2014,-276,-225,-51,516.6666666666666,39,49,-56,-6,2001,662,-1352,0
1,516,-800,1316,-270,-213,-57,385.20588235294116,34,14,-61,0,1315,229,-1087,0
0,1184,1175,9,-163,-184,21,35.0,1,23,0,-1,32,904,895,1
1,1728,1503,225,-243,-251,8,187.08333333333334,12,23,-5,-10,220,1411,1186,1
0,447,823,-376,-128,-108,-20,135.8846153846154,26,0,-36,18,-373,144,520,1
0,804,-961,1765,-246,-143,-103,341.80392156862746,51,5,-85,-3,1765,475,-1290,0
0,797,-894,1691,-195,-133,-62,338.04,50,66,-85,0,1690,502,-1189,0
0,1245,509,736,-228,-143,-85,271.7037037037037,27,10,-85,0,745,910,174,1
0,534,-897,1431,-273,-224,-49,323.3720930232558,43,19,-83,0,1419,243,-1188,0
0,261,2023,-1762,-515,-127,-388,375.5744680851064,47,0,-293,0,-1769,-66,1696,1
1,1171,854,317,-163,-141,-22,203.86666666666667,15,49,-4,0,327,888,571,1
1,463,411,52,-82,-75,-7,110.66666666666667,3,31,0,-3,51,152,100,1
1,14,198,-184,-486,-478,-8,177.0,10,0,-40,0,-184,-381,-197,1
0,276,-196,472,-539,-481,-58,170.77777777777777,27,12,-57,0,477,-49,-521,0
0,1973,477,1496,-164,-205,41,317.6808510638298,47,84,0,0,1508,1700,204,1
0,600,230,370,-177,-417,240,134.93939393939394,33,371,-8,0,386,276,-94,1
1,744,-204,948,-204,-255,51,444.2857142857143,21,30,0,-2,939,449,-499,0
1,1985,1542,443,-242,-347,105,258.1666666666667,18,155,-2,0,447,1646,1203,1
0,187,-200,387,-456,-392,-64,128.73333333333332,30,7,-53,0,399,-158,-545,0
0,235,-209,444,-468,-490,22,159.93103448275863,29,94,0,0,446,-91,-535,0
0,702,715,-13,-134,-78,-56,213.9047619047619,21,61,0,4,-458,405,418,1
0,1055,936,119,-170,-102,-68,117.54545454545455,11,14,-22,-9,123,759,640,1
0,1405,1420,-15,-82,-27,-55,70.78571428571429,14,74,-4,95,-23,1108,1123,1
0,878,26,852,-172,-675,503,200.97826086956522,46,548,-1,-1,871,588,-264,0
0,193,229,-36,-544,-520,-24,127.4,20,26,-245,128,-33,-123,-87,1
0,1666,1707,-41,-128,-121,-7,123.35714285714286,28,94,-17,308,-27,1350,1391,1
1,481,499,-18,-69,-65,-4,9.0,1,61,0,0,34,147,165,1
0,2136,220,1916,-160,-421,261,340.34285714285716,70,377,0,-8,2368,1830,-86,0
1,259,-244,503,-528,-539,11,4.0,1,42,0,503,-5,-22,-525,0
0,572,-509,1081,-199,-131,-68,82.0,2,131,-53,1072,0,328,-753,0
1,443,-421,864,-141,-86,-55,78.0,3,102,-40,849,-1,199,-665,0
0,1876,615,1261,-191,-155,-36,333.60526315789474,38,96,-23,0,1279,1587,326,1
0,215,-25,240,-496,-864,368,222.94117647058823,17,370,-2,-3,251,-82,-322,0
0,245,-179,424,-547,-425,-122,200.66666666666666,18,0,-272,455,-61,-92,-516,0
1,68,256,-188,-508,-242,-266,186.92857142857142,14,1,-290,-472,0,-243,-55,1
0,632,-1093,1725,-199,211,-410,348.0408163265306,49,28,-103,0,1734,304,-1421,0
0,34,212,-178,-656,-111,-545,121.47058823529412,17,0,-238,0,-196,-320,-142,1
0,55,21,34,-723,-765,42,192.0,1,47,-252,-7,37,-246,-280,0
0,1041,465,576,-180,-265,85,216.64,25,142,-1,1138,0,712,136,0
0,299,-269,568,-425,-420,-5,159.5,36,65,0,0,579,-21,-589,0
0,140,-255,395,-514,-489,-25,216.27777777777777,18,8,-29,0,394,-138,-533,0
0,1040,-534,1574,-238,-140,-98,374.1904761904762,42,44,-7,0,1595,775,-799,0
0,872,658,214,-126,-103,-23,23.0,2,1,-32,227,0,531,317,1
0,1165,535,630,-251,-213,-38,55.666666666666664,3,4,-66,651,0,824,194,1
0,1792,1164,628,-86,-76,-10,143.8,40,1,-25,0,619,1505,877,1
0,564,1614,-1050,-169,-196,27,237.5681818181818,44,103,0,0,-1075,257,1307,1
0,416,966,-550,-86,-210,124,176.2,30,128,-3,1,-552,109,659,1
1,244,-237,481,-519,-519,0,198.41666666666666,24,46,-1,0,482,-39,-520,0
1,904,-575,1479,-271,-212,-59,464.65625,32,94,-8,-10,1467,621,-858,0
1,626,-584,1210,-188,-242,54,340.6216216216216,37,110,-20,-35,1227,341,-869,0
1,471,-572,1043,-240,-251,11,302.0857142857143,35,58,0,0,1045,177,-866,0
0,826,1370,-544,-104,-34,-70,214.7058823529412,34,94,-49,190,-556,507,1051,1
0,22,11,11,-733,-687,-46,11.0,1,6,-413,-7,87,-311,-322,0
0,967,1111,-144,-226,-202,-24,112.375,8,41,-15,-140,69,634,778,1
0,566,585,-19,-186,-140,-46,89.15384615384616,39,62,-33,-72,313,233,252,1
1,410,396,14,-226,-210,-16,55.333333333333336,3,17,-75,-36,25,65,51,1
1,1149,-236,1385,-196,-389,193,535.4444444444445,27,185,-13,-32,1385,846,-539,0
1,818,-391,1209,-248,-230,-18,367.8837209302326,43,97,-42,-8,1577,495,-714,0
0,318,172,146,-413,-472,59,192.4375,32,71,-170,-464,144,-3,-149,1
1,1358,660,698,-163,-327,164,411.8888888888889,18,169,0,0,707,1060,362,1
0,711,-725,1436,-158,-114,-44,283.9019607843137,51,113,-31,-9,1440,398,-1038,0
1,254,-246,500,-517,-503,-14,195.72,25,29,-9,0,500,-59,-559,0
0,586,-962,1548,-217,-112,-105,301.88461538461536,52,74,-72,0,1569,258,-1290,0
1,1301,-538,1839,-175,-257,82,175.0,2,85,-6,1875,-7,967,-872,0
0,45,-6,51,-700,-698,-2,57.166666666666664,6,46,-486,67,-21,-265,-316,0
1,1042,657,385,-146,-283,137,360.90909090909093,11,109,0,-7,366,746,361,1
1,185,-548,733,-586,-589,3,450.94117647058823,17,23,-18,-26,731,-118,-851,0
1,696,-1166,1862,-186,-135,-51,377.6938775510204,49,62,-61,0,1863,372,-1490,0
1,910,784,126,-180,-197,17,123.2,10,49,-3,-1,140,629,503,1
0,1118,-395,1513,-245,-61,-184,367.3170731707317,41,12,-98,-3,1504,820,-693,0
1,728,-118,846,-215,-180,-35,347.6,10,78,0,1210,-10,424,-422,0
0,116,191,-75,-554,-464,-90,13.0,3,0,-55,-112,0,-177,-102,1
0,222,1256,-1034,-509,-145,-364,260.1951219512195,41,11,-357,0,-1032,-128,906,1
0,1403,937,466,-194,-213,19,183.24,25,27,0,0,476,1103,637,1
1,428,-495,923,-220,-179,-41,260.56756756756755,37,33,-27,-51,924,135,-788,0
1,200,116,84,-580,-458,-122,154.71428571428572,7,20,-3,0,118,-97,-181,1
0,544,-1247,1791,-213,-143,-70,417.23809523809524,42,44,-70,0,1783,241,-1550,0
0,1328,782,546,-198,-159,-39,189.35714285714286,28,15,-35,-2,550,1030,484,1
1,814,-628,1442,-189,-217,28,418.8285714285714,35,96,-7,-10,1443,562,-880,0
1,869,-384,1253,-239,-208,-31,332.2,40,50,-50,0,1343,596,-657,0
1,420,412,8,-144,-57,-87,91.45454545454545,11,38,-5,-25,72,161,153,1
0,479,1283,-804,-269,-112,-157,311.92,25,0,-108,0,-804,189,993,1
1,945,241,704,-251,-632,381,426.5263157894737,19,379,-11,0,707,658,-46,1
0,1245,-15,1260,-101,-670,569,357.8974358974359,39,542,0,0,1275,920,-340,0
0,1251,11,1240,-46,-665,619,326.4186046511628,43,569,0,0,1269,936,-304,0
1,19,-830,849,-366,-254,-112,600.3571428571429,14,0,-72,0,844,-313,-1162,0
0,12,-170,182,-763,-533,-230,152.33333333333334,12,0,-431,199,-1,-322,-504,0
1,781,658,123,-317,-326,9,198.0,7,16,-1,-6,123,489,366,1
0,702,-974,1676,-218,-160,-58,405.1190476190476,42,101,-37,-3,1689,395,-1281,0
0,541,-196,737,-270,-476,206,112.875,8,217,-78,720,-79,279,-458,0
0,563,-566,1129,-216,-153,-63,278.1707317073171,41,43,-34,-9,1132,307,-822,0
0,843,-1360,2203,-198,-156,-42,417.1730769230769,52,105,-17,0,2201,587,-1616,0
0,228,284,-56,-513,-549,36,77.375,8,36,-3,15,-56,-119,-63,1
0,1226,645,581,-211,-132,-79,183.4,35,6,-19,-5,648,922,341,1
0,112,204,-92,-410,-571,161,112.0,2,168,-36,-103,20,-196,-104,1
0,212,-271,483,-517,-447,-70,169.93103448275863,29,32,-72,-4,489,-86,-569,0
1,235,216,19,-508,-572,64,48.5,2,112,0,0,44,-83,-102,1
1,1303,-896,2199,-157,-229,72,455.8333333333333,48,114,0,-8,2205,975,-1224,0
0,131,184,-53,-357,-494,137,115.0,7,141,-92,-93,41,-197,-144,1
1,17,22,-5,-784,-772,-12,66.0,3,19,-6,0,-25,-322,-317,1
0,1003,-1108,2111,-188,-155,-33,408.40384615384613,52,100,-28,0,2117,708,-1403,0
1,527,-11,538,-110,-558,448,46.0,1,466,-13,548,-3,242,-296,0
0,2020,921,1099,-188,-223,35,283.7692307692308,39,122,-1,0,1105,1729,630,1
0,437,-601,1038,-235,-194,-41,328.75,32,66,-45,0,1057,143,-895,0
0,173,-822,995,-552,-164,-388,254.41860465116278,43,13,-370,0,1004,-127,-1122,0
1,459,278,181,-241,-271,30,248.66666666666666,21,36,-14,-1,534,180,-1,0
0,320,2078,-1758,-548,-214,-334,409.86046511627904,43,0,-325,3,-1743,-48,1710,1
0,251,240,11,-506,-398,-108,150.0,18,0,-213,0,193,-95,-106,1
0,847,-935,1782,-176,-39,-137,341.1764705882353,51,74,-57,0,1770,493,-1289,0
0,491,-1266,1757,-298,-59,-239,366.8936170212766,47,10,-175,0,1748,127,-1630,0
0,271,-249,520,-479,-445,-34,257.42857142857144,21,48,-40,0,543,-84,-604,0
1,649,-20,669,-187,-270,83,426.6470588235294,17,79,-9,-27,677,268,-401,0
0,1145,-179,1324,-206,-543,337,340.075,40,347,0,0,1352,902,-422,0
1,505,586,-81,-196,-65,-131,239.5,22,55,-45,444,-72,136,217,1
1,1259,803,456,-265,-175,-90,273.29411764705884,17,9,-29,0,462,962,506,1
1,892,375,517,-178,-187,9,371.73333333333335,15,79,0,-2,542,636,119,1
1,861,766,95,-216,-264,48,429.76190476190476,21,87,-1,993,0,561,466,0
1,500,456,44,-255,-255,0,212.5,16,47,-3,0,345,227,183,1
0,902,-1253,2155,-188,-145,-43,390.6666666666667,54,100,-5,-9,2135,571,-1584,0
0,855,-1127,1982,-225,-138,-87,354.5090909090909,55,64,-90,-1,1972,486,-1496,0
1,474,-671,1145,-155,-90,-65,315.85714285714283,35,91,-31,0,1086,171,-974,0
0,521,544,-23,-195,-132,-63,220.66666666666666,21,39,-71,412,-43,159,182,1
1,1073,427,646,-273,-345,72,439.5,14,72,0,0,638,762,116,1
0,223,-440,663,-558,-160,-398,263.25,28,1,-398,-1,670,-88,-751,0
1,1029,-403,1432,-206,-77,-129,105.25,4,83,-4,1497,-5,750,-682,0
0,1168,527,641,-240,-179,-61,218.3793103448276,29,2,-57,0,651,933,292,1
1,443,258,185,-122,-285,163,254.73684210526315,19,206,-14,0,499,129,-56,0
0,186,-174,360,-524,-447,-77,137.55555555555554,27,42,-36,0,369,-131,-491,0
0,597,-1390,1987,-177,-133,-44,424.02127659574467,47,142,-1,0,1984,315,-1672,0
1,727,-1247,1974,-249,-259,10,471.3333333333333,42,62,0,-7,1971,430,-1544,0
1,1026,-119,1145,-250,-266,16,528.0909090909091,22,73,0,0,1147,710,-435,0
1,448,273,175,-269,-299,30,196.75,8,21,-7,0,177,175,0,1
1,548,-476,1024,-248,-166,-82,276.9166666666667,36,29,-80,-4,1024,245,-779,0
1,732,-448,1180,-177,-249,72,412.42857142857144,28,97,0,0,1177,422,-758,0
1,2009,1177,832,-215,-154,-61,280.3666666666667,30,79,-7,0,830,1702,870,1
1,871,634,237,-198,-235,37,264.8888888888889,9,36,-13,0,236,543,306,1
0,458,-799,1257,-166,-126,-40,296.69767441860466,43,99,0,-1,1283,147,-1110,0
0,984,-975,1959,-218,-192,-26,414.6808510638298,47,91,-29,0,1953,710,-1249,0
0,543,-401,944,-108,-183,75,19.0,1,149,-1,962,-1,161,-783,0
0,10,736,-726,-275,-209,-66,335.0,21,0,-36,0,-740,-290,436,1
1,964,516,448,-235,-221,-14,379.75,12,0,-17,0,441,636,188,1
0,152,-871,1023,-227,-144,-83,319.16129032258067,31,18,-83,0,1018,-176,-1199,0
0,907,1345,-438,-88,-74,-14,151.35714285714286,28,9,-44,2,-448,581,1019,1
0,909,300,609,-394,-508,114,53.0,3,118,0,656,0,583,-26,1
0,607,-1232,1839,-246,-86,-160,377.6041666666667,48,0,-159,0,1838,309,-1530,0
1,1887,1515,372,-240,-189,-51,199.21052631578948,19,0,-43,0,375,1535,1163,1
0,1544,260,1284,-317,-508,191,261.53061224489795,49,197,-2,0,1285,1227,-57,1
1,1150,-452,1602,-125,-150,25,399.675,40,4,-37,-10,1618,832,-770,0
0,414,230,184,-218,-539,321,187.9375,16,312,0,0,204,-978,-1162,1
0,396,-537,933,-236,-170,-66,292.741935483871,31,1,-66,-1,937,70,-863,0
1,786,509,277,-247,-244,-3,285.6,10,4,-14,-6,278,460,183,1
1,302,-255,557,-276,-354,78,292.7894736842105,19,78,0,0,557,-7,-564,0
0,1853,457,1396,-242,-185,-57,256.8888888888889,54,0,-82,0,1414,1550,154,1
0,113,-247,360,-556,-423,-133,149.58333333333334,24,12,-60,0,360,-159,-519,0
1,749,571,178,-237,-250,13,214.5,8,10,0,-1,174,400,222,1
0,1658,1761,-103,-134,-31,-103,123.18181818181819,11,19,-13,0,-147,1365,1468,1
0,522,1416,-894,-253,-211,-42,279.6875,32,51,-42,0,-900,193,1087,1
0,192,236,-44,-634,-514,-120,147.33333333333334,6,0,-111,0,-54,-104,-60,1
0,853,-1304,2157,-246,-83,-163,376.89473684210526,57,33,-65,-9,2160,557,-1600,0
1,1153,793,360,-235,-301,66,335.45454545454544,11,70,0,0,371,828,468,1
1,1484,971,513,-314,-172,-142,217.75,24,3,-92,0,521,1181,668,1
0,604,-460,1064,-208,-198,-10,299.6388888888889,36,64,-14,0,1074,301,-763,0
1,836,-152,988,-246,-231,-15,488.6818181818182,22,61,-25,-81,989,520,-468,0
1,536,215,321,-175,-244,69,328.0,10,78,-3,0,327,247,-74,1
1,601,-356,957,-176,-231,55,368.3076923076923,26,66,-1,0,964,302,-655,0
1,992,-351,1343,-171,-262,91,491.57142857142856,28,144,0,-10,1338,694,-649,0
1,1026,665,361,-189,-267,78,350.4166666666667,12,114,-3,-21,372,744,383,1
1,722,-11,733,-210,-509,299,491.88235294117646,17,349,0,0,736,408,-325,0
0,987,-38,1025,-383,-752,369,376.55172413793105,29,383,0,0,1062,684,-341,0
0,836,-297,1133,-252,-530,278,288.4,40,277,0,0,1132,556,-577,0
1,486,-1341,1827,-192,-164,-28,362.46,50,31,-37,0,1821,160,-1667,0
1,1466,441,1025,-192,-200,8,350.3448275862069,29,46,0,0,1026,1169,144,1
1,1526,873,653,-186,-177,-9,267.5833333333333,24,28,-9,0,648,1204,551,1
1,1264,820,444,-205,-219,14,293.53333333333336,15,61,-34,0,436,887,443,1
0,623,1121,-498,-326,-248,-78,301.0625,16,0,-67,0,-499,319,817,1
1,468,-775,1243,-241,-229,-12,435.62068965517244,29,26,-5,-3,1264,127,-1116,0
1,868,-562,1430,-196,-252,56,372.84090909090907,44,54,-1,0,1660,575,-855,0
1,502,-713,1215,-269,-272,3,356.1764705882353,34,31,-18,-4,1212,201,-1014,0
0,340,485,-145,-481,-184,-297,131.35294117647058,17,0,-222,1,-158,-6,139,1
1,470,-618,1088,-191,-150,-41,306.46153846153845,39,78,-44,0,1241,175,-913,0
1,1233,717,516,-181,-235,54,356.2,15,57,-12,0,529,898,382,1
0,163,265,-102,-558,-463,-95,68.52941176470588,17,367,0,0,-185,-146,-44,1
1,776,-51,827,-154,-752,598,512.7692307692307,13,614,0,1326,-8,465,-362,0
1,442,189,253,-277,-294,17,286.1111111111111,9,19,0,-1,250,126,-127,1
1,630,448,182,-218,-330,112,265.5,8,108,0,-17,179,345,163,1
0,235,-234,469,-579,-580,1,239.68421052631578,19,18,-9,0,469,-64,-533,0
0,442,-442,884,-226,-251,25,258.7647058823529,34,41,0,-3,898,130,-754,0
0,252,-208,460,-530,-479,-51,196.9090909090909,22,25,-12,0,445,-73,-533,0
1,2171,1458,713,-205,-154,-51,233.73333333333332,30,30,-39,0,710,1809,1096,1
1,687,150,537,-214,-280,66,247.5,22,70,0,536,-108,388,-149,1
0,1017,-1069,2086,-181,-114,-67,383.462962962963,54,135,0,0,2092,662,-1424,0
0,233,-207,440,-513,-479,-34,220.1818181818182,22,56,-11,-3,477,-110,-550,0
0,661,703,-42,-267,-207,-60,126.0,3,0,-64,0,-39,369,411,1
0,1894,1897,-3,-104,-99,-5,86.78571428571429,42,315,-24,-16,375,1586,1589,1
0,441,-543,984,-197,-190,-7,130.85135135135135,74,162,-11,-1,983,133,-851,0
1,963,-1162,2125,-175,-291,116,461.80434782608694,46,166,0,0,2120,678,-1447,0
0,497,492,5,-225,-192,-33,170.8095238095238,21,40,-40,377,-3,212,207,1
0,260,-588,848,-247,-237,-10,365.04347826086956,23,50,-14,0,850,-47,-895,0
0,704,771,-67,-276,-268,-8,183.95833333333334,24,92,0,396,-61,399,466,1
0,342,-937,1279,-225,-136,-89,343.81081081081084,37,47,-36,0,1278,39,-1240,0
0,346,1389,-1043,-546,-124,-422,337.57575757575756,33,0,-375,0,-1044,44,1087,1
0,449,-432,881,-184,-240,56,249.94117647058823,34,75,0,0,897,116,-765,0
1,1235,918,317,-200,-184,-16,212.6875,16,12,-26,-22,323,902,585,1
0,388,1946,-1558,-354,-189,-165,421.56756756756755,37,0,-168,0,-1576,46,1604,1
0,1982,2006,-24,-175,-64,-111,3.0,1,2,-30,-30,10,1683,1707,1
0,502,1224,-722,-306,-134,-172,307.5652173913044,23,0,-68,0,-727,183,905,1
1,1046,239,807,-214,-388,174,289.82758620689657,29,236,-3,-3,815,727,-80,1
0,426,550,-124,-366,-139,-227,149.75,12,0,-155,0,-139,85,209,1
0,178,-235,413,-534,-418,-116,162.28,25,39,-60,0,443,-113,-526,0
1,160,-132,292,-577,-566,-11,307.2,10,13,-21,-7,298,-168,-460,0
0,288,296,-8,-526,-480,-46,20.0,2,0,-19,8,-8,-17,-9,1
1,1219,758,461,-216,-136,-80,174.76923076923077,26,2,-76,0,466,946,485,1
0,31,-536,567,-270,-193,-77,213.08,25,4,-87,0,567,-272,-839,0
1,276,241,35,-629,-519,-110,40.0,6,0,-91,7,-53,-12,-47,1
0,399,197,202,-242,-399,157,177.48275862068965,29,201,-4,-34,490,107,-95,0
1,804,-447,1251,-228,-365,137,509.52,25,138,-2,-1,1258,536,-715,0
1,480,550,-70,-204,-189,-15,46.0,1,0,-21,-70,11,208,278,1
1,403,-242,645,-289,-414,125,296.6190476190476,21,169,-5,0,637,115,-530,0
1,759,-744,1503,-290,-199,-91,423.6857142857143,35,21,-18,0,1494,473,-1030,0
0,815,-1060,1875,-170,-170,0,331.10714285714283,56,39,-35,0,1880,514,-1361,0
1,561,545,16,-134,-154,20,26.25,4,22,0,-20,26,278,262,1
1,825,-543,1368,-243,-260,17,301.77777777777777,45,53,-8,0,1363,536,-832,0
0,106,249,-143,-538,-392,-146,46.0,1,0,-56,-134,0,-189,-46,1
1,754,-448,1202,-230,-157,-73,384.93548387096774,31,42,0,0,1211,459,-743,0
1,648,-1012,1660,-237,-194,-43,357.59574468085106,47,97,-40,-8,1655,322,-1338,0
1,369,405,-36,-125,-71,-54,59.142857142857146,14,0,-45,2,-117,75,111,1
1,767,-518,1285,-234,-271,37,448.6551724137931,29,66,0,-7,1281,464,-821,0
0,1517,1719,-202,-95,0,-95,198.572,250,1050,-3,4456,-226,1200,1402,0
0,3307,-249,3556,-650,-457,-193,169.30366492146598,191,493,-135,-38,3612,3018,-538,0
0,1287,2116,-829,-88,-36,-52,84.27350427350427,117,896,-39,-839,1152,998,1827,1
0,997,953,44,-121,-51,-70,189.95752895752895,259,1014,-6,3835,-8,680,636,0
0,760,950,-190,-161,-74,-87,72.73809523809524,126,928,-47,-319,699,471,661,1
1,1016,391,625,-267,-271,4,232.76923076923077,26,46,0,0,611,775,150,1
0,372,298,74,-565,-467,-98,50.0,3,10,-18,124,-45,39,-35,1
0,437,165,272,-258,-336,78,145.0625,16,178,0,-5,245,193,-79,1
0,456,1180,-724,-491,32,-523,182.16666666666666,42,2,-441,2,-697,123,847,1
1,644,471,173,-320,-296,-24,6.0,1,12,-24,186,-25,309,136,1
0,11,-203,214,-637,-559,-78,128.7058823529412,17,7,-81,0,221,-259,-473,0
0,186,-276,462,-604,-493,-111,150.13333333333333,30,27,-29,0,470,-94,-556,0
0,246,252,-6,-562,-530,-32,170.125,24,44,-31,-4,409,-34,-28,0
0,1614,234,1380,-208,-563,355,319.5925925925926,54,374,-5,-1,1509,1317,-63,1
0,313,293,20,-526,-482,-44,51.5,6,0,-45,42,-2,-28,-48,1
0,819,-946,1765,-282,-152,-130,394.5777777777778,45,22,-108,-1,1786,541,-1224,0
0,1291,-244,1535,-174,-513,339,9.0,1,456,0,1548,-7,953,-582,0
0,1561,-517,2078,-268,-203,-65,386.22222222222223,54,36,-45,-4,2091,1287,-791,0
0,476,-488,964,-215,-143,-72,2.0,1,39,-46,950,0,173,-791,0
1,520,-701,1221,-216,-333,117,460.74074074074076,27,114,-1,-12,1225,241,-980,0
1,1021,435,586,-257,-334,77,334.0,19,129,-5,-22,588,687,101,1
1,847,-580,1427,-101,-72,-29,455.3225806451613,31,23,-32,-1,1418,568,-859,0
0,743,-854,1597,-235,-181,-54,109.1304347826087,23,36,-61,1966,0,339,-1258,0
1,1237,651,586,-85,-334,249,379.4375,16,255,0,0,592,940,354,1
1,27,-328,355,-771,-258,-513,441.3636363636364,11,0,-514,-67,337,-259,-614,0
1,25,-6,31,-746,-704,-42,36.5,4,0,-15,48,0,-309,-340,0
0,200,-1560,1760,-435,-149,-286,381.9148936170213,47,0,-307,0,1768,-70,-1830,0
1,609,463,146,-253,-270,17,160.33333333333334,15,44,0,-19,226,339,193,1
0,123,-289,412,-557,-547,-10,183.28571428571428,21,17,-19,0,410,-147,-559,0
1,315,324,-9,-357,-347,-10,47.4,5,25,-17,77,-10,12,21,1
1,932,585,347,-227,-301,74,318.0,12,109,0,-8,351,627,280,1
1,1775,848,927,-275,-158,-117,315.53333333333336,30,58,-6,0,953,1466,539,1
1,745,-814,1559,-285,-126,-159,482.5,32,17,-3,-4,1547,438,-1121,0
1,676,-641,1317,-255,-288,33,337.79487179487177,39,54,-3,-8,1315,372,-945,0
1,140,-732,872,-259,-143,-116,388.4347826086956,23,8,-141,0,902,-144,-1016,0
1,1491,1470,21,-132,-79,-53,78.66666666666667,9,7,-15,109,0,1189,1168,1
1,390,-550,940,-315,-215,-100,392.7083333333333,24,7,-56,0,948,80,-860,0
1,1478,1462,16,-73,80,-153,53.0,6,7,0,76,0,1198,1182,1
1,432,-471,903,-244,-268,24,462.65,20,46,-1,0,911,140,-763,0
0,725,-781,1506,-143,-81,-62,353.6904761904762,42,131,-4,-10,1500,414,-1092,0
1,589,-339,928,-199,-163,-36,452.95238095238096,21,78,-8,0,936,261,-667,0
1,652,49,603,-262,-255,-7,408.8,15,91,0,0,600,361,-242,1
0,441,-455,896,-253,-29,-224,251.11764705882354,34,8,-91,-1,889,137,-759,0
0,217,-255,472,-583,-456,-127,219.28571428571428,21,13,-20,-2,478,-102,-574,0
0,418,819,-401,-298,-67,-231,149.80769230769232,26,20,-100,11,-400,134,535,1
0,241,209,32,-488,-457,-31,163.0,12,47,-167,0,166,-74,-106,1
1,844,74,770,-279,-257,-22,443.1111111111111,18,0,-21,-1,783,511,-259,1
1,1478,927,551,-185,-138,-47,260.95238095238096,21,16,-6,-7,555,1177,626,1
0,69,190,-121,-512,-499,-13,141.52941176470588,17,24,-12,-120,270,-234,-113,0
1,776,653,123,-276,-260,-16,346.5416666666667,24,50,-6,-1,841,465,342,0
0,225,203,22,-477,-407,-70,263.42857142857144,14,0,-351,-5,160,-69,-91,1
1,891,-391,1282,-224,-306,82,524.68,25,116,-6,-4,1284,610,-672,0
1,950,-95,1045,-194,-264,70,507.1904761904762,21,123,0,-13,1033,646,-399,0
0,1180,244,936,-367,-421,54,270.25714285714287,35,161,0,0,941,856,-80,1
0,443,-419,862,-122,-191,69,272.8484848484849,33,142,0,-2,884,157,-705,0
0,856,-613,1469,-181,-206,25,396.5135135135135,37,76,0,0,1473,543,-926,0
0,254,-718,972,-509,-139,-370,313.72727272727275,33,4,-254,0,994,-96,-1068,0
0,714,-429,1143,-192,-229,37,14.0,1,56,-19,1152,-6,415,-728,0
0,6,-1412,1418,-769,-64,-705,393.35897435897436,39,5,-593,-2,1439,-295,-1713,0
0,776,-848,1624,-158,-120,-38,360.8222222222222,45,103,-48,0,1632,497,-1127,0
0,517,-542,1059,-322,-179,-143,296.9166666666667,36,3,-105,-4,1067,196,-863,0
0,189,220,-31,-505,-356,-149,63.666666666666664,3,0,-21,0,-37,-159,-128,1
1,844,-430,1274,-184,-130,-54,510.32,25,86,0,0,1274,509,-765,0
0,596,200,396,-182,-495,313,286.1,20,315,-2,0,588,270,-126,1
1,829,-197,1026,-151,-396,245,446.9166666666667,24,263,0,-20,1028,531,-495,0
0,776,-656,1432,-244,-222,-22,374.5263157894737,38,63,-20,0,1432,448,-984,0
0,1613,693,920,-197,-79,-118,307.06666666666666,30,34,-122,0,923,1295,375,1
0,790,18,772,-175,-771,596,188.125,48,607,-2,-3,786,496,-276,1
0,1057,-5,1062,-170,-722,552,225.01923076923077,52,586,-2,-27,1062,757,-305,0
0,1763,717,1046,-170,-176,6,225.15217391304347,46,44,0,0,1044,1290,244,1
0,227,252,-25,-508,-374,-134,82.5,4,0,-27,0,-41,-93,-68,1
0,837,26,811,-129,-746,617,217.85714285714286,42,642,0,-18,827,542,-269,1
0,1241,25,1216,-203,-745,542,306.40909090909093,44,546,0,-10,1262,930,-286,0
1,635,-325,960,-196,-624,428,485.9166666666667,24,551,-18,-55,946,382,-578,0
0,1982,1975,7,-124,8,-132,67.3529411764706,17,53,-9,151,0,1664,1657,1
0,824,-1182,2006,-250,-72,-178,404.6938775510204,49,39,-64,-1,2010,500,-1506,0
0,217,-239,456,-547,-457,-90,200.3913043478261,23,42,-8,0,462,-125,-581,0
0,748,-1143,1891,-267,-120,-147,551.0,34,11,-55,0,1906,406,-1485,0
0,1886,1362,524,-46,111,-157,122.56,50,11,-41,0,535,1603,1079,1
0,1030,465,565,-171,-21,-150,157.25641025641025,39,23,-46,-10,610,747,182,1
0,1888,1902,-14,-107,3,-110,140.2037037037037,54,16,-48,-29,737,1627,1641,1
0,886,-1123,2009,-234,-182,-52,423.6595744680851,47,60,-57,0,2010,595,-1414,0
1,900,-617,1517,-225,-207,-18,570.1111111111111,27,95,-4,-9,1508,609,-908,0
0,233,-290,523,-468,-456,-12,161.5483870967742,31,61,-1,-1,516,-51,-574,0
1,533,-478,1011,-221,-174,-47,378.9259259259259,27,43,-40,0,1015,252,-759,0
0,232,-415,647,-566,-244,-322,259.18518518518516,27,0,-340,-1,661,-79,-726,0
1,930,-275,1205,-199,-395,196,465.4074074074074,27,194,0,-10,1204,619,-586,0
0,607,-943,1550,-314,-208,-106,445.7647058823529,34,16,-118,0,1547,319,-1231,0
0,250,-220,470,-543,-499,-44,222.47619047619048,21,29,-33,-3,472,-73,-543,0
1,801,-595,1396,-201,-323,122,405.74285714285713,35,150,0,-13,1397,518,-878,0
1,734,757,-23,-213,-45,-168,100.0,3,0,-6,0,37,461,484,1
1,438,447,-9,-243,-65,-178,81.0,6,0,-16,0,51,165,174,1
1,15,35,-20,-690,-509,-181,112.0,4,0,-19,0,40,-258,-238,1
1,6,-290,296,-293,-156,-137,210.0,17,0,-233,-1,274,-245,-541,0
1,257,-17,274,-496,-705,209,217.0625,16,230,0,-1,277,-40,-314,0
0,402,-400,802,-174,-153,-21,234.8,35,55,-9,0,819,114,-688,0
0,462,-582,1044,-220,-51,-169,312.1111111111111,36,112,-172,0,1065,174,-870,0
1,366,-1115,1481,-229,-123,-106,135.16,25,55,-93,1474,-359,73,-1408,0
0,329,-405,734,-227,-254,27,65.6,5,42,0,754,0,33,-701,0
0,1214,614,600,-183,-150,-33,193.29032258064515,31,42,-34,0,608,934,334,1
1,996,100,896,-241,-408,167,393.1363636363636,22,159,-21,0,898,710,-186,1
0,1128,830,298,-162,-79,-83,117.79166666666667,24,30,-108,0,326,833,535,1
1,1305,780,525,-116,-390,274,419.35714285714283,14,270,0,-4,516,1022,497,1
1,1005,-654,1659,-188,-180,-8,454.2162162162162,37,87,0,0,1683,705,-954,0
1,1237,660,577,-232,-250,18,388.6,15,34,-1,0,580,971,394,1
0,13,-482,495,-262,-178,-84,233.57142857142858,21,0,-63,0,520,-274,-769,0
0,1126,731,395,-128,-133,5,11.0,1,25,-4,402,-10,863,468,1
1,1080,733,347,-183,-191,8,318.8333333333333,12,72,0,-16,356,758,411,1
0,300,457,-157,-289,-225,-64,163.45454545454547,11,0,-66,0,-188,-35,122,1
1,803,413,390,-205,-249,44,278.7142857142857,28,64,-4,-2,778,494,104,1
0,290,-1903,2193,-279,-185,-94,445.6938775510204,49,32,-101,0,2194,-10,-2203,0
1,776,-335,1111,-241,-367,126,482.7391304347826,23,103,0,0,1099,473,-638,0
0,1384,813,571,-242,-191,-51,196.13793103448276,29,15,-46,0,575,1077,506,1
1,1307,198,1109,-186,-234,48,432.75,12,94,-4,1583,-2,1001,-108,0
0,1236,729,507,-175,-194,19,180.33333333333334,27,27,0,0,510,935,428,1
1,699,-386,1085,-290,-366,76,459.3333333333333,24,106,-2,-10,1083,389,-696,0
1,216,-221,437,-600,-570,-30,220.9,20,14,-32,0,441,-94,-531,0
0,509,-316,825,-281,-492,211,313.65384615384613,26,202,0,0,818,210,-615,0
0,1527,489,1038,-151,-228,77,52.0,3,86,-3,1060,-6,1181,143,1
0,1932,480,1452,-154,-140,-14,373.5897435897436,39,53,-22,0,1477,1635,183,1
0,1026,-923,1949,-174,-116,-58,367.3018867924528,53,95,-3,-2,1959,722,-1227,0
0,5,544,-539,-531,-175,-356,207.13793103448276,29,0,-352,0,-538,-347,192,1
1,898,-385,1283,-212,-304,92,469.2857142857143,28,90,0,-3,1291,590,-693,0
0,996,-1059,2055,-132,-154,22,396.96153846153845,52,192,0,-5,2045,691,-1364,0
0,64,-15,79,-603,-736,133,156.22222222222223,9,139,0,0,90,-234,-313,0
1,844,274,570,-254,-299,45,380.8,15,47,-3,-5,550,563,-7,1
0,129,841,-712,-249,-159,-90,244.82142857142858,28,0,-90,0,-708,-204,508,1
0,1488,224,1264,-126,-387,261,267.88235294117646,51,378,0,0,1308,1179,-85,1
0,897,1195,-298,-104,35,-139,8.0,1,0,-56,-287,0,588,886,1
1,1454,929,525,-252,-228,-24,182.17241379310346,29,7,-21,0,528,1146,621,1
1,963,482,481,-193,-267,74,402.44,25,87,-1,-2,1019,636,155,0
1,760,393,367,-193,-268,75,359.9583333333333,24,108,-3,-10,851,462,95,0
1,202,1118,-916,-576,-729,153,535.5555555555555,27,196,0,492,-914,-82,834,0
1,892,-50,942,-229,-269,40,456.7142857142857,21,44,0,-6,943,611,-331,0
0,802,910,-108,-101,-33,-68,97.72222222222223,18,40,-41,-154,25,488,596,1
0,195,256,-61,-493,-412,-81,74.5,6,4,-30,-50,81,-119,-58,1
1,844,405,439,-240,-328,88,373.75,8,90,0,711,-9,514,75,1
0,1174,536,638,-255,-103,-152,31.0,1,13,-60,646,0,839,201,1
1,702,485,217,-250,-321,71,418.7,10,70,0,614,-3,418,201,1
0,523,-439,962,-188,-66,-122,54.0,1,64,-125,972,0,204,-758,0
1,286,-1336,1622,-623,-683,60,609.6296296296297,27,77,0,0,1620,-34,-1656,0
0,1099,1081,18,-228,-73,-155,331.43589743589746,39,94,-48,-2,1295,824,806,0
1,980,421,559,-208,-258,50,2.0,1,49,-9,552,-5,632,73,1
0,61,-506,567,-281,-175,-106,235.33333333333334,24,0,-116,0,567,-226,-793,0
1,784,575,209,-160,-296,136,461.54545454545456,11,147,-1,696,-3,477,268,1
0,767,-909,1676,-239,-146,-93,142.55555555555554,18,18,-97,1682,-259,459,-1217,0
1,222,-173,395,-462,-452,-10,206.94736842105263,19,4,-10,-1,397,-80,-475,0
0,1201,1202,-1,-311,-266,-45,123.5,14,13,-20,-23,188,895,896,1
0,221,-251,472,-508,-465,-43,207.56521739130434,23,67,-4,0,480,-74,-546,0
1,1061,-396,1457,-245,-328,83,539.3703703703703,27,76,-7,0,1459,625,-832,0
0,10,-412,422,-268,72,-340,228.0,24,0,-339,-3,448,-320,-742,0
0,425,-382,807,-235,-208,-27,262.2903225806452,31,45,-3,0,828,151,-656,0
0,723,-416,1139,-221,-183,-38,44.0,1,29,-43,1167,-10,420,-719,0
1,609,341,268,-249,-259,10,232.66666666666666,12,0,-25,0,281,352,84,1
0,180,0,180,-535,-791,256,162.89473684210526,19,317,0,-1,190,-137,-317,0
1,924,-833,1757,-207,-146,-61,336.7169811320755,53,117,-61,-6,1762,623,-1134,0
0,626,1466,-840,-333,-254,-79,352.6521739130435,23,1,-81,0,-839,350,1190,1
0,811,1590,-779,-336,-215,-121,306.56,25,0,-135,0,-780,522,1301,1
0,1308,1634,-326,-63,-89,26,127.61538461538461,26,38,-22,0,-338,1010,1336,1
0,1289,230,1059,-293,-456,163,302.14285714285717,35,165,0,0,1064,997,-62,1
1,954,2,952,-229,-670,441,437.5,24,444,0,-3,950,662,-290,1
1,1121,-529,1650,-208,-330,122,555.3,30,128,-4,0,1651,829,-821,0
0,733,1147,-414,-198,-148,-50,97.23076923076923,26,88,-19,-407,252,431,845,1
1,580,-500,1080,-193,-124,-69,358.1666666666667,30,75,-3,0,1076,278,-802,0
0,1616,245,1371,-229,-394,165,369.20512820512823,39,274,0,0,1425,1294,-77,1
0,434,1142,-708,-287,-160,-127,192.1764705882353,34,0,-133,0,-713,121,829,1
1,1127,-1026,2153,-208,-116,-92,393.8703703703704,54,30,-72,-10,2134,825,-1328,0
1,472,437,35,-82,-14,-68,105.0,2,0,-61,-4,26,161,126,1
0,438,909,-471,-445,-204,-241,171.56666666666666,30,0,-245,0,-474,88,559,1
1,1236,-887,2123,-282,-250,-32,450.0,47,72,-39,-1,2129,886,-1237,0
1,905,517,388,-190,-301,111,323.61538461538464,13,109,-3,-13,391,614,226,1
1,1877,1427,450,-176,-207,31,218.25,20,31,-2,0,452,1583,1133,1
0,102,360,-258,-524,-466,-58,125.4,20,0,-69,0,-258,-236,22,1
0,115,-1000,1115,-315,-139,-176,338.6363636363636,33,0,-197,0,1143,-208,-1323,0
1,980,-574,1554,-188,-248,60,469.1714285714286,35,91,-4,-5,1648,663,-891,0
0,69,1211,-1142,-287,-185,-102,325.4,35,21,-105,0,-1154,-251,891,1
1,824,-859,1683,-214,-268,54,386.69767441860466,43,102,-6,-8,1673,478,-1205,0
1,1040,-515,1555,-258,-248,-10,360.93023255813955,43,81,-10,-4,1544,729,-826,0
0,244,595,-351,-501,-70,-431,239.8421052631579,19,0,-405,2,-341,-222,129,1
1,1739,1044,695,-269,-225,-44,227.96666666666667,30,1,-46,0,698,1408,713,1
1,9,4,5,-681,-605,-76,134.33333333333334,3,0,-29,-3,28,-256,-261,1
1,984,213,771,-233,-579,346,452.57894736842104,19,343,0,-3,773,682,-89,1
0,86,280,-194,-174,-446,272,130.70833333333334,24,273,-11,11,-196,-233,-39,1
0,1403,495,908,-219,-192,-27,240.19444444444446,36,16,-38,-1,917,1104,196,1
1,1884,1443,441,-250,-210,-40,199.61904761904762,21,0,-38,0,441,1599,1158,1
1,1174,-621,1795,-142,-232,90,393.60869565217394,46,110,0,0,1799,880,-915,0
0,501,-556,1057,-121,-160,39,31.0,1,119,-6,1055,-25,145,-912,0
1,789,-1410,2199,-322,-305,-17,480.2608695652174,46,61,-18,-10,2206,470,-1729,0
0,792,1232,-440,-310,-170,-140,157.41379310344828,29,8,-150,5,-450,457,897,1
1,256,-300,556,-638,-553,-85,475.0,12,18,-4,0,570,-78,-634,0
1,1082,-1368,2450,-136,-122,-14,444.09090909090907,55,91,-12,0,2454,760,-1690,0
0,533,-702,1235,-264,-244,-20,354.1714285714286,35,55,-14,0,1249,217,-1018,0
1,479,228,251,-207,-310,103,261.2,10,103,-30,-2,250,183,-68,1
0,236,563,-327,-218,-183,-35,223.26666666666668,15,1,-44,0,-360,-92,235,1
1,604,161,443,-212,-775,563,375.76666666666665,30,558,0,-1,1090,303,-140,0
1,1847,1523,324,-137,-185,48,213.66666666666666,15,48,0,0,325,1559,1235,1
0,750,-515,1265,-209,-157,-52,359.77142857142854,35,56,-49,0,1265,442,-823,0
1,50,-229,279,-561,-423,-138,118.9,10,19,-26,296,-130,-248,-527,0
1,915,700,215,-212,-252,40,246.5,8,52,-7,0,211,583,368,1
0,499,201,298,296,-71,367,208.0,18,289,-3,-1,300,182,-116,1
0,1053,-1078,2131,-170,-189,19,382.3392857142857,56,75,-33,0,2151,740,-1391,0
0,1222,1432,-210,-86,-79,-7,102.68888888888888,45,115,-4,195,-333,921,1131,1
1,1975,1554,421,-295,-249,-46,156.9375,32,147,-64,-32,481,1696,1275,1
0,1108,1169,-61,-256,-107,-149,53.7,20,104,-138,-27,172,829,890,1
1,2380,629,1751,-278,-340,62,430.3658536585366,41,95,-2,-19,1745,2077,326,1
1,1078,-36,1114,-231,-278,47,489.39130434782606,23,47,-3,-5,1109,753,-361,0
0,465,-458,923,-224,-197,-27,270.61764705882354,34,29,-26,0,926,162,-761,0
1,240,-409,649,-537,-200,-337,47.0,1,0,-318,665,-9,-64,-713,0
0,223,-1758,1981,-499,-164,-335,424.5744680851064,47,0,-333,0,1982,-81,-2062,0
0,553,680,-127,-168,-141,-27,281.7368421052632,19,39,-28,-118,522,213,340,1
1,2048,1419,629,-111,-211,100,252.88,25,110,-2,0,626,1757,1128,1
1,2001,1465,536,-144,-109,-35,209.33333333333334,27,51,-10,0,558,1668,1132,1
1,1206,547,659,-150,-100,-50,235.3793103448276,29,55,-30,-3,702,869,210,1
0,516,-723,1239,-195,-120,-75,316.25,40,67,-75,0,1262,217,-1022,0
1,1997,1668,329,-165,-199,34,166.1578947368421,19,31,-7,0,330,1713,1384,1
0,1255,-788,2043,-202,-199,-3,381.25925925925924,54,138,-5,-9,2040,940,-1103,0
0,577,-1103,1680,-230,-161,-69,343.75,48,88,-2,-2,1673,116,-1564,0
0,403,-547,950,-271,-46,-225,253.22222222222223,36,46,-50,-3,934,81,-869,0
0,892,498,394,-285,-204,-81,179.61904761904762,21,0,-64,0,404,573,179,1
0,248,-754,1002,-550,-179,-371,327.625,32,0,-378,0,1000,-96,-1098,0
1,1128,-220,1348,-166,-311,145,440.27272727272725,11,145,-2,1813,-9,840,-508,0
1,479,347,132,-204,-214,10,242.2,5,19,0,0,127,243,111,1
0,34,1108,-1074,-316,-184,-132,360.7586206896552,29,0,-127,0,-1071,-237,837,1
1,433,-449,882,-284,-282,-2,280.03225806451616,31,28,-1,-1,878,90,-792,0
0,482,-388,870,-265,-264,-1,275.0,31,36,-11,0,872,160,-710,0
0,567,214,353,-196,-417,221,246.0,19,263,-6,0,449,433,80,1
0,432,674,-242,-114,-60,-54,148.2,15,2,-51,0,-250,162,404,1
0,1280,1298,-18,-188,-79,-109,98.78571428571429,14,6,-109,114,-19,1009,1027,1
1,265,247,18,-526,-381,-145,33.0,3,0,-13,-1,26,-66,-84,1
1,13,-74,87,-497,-280,-217,301.8333333333333,12,6,-239,438,0,-329,-416,0
0,431,-867,1298,-265,-223,-42,275.7391304347826,46,32,-21,0,1299,95,-1203,0
0,492,728,-236,-246,-135,-111,206.79310344827587,29,66,-12,369,-238,165,401,1
0,31,213,-182,-818,-579,-239,175.0,15,0,-241,0,-186,-302,-120,1
0,881,1002,-121,-153,-118,-35,71.0,15,35,-14,0,-138,586,707,1
1,434,-810,1244,-249,-184,-65,287.69767441860466,43,44,-1,0,1260,92,-1152,0
0,538,-405,943,-253,-45,-208,278.5,34,83,-44,-2,954,193,-750,0
1,774,-829,1603,-153,60,-213,367.47727272727275,44,101,-50,-8,1589,419,-1184,0
0,4,207,-203,-746,-547,-199,190.375,16,0,-225,0,-227,-286,-83,1
0,12,210,-198,-674,-518,-156,57.333333333333336,3,0,-199,-219,29,-277,-79,0
0,549,-552,1101,-222,-206,-16,334.93939393939394,33,29,-27,0,1114,307,-794,0
1,188,16,172,-466,-560,94,294.75,8,91,-2,-32,173,-113,-285,1
0,576,-457,1033,-196,-212,16,290.4,35,49,0,0,1029,278,-755,0
0,297,1916,-1619,-513,-168,-345,397.95238095238096,42,4,-347,4,-1615,-4,1615,1
0,828,205,623,-233,-524,291,248.92592592592592,27,292,-12,0,623,549,-74,1
0,780,-1104,1884,-201,-189,-12,400.2291666666667,48,172,-12,0,1884,464,-1420,0
1,1488,753,735,-267,-188,-79,256.1034482758621,29,50,-23,0,749,1155,420,1
0,456,173,283,-238,-327,89,177.7058823529412,17,94,-3,0,299,156,-127,1
1,1071,685,386,-191,-272,81,339.5,12,81,0,0,388,758,372,1
1,208,721,-513,-289,-125,-164,218.2173913043478,23,0,-75,0,-501,-162,351,1
0,554,-476,1030,-204,-227,23,312.09375,32,45,0,0,1036,261,-769,0
1,974,216,758,-231,-467,236,362.8181818181818,22,235,-1,-3,764,677,-81,1
1,1263,123,1140,-172,-737,565,384.2857142857143,42,568,0,-5,1531,981,-159,0
1,687,216,471,-259,-361,102,370.2857142857143,14,113,-2,-8,492,415,-56,1
0,1047,-431,1478,-242,-189,-53,303.375,48,71,-50,-3,1477,750,-728,0
1,194,407,-213,-548,-241,-307,132.66666666666666,3,0,-327,-268,3,-94,119,1
0,592,-1402,1994,-257,-233,-24,364.72222222222223,54,47,-30,0,1999,278,-1716,0
1,151,-375,526,-296,-544,248,216.92307692307693,26,231,0,0,520,-163,-689,0
1,433,455,-22,-198,-111,-87,62.0,6,0,-9,0,53,27,49,1
1,645,1243,-598,-213,-790,577,567.3529411764706,34,645,0,1152,-595,349,947,0
1,944,313,631,-293,-394,101,440.46666666666664,15,98,0,-1,633,634,3,1
1,179,378,-199,-521,-225,-296,133.0,5,0,-313,-289,0,-104,95,1
1,932,380,552,-232,-371,139,393.8666666666667,15,164,-5,-5,550,622,70,1
1,272,-456,728,-302,-332,30,363.3076923076923,13,43,-48,1186,0,-70,-798,0
0,260,1181,-921,-251,-119,-132,421.4761904761905,21,6,-104,0,-906,-57,864,1
1,221,562,-341,-308,-349,41,293.5882352941176,34,39,-83,0,-1034,-143,198,1
0,500,1031,-531,-448,-229,-219,234.18421052631578,38,102,-214,295,-548,174,705,1
1,973,532,441,-161,-296,135,358.46153846153845,13,125,-2,0,441,647,206,1
0,597,-602,1199,-210,-188,-22,306.3333333333333,39,68,-29,-4,1202,284,-915,0
1,1574,1199,375,-148,-125,-23,250.66666666666666,15,21,0,-5,367,1282,907,1
1,1471,587,884,-204,-333,129,449.65,20,126,-11,0,886,1176,292,1
0,1450,739,711,-255,-180,-75,194.94444444444446,36,17,-78,0,717,1145,434,1
1,212,115,97,-361,-258,-103,285.38461538461536,26,0,-123,88,-755,-96,-193,1
1,411,228,183,-202,-231,29,256.5,8,25,-7,-5,197,121,-62,1
1,1201,97,1104,-209,-838,629,541.7083333333334,24,631,0,0,1102,876,-228,1
0,147,-226,373,-597,-574,-23,135.25581395348837,43,50,-314,-2,403,-191,-564,0
0,651,-652,1303,-205,-158,-47,323.775,40,44,-54,-1,1304,343,-960,0
0,406,483,-77,-370,-291,-79,68.8,5,1,-76,0,-60,63,140,1
0,634,-612,1246,-221,-101,-120,307.175,40,65,-44,-1,1250,303,-943,0
1,569,-558,1127,-206,-263,57,337.1212121212121,33,105,0,-6,1109,232,-895,0
0,779,189,590,-209,-465,256,187.6060606060606,33,280,0,-1,591,440,-150,1
0,231,241,-10,-328,-298,-30,36.0,2,4,-15,8,-12,-60,-50,1
0,1430,676,754,-260,-171,-89,272.32142857142856,28,31,-33,0,771,1063,309,1
1,998,542,456,-250,-287,37,374.75,12,49,-3,0,454,665,209,1
0,276,-302,578,-565,-562,-3,248.6086956521739,23,0,-46,-16,572,-83,-661,0
0,1278,273,1005,-266,-460,194,337.2758620689655,29,236,0,0,1014,940,-65,1
0,209,238,-29,-533,-528,-5,65.0,1,12,-2,0,-29,-123,-94,1
1,1507,1172,335,-175,-146,-29,137.43478260869566,23,0,-30,0,334,1189,854,1
1,524,474,50,-56,-97,41,49.75,4,90,0,-1,60,206,156,1
0,768,-783,1551,-215,-110,-105,345.2391304347826,46,99,-113,-2,1556,415,-1136,0
0,138,263,-125,-412,-441,29,75.0,11,108,-6,4,-132,-139,-14,1
1,870,576,294,-185,-262,77,279.0,11,75,-8,-24,288,518,224,1
1,2073,1864,209,-250,-257,7,205.8181818181818,11,30,0,-13,213,1741,1532,1
1,2046,1524,522,-204,-98,-106,62.75,4,21,-45,514,-106,1759,1237,1
0,1215,1210,5,-87,41,-128,66.5,20,19,-31,0,168,859,854,1
0,276,-259,535,-463,-424,-39,212.70833333333334,24,23,-34,0,524,-72,-607,0
0,274,-523,797,-478,-147,-331,263.03225806451616,31,0,-277,-1,795,-76,-873,0
0,1810,-236,2046,-349,-441,92,387.3207547169811,53,263,-10,0,2039,1515,-531,0
0,279,1697,-1418,-445,-166,-279,359.025,40,0,-283,0,-1431,19,1437,1
0,451,-471,922,-255,-184,-71,263.0,35,12,-39,0,925,112,-810,0
0,760,-867,1627,-189,-161,-28,321.46,50,83,-42,0,1629,447,-1180,0
0,104,-415,519,-278,-261,-17,254.5,20,14,-12,0,536,-203,-722,0
1,1366,666,700,-151,-216,65,240.93103448275863,29,100,0,-2,697,1060,360,1
0,2,216,-214,-715,-512,-203,61.333333333333336,6,0,-209,-240,13,-304,-90,0
0,1310,3,1307,-260,-708,448,272.4901960784314,51,471,0,-4,1327,995,-312,0
0,448,-309,757,-274,-373,99,264.7586206896552,29,98,-2,0,774,143,-614,0
1,211,-95,306,-440,-438,-2,252.66666666666666,12,4,0,0,306,-80,-386,0
1,724,-770,1494,-293,-286,-7,377.46153846153845,39,6,-14,-3,1484,421,-1073,0
0,8,-220,228,-618,-535,-83,132.33333333333334,15,0,-114,238,-178,-320,-548,0
1,831,-727,1558,-119,-386,267,547.4,30,263,-1,-4,1558,528,-1030,0
1,1488,1004,484,-220,-189,-31,212.08695652173913,23,19,-29,0,487,1163,679,1
1,392,-643,1035,-231,-248,17,373.82142857142856,28,68,-3,-3,1054,100,-935,0
1,1896,1017,879,-265,-268,3,269.84375,32,7,-1,0,881,1622,743,1
0,748,-410,1158,-262,-278,16,349.42424242424244,33,71,0,0,1165,475,-683,0
0,744,1351,-607,-356,-304,-52,320.77777777777777,18,0,-67,0,-610,420,1027,1
1,693,-809,1502,-257,-225,-32,347.3953488372093,43,26,-37,-8,1498,386,-1116,0
1,1185,535,650,-196,-300,104,392.8235294117647,17,106,-5,-3,649,876,226,1
0,16,-197,213,-720,-491,-229,147.71428571428572,28,5,-227,-200,205,-283,-496,0
0,226,-1013,1239,-262,-144,-118,351.97297297297297,37,20,-130,0,1304,-64,-1303,0
1,1526,1081,445,-170,-143,-27,201.0909090909091,22,3,-34,0,448,1237,792,1
0,22,238,-216,-734,-481,-253,142.3684210526316,19,0,-241,0,-212,-300,-84,1
1,1018,1215,-197,-180,-212,32,341.7037037037037,27,102,0,731,-183,679,876,1
1,729,-327,1056,-166,-318,152,355.2,30,153,0,-2,1062,451,-605,0
1,531,-1,532,-159,-194,35,339.75,16,55,0,1082,-2,270,-262,0
0,302,236,66,-499,-418,-81,116.23076923076923,13,0,-129,172,0,-10,-76,1
1,882,-295,1177,-139,-190,51,550.1818181818181,22,121,0,-8,1195,556,-621,0
0,623,-881,1504,-243,-150,-93,359.8333333333333,42,25,-93,0,1512,293,-1211,0
1,855,-416,1271,-158,-601,443,558.36,25,459,0,-9,1295,540,-731,0
1,2,29,-27,-471,-229,-242,306.5625,16,4,-317,470,-34,-304,-277,0
0,1210,4,1206,-123,-755,632,286.06382978723406,47,652,0,0,1208,871,-335,1
0,190,1718,-1528,-484,-162,-322,53.333333333333336,3,0,-344,-1556,12,-79,1449,1
0,870,1428,-558,-119,-159,40,211.59375,32,17,-5,0,-708,707,1265,1
1,417,162,255,-212,-592,380,301.35,20,427,0,0,575,98,-157,0
1,1430,-141,1571,-166,-223,57,315.04,50,60,-19,0,1571,1128,-443,0
1,794,-508,1302,-211,-307,96,383.29411764705884,34,103,-3,-8,1293,482,-820,0
0,1859,492,1367,-176,-166,-10,355.2368421052632,38,44,-17,0,1369,1542,175,1
0,293,-1258,1551,-247,-141,-106,511.3666666666667,30,25,-101,0,1560,-5,-1556,0
1,1101,690,411,-169,-115,-54,158.8,25,0,-54,0,411,791,380,1
0,764,860,-96,-225,-26,-199,183.46428571428572,28,75,-58,404,-100,430,526,1
0,1106,681,425,-198,-96,-102,190.54545454545453,22,0,-94,0,425,812,387,1
0,442,195,247,-82,-350,268,127.1,10,337,0,320,-21,139,-108,1
0,441,427,14,-239,-246,7,226.38095238095238,21,17,-3,477,-2,134,120,0
1,459,535,-76,-177,-44,-133,27.0,1,18,-65,-66,26,184,260,1
1,721,-487,1208,-159,-257,98,520.25,24,152,-3,-2,1211,438,-770,0
0,930,30,900,-214,-627,413,173.94915254237287,59,522,0,-19,918,647,-253,1
0,1090,1176,-86,-380,39,-419,56.473684210526315,19,73,-52,-107,82,819,905,1
0,1406,1447,-41,-388,15,-403,123.76595744680851,47,124,-37,471,-115,1095,1136,1
0,1159,619,540,-145,-93,-52,193.2962962962963,27,44,-10,0,541,879,339,1
0,932,-1446,2378,-189,-136,-53,478.88,50,102,-55,-2,2397,662,-1716,0
0,795,1497,-702,-81,-61,-20,204.85294117647058,34,17,-20,2,-714,484,1186,1
0,1137,198,939,-182,-522,340,247.35,40,344,-2,0,949,861,-78,1
1,834,-431,1265,-172,-292,120,536.8333333333334,24,124,-2,0,1265,523,-742,0
0,245,-191,436,-225,-366,141,305.0,16,218,0,0,438,-20,-456,0
0,2007,465,1542,-242,-88,-154,325.3829787234043,47,20,-48,0,1549,1738,196,1
0,1554,1171,383,-291,-215,-76,150.54166666666666,24,0,-77,0,377,1244,861,1
1,1187,558,629,-167,-201,34,583.2758620689655,29,77,-60,2288,0,880,251,0
0,226,-204,430,-521,-511,-10,157.77777777777777,27,61,-6,0,441,-60,-490,0
0,15,1429,-1414,-391,-164,-227,422.3333333333333,33,0,-228,0,-1412,-280,1134,1
1,895,-403,1298,-175,-280,105,578.1304347826087,23,135,0,-6,1298,560,-738,0
0,1337,288,1049,-300,-585,285,291.7837837837838,37,293,0,0,1050,1039,-10,1
0,1574,222,1352,-237,-516,279,358.5,44,328,-8,-4,1554,1257,-95,1
0,485,331,154,-204,-298,94,115.16666666666667,12,94,-8,-13,154,168,14,1
0,939,1218,-279,-59,-71,12,164.2941176470588,17,10,-4,6,-286,644,923,1
0,429,-846,1275,-248,-50,-198,413.8333333333333,30,8,-107,0,1266,132,-1143,0
1,1640,830,810,-182,-298,116,386.85714285714283,21,121,-19,0,815,1342,532,1
1,8,157,-149,-493,-252,-241,246.36363636363637,11,0,-272,-415,5,-295,-146,1
1,518,-232,750,-228,-212,-16,380.75,20,57,0,-1,749,210,-540,0
1,893,-199,1092,-240,-736,496,488.76,25,521,0,-1,1094,580,-512,0
0,811,843,-32,-219,-198,-21,288.08,25,45,-2,-32,734,503,535,1
0,844,-602,1446,-189,-90,-99,322.1333333333333,45,108,-34,0,1440,557,-889,0
0,502,-702,1204,-184,-105,-79,319.0263157894737,38,30,-82,0,1204,204,-1000,0
0,22,-205,227,-594,-511,-83,88.04,25,0,-131,-30,252,-280,-507,0
0,1058,-760,1818,-167,-172,5,412.65909090909093,44,100,0,0,1818,785,-1033,0
1,1831,1007,824,-236,-248,12,230.51351351351352,37,129,-1,0,824,1532,708,1
1,560,-139,699,-257,-286,29,394.3888888888889,18,28,0,0,697,236,-463,0
1,1085,-342,1427,-211,-312,101,517.75,28,120,0,-7,1420,761,-666,0
0,712,-54,766,-307,-456,149,373.21875,32,163,-2,-1,1174,403,-363,0
1,700,-428,1128,-232,-250,18,540.2857142857143,21,29,-2,0,1126,372,-756,0
0,28,-568,596,-304,-163,-141,259.2173913043478,23,0,-138,0,596,-278,-874,0
1,496,513,-17,-176,-156,-20,87.0,3,0,-23,11,-14,222,239,1
0,450,399,51,-214,-219,5,202.3913043478261,23,50,0,0,477,138,87,0
0,725,483,242,-161,-197,36,144.66666666666666,18,60,-7,0,268,427,185,1
0,1497,523,974,-189,-78,-111,291.1818181818182,33,45,-22,0,991,1196,222,1
0,1196,238,958,-276,-394,118,278.3333333333333,39,225,0,0,1057,862,-96,1
1,1031,-135,1166,-225,-288,63,513.4347826086956,23,74,0,-4,1168,677,-489,0
1,1223,219,1004,-287,-516,229,276.3157894736842,38,230,-5,0,1050,909,-95,1
0,852,-930,1782,-209,-150,-59,374.8936170212766,47,73,-66,0,1778,564,-1218,0
0,1447,523,924,-211,-82,-129,260.43243243243245,37,66,-63,0,959,1120,196,1
0,774,451,323,-45,-101,56,136.41666666666666,24,135,-1,-2,323,491,168,1
0,237,122,115,-462,-228,-234,148.0,10,0,-229,0,121,-73,-188,1
1,777,728,49,-70,363,-433,195.33333333333334,3,0,-68,-2,39,450,401,1
0,972,-652,1624,-188,-73,-115,402.9756097560976,41,109,0,0,1654,603,-1021,0
1,1093,1176,-83,-207,-98,-109,125.0,7,4,-24,3,-85,733,816,1
0,1178,278,900,-353,-439,86,77.52941176470588,17,172,-11,1066,0,818,-82,1
0,322,-281,603,-569,-463,-106,235.30769230769232,26,38,-27,-4,621,-11,-614,0
0,260,-1521,1781,-267,-91,-176,396.5111111111111,45,7,-103,0,1812,-74,-1855,0
1,511,494,17,-60,-77,17,12.0,1,42,-11,-4,33,195,178,1
0,261,484,-223,249,-155,404,147.84615384615384,13,0,-63,0,-224,-20,203,1
0,46,-80,126,-261,-192,-69,127.81818181818181,11,0,-75,0,130,-242,-368,0
0,741,-1299,2040,-252,-176,-76,355.29824561403507,57,46,-80,-2,2040,431,-1609,0
1,944,404,540,-203,-240,37,190.57142857142858,28,38,-2,-5,537,624,84,1
0,107,253,-146,-546,-579,33,107.46666666666667,15,9,-20,0,-171,-239,-93,1
1,851,-376,1227,-270,-303,33,502.8,25,40,0,-10,1237,558,-669,0
1,785,-317,1102,-217,-280,63,465.5416666666667,24,66,-3,-9,1102,489,-613,0
0,889,455,434,-105,-122,17,239.91304347826087,23,132,-1,0,536,555,121,1
0,869,-409,1278,-168,-162,-6,306.64285714285717,42,71,-6,0,1295,477,-801,0
1,272,-198,470,-481,-615,134,418.6666666666667,12,134,-2,-2,469,-94,-564,0
0,1769,502,1267,-220,-197,-23,336.97297297297297,37,17,-28,0,1266,1403,136,1
1,1003,209,794,-186,-132,-54,465.0625,16,60,0,0,750,688,-106,1
0,964,545,419,-198,-155,-43,135.46428571428572,28,0,-46,-4,416,673,254,1
1,1746,1362,384,-228,-97,-131,325.8333333333333,12,4,-1,0,389,1457,1073,1
0,1113,962,151,-117,-125,8,72.05555555555556,18,21,0,0,149,816,665,1
0,772,-1346,2118,-192,-81,-111,307.42028985507244,69,101,-40,-4,2124,409,-1709,0
0,964,-1274,2238,-191,-152,-39,349.671875,64,114,-39,0,2243,613,-1625,0
0,1309,1639,-330,-140,-79,-61,149.5,20,30,0,7,-326,959,1289,1
1,12,172,-160,-389,-273,-116,200.4,25,8,-213,0,-480,-296,-136,1
1,2054,1340,714,-275,-122,-153,353.23809523809524,21,9,-42,-8,730,1764,1050,1
1,1425,1237,188,-110,-71,-39,171.0,11,44,0,-11,179,1055,867,1
1,1745,1270,475,-255,-187,-68,327.4,15,14,-24,-6,475,1464,989,1
0,365,503,-138,-263,-154,-109,143.36363636363637,11,0,-109,0,-149,55,193,1
1,430,144,286,-213,-302,89,322.55555555555554,9,89,-6,-3,287,141,-145,1
0,1322,361,961,-162,-230,68,198.61702127659575,47,79,0,0,954,1045,84,1
0,1926,2122,-196,-113,-68,-45,108.26785714285714,112,164,0,600,-174,1588,1784,1
0,293,284,9,-475,-387,-88,84.5,38,35,-176,-13,362,-101,-110,0
0,1162,1217,-55,-66,12,-78,213.04761904761904,42,329,-9,776,-128,824,879,1
0,495,743,-248,-82,75,-157,152.53333333333333,15,18,-13,0,-248,168,416,1
1,946,114,832,-147,-728,581,390.65384615384613,26,585,0,-12,834,633,-199,1
1,1898,1395,503,-338,-248,-90,211.33333333333334,24,2,-81,-3,508,1545,1042,1
1,599,-821,1420,-221,-361,140,314.4222222222222,45,146,0,0,1416,301,-1119,0
1,1485,1001,484,-136,-93,-43,234.5,22,33,0,0,523,1179,695,1
1,1995,1345,650,-271,-197,-74,228.07142857142858,28,3,-62,0,650,1637,987,1
0,439,-635,1074,-261,-239,-22,315.44117647058823,34,21,-20,0,1076,118,-956,0
0,547,-23,570,-162,-458,296,81.5,2,315,-9,584,-13,279,-291,0
1,464,431,33,-89,-121,32,4.0,1,43,-17,-10,15,165,132,1
1,1556,671,885,-253,-192,-61,295.93333333333334,30,0,-58,-1,890,1206,321,1
0,949,448,501,-285,-253,-32,3.0,2,0,-47,520,0,648,147,1
0,1,224,-223,-791,-555,-236,142.28571428571428,21,0,-234,2,-247,-288,-65,0
1,1519,646,873,-206,-160,-46,332.9230769230769,26,0,-51,0,871,1234,361,1
1,1155,645,510,-172,-257,85,149.52941176470588,34,83,0,0,507,848,338,1
0,453,1520,-1067,-287,-134,-153,420.96,25,2,-150,0,-1072,121,1188,1
1,469,466,3,-251,-257,6,5.2,5,9,-11,-14,25,170,167,1
1,1066,121,945,-175,-768,593,348.71875,32,591,-1,-1,951,738,-207,1
0,640,-754,1394,-206,-115,-91,326.23809523809524,42,78,-18,-2,1372,355,-1039,0
1,1577,1184,393,-216,-149,-67,271.5,14,0,-24,0,389,1276,883,1
1,184,-199,383,-539,-456,-83,232.44444444444446,18,32,-7,-27,398,-118,-501,0
0,210,233,-23,-307,-376,69,75.85714285714286,7,84,-86,51,-48,-114,-91,1
1,1768,1348,420,-264,-217,-47,149.92592592592592,27,0,-47,0,423,1435,1015,1
0,144,553,-409,-259,-215,-44,284.42857142857144,14,0,-54,0,-429,-181,228,1
1,796,582,214,-195,-221,26,222.9,10,94,-5,-2,199,500,286,1
1,648,-933,1581,-169,-111,-58,376.9047619047619,42,73,-57,0,1575,315,-1266,0
1,228,332,-104,-617,-557,-60,59.0,14,0,-51,0,-120,-75,29,1
1,2099,1482,617,-172,-187,15,285.90909090909093,22,16,-18,0,620,1799,1182,1
0,971,1102,-131,-185,-178,-7,58.23529411764706,17,11,-2,0,-126,629,760,1
1,781,-1389,2170,-230,-70,-160,425.11764705882354,51,33,-130,-7,2160,471,-1699,0
0,943,224,719,-242,-440,198,357.3181818181818,22,213,0,0,780,660,-59,1
0,572,-696,1268,-220,-209,-11,270.69565217391306,46,55,-22,0,1274,256,-1012,0
0,441,213,228,-233,-439,206,178.35294117647058,17,215,-4,-8,260,143,-85,1
0,527,660,-133,-174,-148,-26,116.0909090909091,11,3,-35,3,-138,180,313,1
1,1367,816,551,-331,-247,-84,189.75862068965517,29,0,-83,-2,551,1038,487,1
0,489,836,-347,-249,-174,-75,269.90909090909093,22,28,-62,245,-361,150,497,1
0,230,-204,434,-599,-505,-94,190.14285714285714,21,3,-51,-1,415,-70,-504,0
1,1848,908,940,-215,-246,31,217.62790697674419,43,57,0,-7,939,1536,596,1
1,821,501,320,-384,-334,-50,354.7,10,0,-188,-20,323,465,145,1
1,1302,143,1159,-239,-585,346,19.0,1,340,-11,1159,-20,963,-196,1
1,170,-36,206,-589,-584,-5,283.42857142857144,7,8,0,0,202,-125,-331,0
1,463,496,-33,-227,-273,46,187.25,12,69,0,-38,223,173,206,1
1,1794,1261,533,-139,-189,50,235.77272727272728,22,54,0,0,535,1483,950,1
0,85,218,-133,-499,-507,8,83.3125,16,69,0,0,-169,-247,-114,1
1,1447,1063,384,332,206,126,228.7058823529412,17,40,0,-6,385,1138,754,1
0,186,-227,413,-45,-75,30,146.93103448275863,29,18,-58,0,428,-123,-536,0
1,609,183,426,-261,-383,122,148.875,8,123,-6,530,-2,217,-209,1
1,2009,1146,863,-226,-192,-34,276.5806451612903,31,12,-26,0,864,1730,867,1
1,1328,827,501,-210,-196,-14,215.30434782608697,23,35,-7,0,498,1005,504,1
0,1946,1374,572,-213,-190,-23,264.3809523809524,21,29,-28,0,576,1617,1045,1
1,995,-283,1278,-213,-300,87,510.72,25,89,-17,0,1276,678,-600,0
1,1179,1014,165,-135,-116,-19,202.11111111111111,18,35,-19,-1,367,854,689,1
1,510,349,161,-140,-231,91,239.55555555555554,18,85,-12,596,-6,158,-3,0
0,1646,-1983,3629,-32,24,-56,454.95061728395063,81,282,-10,-4,3650,1332,-2297,0
0,999,1365,-366,-88,-53,-35,59.0,7,37,-3,-349,86,685,1051,1
1,1230,6,1224,-288,-585,297,376.0857142857143,35,297,-1,-2,1298,881,-343,0
0,1451,1316,135,454,66,388,107.75,12,8,-6,-5,133,1107,972,1
0,2014,2019,-5,461,97,364,70.4375,16,28,-24,132,-6,1625,1630,1
0,470,551,-81,343,-31,374,52.2,10,57,-12,-185,5,126,207,1
0,282,256,26,-17,-154,137,71.63636363636364,22,7,-142,185,-4,-81,-107,1
0,1986,1962,24,448,282,166,48.2,10,66,-5,132,0,1623,1599,1
1,811,-459,1270,-192,-407,215,411.030303030303,33,249,-1,0,1330,522,-748,0
0,476,-531,1007,-86,-186,100,254.56410256410257,39,157,-5,-1,1016,176,-831,0
1,789,-346,1135,-224,-268,44,505.9130434782609,23,56,0,0,1153,468,-667,0
1,2152,748,1404,-184,-218,34,433.77142857142854,35,116,-6,-105,1406,1809,405,1
1,1463,1188,275,-229,-196,-33,215.30769230769232,13,0,-34,0,277,1126,851,1
0,1959,1269,690,-148,-171,23,227.06666666666666,30,66,0,0,698,1631,941,1
1,858,-127,985,-256,-712,456,544.3809523809524,21,492,-19,-2,1009,526,-459,0
0,482,-625,1107,-223,-164,-59,282.6666666666667,39,69,-49,0,1107,195,-912,0
0,1091,604,487,-192,-150,-42,199.25,24,1,-72,0,486,779,292,1
1,844,250,594,-230,-312,82,400.25,16,86,0,-12,608,554,-40,1
0,1536,942,594,-303,-233,-70,175.27272727272728,33,0,-71,0,595,1242,648,1
0,1388,267,1121,-300,-371,71,331.1764705882353,34,154,0,0,1145,1068,-53,1
1,580,301,279,-181,-362,181,256.25,24,179,0,-1,623,279,0,0
0,138,184,-46,-568,-650,82,117.33333333333333,3,131,-149,-24,35,-370,-324,1
0,776,771,5,-212,-217,5,83.26923076923077,26,127,0,-11,209,462,457,1
0,205,1861,-1656,-498,-166,-332,339.8979591836735,49,0,-324,0,-1656,-109,1547,1
0,616,-433,1049,-245,-203,-42,267.2307692307692,39,16,-40,-7,1056,233,-816,0
1,622,-681,1303,-222,-27,-195,124.4,5,16,-29,1328,0,318,-985,0
1,809,350,459,-241,-321,80,337.38461538461536,13,75,0,-10,462,473,14,1
0,429,-623,1052,-210,-164,-46,202.88709677419354,62,44,-51,-1,1088,93,-959,0
0,1103,1148,-45,-69,-74,5,89.52173913043478,23,155,-3,132,-52,777,822,1
0,534,407,127,-145,-92,-53,92.6,15,0,-58,-10,142,416,289,1
0,650,522,128,-189,-149,-40,55.8421052631579,19,1,-40,-2,144,532,404,1
0,157,1108,-951,-500,-136,-364,253.075,40,0,-379,1,-949,-146,805,1
1,524,374,150,-184,-221,37,244.14285714285714,7,33,0,-2,161,301,151,1
1,1174,415,759,-222,-343,121,463.3529411764706,17,115,-1,-8,761,930,171,1
0,507,-876,1383,-264,-91,-173,378.2432432432432,37,11,-86,0,1417,184,-1199,0
0,184,-212,396,-517,-122,-395,187.65217391304347,23,15,-41,-2,431,-187,-583,0
1,1173,551,622,-181,-259,78,432.4,15,78,-9,0,629,974,352,1
1,564,-474,1038,-200,-216,16,325.54545454545456,33,63,-1,-34,1042,287,-751,0
0,257,-1344,1601,-288,-160,-128,314.52,50,33,-136,0,1608,-50,-1651,0
0,221,631,-410,-362,-268,-94,135.1,30,3,-111,3,-417,-61,349,1
0,12,-1280,1292,-628,-101,-527,299.5869565217391,46,0,-528,0,1295,-359,-1651,0
1,802,-676,1478,-198,-314,116,512.6896551724138,29,102,0,-2,1484,447,-1031,0
0,206,107,99,-468,-121,-347,222.11111111111111,9,0,-245,0,110,-93,-192,1
1,593,-264,857,-153,-251,98,308.3235294117647,34,79,-2,-6,1062,271,-586,0
0,526,805,-279,-85,-96,11,129.8695652173913,23,73,0,12,-310,222,501,1
1,224,1265,-1041,-534,-547,13,404.03846153846155,26,13,-7,6,-1038,-37,1004,1
0,591,-695,1286,-294,-83,-211,305.27906976744185,43,81,-72,0,1316,210,-1076,0
0,1870,1947,-77,-208,-162,-46,62.714285714285715,14,58,0,2,-116,1586,1663,1
0,447,-368,815,-238,-300,62,12.0,1,70,0,807,0,151,-664,0
0,233,199,34,-569,-534,-35,115.60714285714286,28,18,-237,134,-2,-54,-88,1
1,1040,746,294,-166,-293,127,334.6,10,147,0,0,297,727,433,1
0,219,-185,404,-433,-515,82,135.6,30,110,-1,0,409,-144,-548,0
0,611,-601,1212,-230,-229,-1,296.1904761904762,42,58,-13,0,1245,310,-902,0
0,251,220,31,-499,-466,-33,126.22222222222223,18,2,-223,190,0,-36,-67,1
0,824,185,639,-576,-559,-17,343.55,20,10,-63,0,718,478,-161,1
1,1195,499,696,-261,-331,70,452.0,16,73,0,-1,708,880,184,1
0,233,-278,511,-539,-529,-10,189.69230769230768,26,43,-14,-3,515,-99,-610,0
1,1077,1050,27,-79,-75,-4,63.166666666666664,12,21,-4,125,-10,759,732,1
0,1459,-38,1497,-216,-745,529,383.0975609756098,41,552,0,0,1511,1150,-347,0
1,912,470,442,-185,-212,27,41.0,1,98,0,417,-19,610,168,1
1,739,-450,1189,-341,-232,-109,331.5090909090909,55,0,-205,-3,1835,446,-743,0
1,120,207,-87,-328,-552,224,270.0,14,308,0,-65,359,-208,-121,0
0,774,1510,-736,-195,-36,-159,61.625,8,2,-96,-736,0,470,1206,1
0,1194,185,1009,-286,-392,106,318.5,38,233,0,0,1168,890,-119,1
0,420,-744,1164,-223,-85,-138,291.6363636363636,44,212,-26,0,1223,116,-1048,0
1,81,-1144,1225,-288,-143,-145,358.29411764705884,34,5,-61,0,1244,-216,-1441,0
1,426,-53,479,-271,-654,383,466.9166666666667,24,413,-56,-520,485,107,-372,0
0,209,-272,481,-528,-485,-43,191.63636363636363,22,1,-58,-9,478,-111,-592,0
0,1583,38,1545,-189,-671,482,16.0,1,556,0,1573,-5,1213,-332,0
1,1097,605,492,-229,-367,138,301.6212121212121,66,146,0,0,1987,782,290,0
0,50,748,-698,-311,-214,-97,265.0,25,0,-85,0,-702,-280,418,1
1,2035,958,1077,-276,-165,-111,298.54285714285714,35,3,-44,0,1062,1740,663,1
1,1232,702,530,-255,-347,92,405.7692307692308,13,97,-14,0,531,917,387,1
0,214,-263,477,-559,-502,-57,106.11627906976744,43,2,-81,-2,504,-113,-590,0
1,1638,927,711,-232,-165,-67,222.1290322580645,31,36,-23,0,707,1330,619,1
0,85,221,-136,-467,-452,-15,12.0,1,35,-5,-161,1,-210,-74,1
0,549,728,-179,-258,-39,-219,127.15,20,0,-211,0,-181,229,408,1
0,580,-477,1057,-215,-121,-94,17.75,4,30,-69,1211,-5,243,-814,0
1,534,772,-238,-215,-216,1,173.3793103448276,29,70,-5,258,-236,167,405,1
1,998,740,258,-230,-317,87,357.90909090909093,22,82,-2,0,785,671,413,1
1,1382,930,452,-219,-199,-20,192.30434782608697,23,0,-19,0,452,1068,616,1
1,1504,1377,127,-358,-316,-42,180.0,7,15,-28,0,132,1231,1104,1
1,590,-481,1071,-187,-193,6,303.1142857142857,35,27,-10,-5,1065,282,-789,0
1,693,223,470,-137,-413,276,264.9047619047619,21,274,-1,-13,474,432,-38,1
1,518,827,-309,-200,-122,-78,120.75,24,42,-22,9,-291,156,465,1
1,470,-695,1165,-213,-199,-14,297.3333333333333,39,75,-11,-2,1161,168,-997,0
0,17,444,-427,-386,-90,-296,44.0,2,0,-297,-450,0,-276,151,1
0,1023,1482,-459,-204,-189,-15,187.91666666666666,24,12,-18,0,-461,705,1164,1
1,4,302,-298,-795,-793,-2,303.4,10,5,-3,10,-294,-307,-9,0
0,170,-642,812,-509,-229,-280,251.06060606060606,33,0,-276,0,816,-92,-904,0
1,200,-385,585,-479,-259,-220,451.93333333333334,15,0,-220,0,584,-59,-644,0
