shiftSinceLineset,motionSinceLineset,snap_motion_gap,init_rel_y_dis,end_rel_y_dis,overall_y_change,init_rel_x_dis,end_rel_x_dis,overall_x_change,motion_s_avg,frames_in_motion,y_reverse_loc,y_reverse_bool
0,1,24,173,-1396,1569,-182,-107,-75,337.0217391304348,46,-1397.0,0
0,1,0,983,201,782,-244,-649,405,346.2142857142857,42,984.0,1
0,1,0,2,-320,322,-475,-256,-219,234.44117647058823,34,-532.0,1
0,1,43,554,613,-59,-221,-146,-75,142.2,5,614.0,0
0,1,0,556,-344,900,-195,-275,80,412.72727272727275,22,-344.0,0
0,1,0,1082,582,500,-151,-117,-34,242.21052631578948,19,582.0,0
1,1,43,12,-469,481,-264,-116,-148,221.6086956521739,23,-481.0,0
0,1,0,1042,419,623,-98,-331,233,390.1875,16,1009.0,1
1,1,56,1021,529,492,-260,-210,-50,138.11111111111111,36,522.0,0
0,1,0,1243,828,415,-195,-202,7,265.4375,16,1246.0,1
0,1,41,41,-1463,1504,-897,-208,-689,307.71153846153845,52,42.0,1
0,1,0,1327,924,403,-229,-303,74,321.84615384615387,13,1325.0,1
0,1,36,1552,-213,1765,-121,-541,420,368.48,50,-214.0,0
0,1,0,929,391,538,-242,-354,112,380.46666666666664,15,938.0,1
0,1,0,558,506,52,-181,-169,-12,166.66666666666666,3,558.0,0
0,1,0,1478,932,546,-162,-167,5,183.41379310344828,29,932.0,0
0,1,0,835,-559,1394,-184,-231,47,358.0,39,835.0,1
0,1,0,653,-212,865,-217,-250,33,431.75,20,655.0,1
1,1,37,814,1115,-301,-152,-149,-3,109.0,44,813.0,1
1,1,11,1217,-1732,2949,-130,-163,33,456.9230769230769,65,1216.0,1
1,1,32,242,-302,544,-502,-482,-20,100.83928571428571,56,-301.0,0
0,1,0,971,-176,1147,-182,-646,464,488.7692307692308,26,972.0,1
0,1,30,684,212,472,-348,-480,132,255.05263157894737,19,199.0,0
0,1,47,355,433,-78,-188,-95,-93,126.0,11,464.0,0
0,1,0,1199,359,840,-227,-361,134,480.8888888888889,18,1199.0,1
0,1,0,697,315,382,-203,-264,61,367.5,36,698.0,1
1,1,91,1934,875,1059,-28,-77,49,226.7391304347826,46,1931.0,1
1,1,97,824,1426,-602,-139,-75,-64,120.83333333333333,48,822.0,1
0,1,97,588,828,-240,-70,-38,-32,118.59322033898304,59,408.0,1
1,1,95,256,374,-118,-454,-450,-4,81.11111111111111,18,258.0,1
1,1,89,1238,1924,-686,-65,12,-77,184.13888888888889,36,1238.0,1
0,1,46,342,-440,782,-214,-154,-60,275.8965517241379,29,-450.0,0
0,1,0,766,398,368,-213,-293,80,358.6363636363636,11,758.0,1
0,1,28,307,1491,-1184,-744,-236,-508,333.3421052631579,38,1492.0,0
0,1,0,230,24,206,-538,-603,65,274.125,8,230.0,1
0,1,0,690,422,268,-54,-149,95,315.55555555555554,9,687.0,1
0,1,29,1067,1509,-442,-191,-62,-129,178.4,25,1507.0,0
0,1,11,216,581,-365,-392,-191,-201,179.11111111111111,27,199.0,1
0,1,39,857,464,393,-192,-164,-28,110.26470588235294,34,469.0,0
0,1,0,607,586,21,-141,-132,-9,47.5,4,586.0,0
0,1,15,222,-289,511,-539,-483,-56,186.66666666666666,27,223.0,1
0,1,0,984,552,432,-264,-394,130,257.0,18,986.0,1
0,1,48,449,528,-79,-205,-170,-35,106.5,8,533.0,0
1,1,62,793,1459,-666,-146,-92,-54,202.75,32,1464.0,0
1,1,56,1170,1313,-143,-213,-213,0,70.05882352941177,17,1169.0,1
0,1,23,1573,68,1505,-73,-175,102,288.4166666666667,60,165.0,0
0,1,0,465,401,64,-248,-244,-4,154.0,4,401.0,0
0,1,0,499,446,53,-245,-221,-24,108.0,3,487.0,0
0,1,46,163,-270,433,-509,-457,-52,170.43333333333334,30,192.0,1
0,1,0,468,125,343,-234,-255,21,349.9,10,470.0,1
0,1,11,564,-1540,2104,-212,-95,-117,318.03076923076924,65,-1540.0,0
0,1,0,219,-128,347,-610,-616,6,306.8181818181818,11,204.0,1
0,1,0,718,365,353,-200,-312,112,396.4,10,719.0,1
0,1,0,990,457,533,-229,-287,58,366.6,15,991.0,1
0,1,0,447,441,6,-135,-126,-9,2.0,1,449.0,0
0,1,2,547,547,0,-204,-209,5,4.0,1,545.0,0
0,1,0,746,-525,1271,-229,-214,-15,397.1875,32,746.0,1
0,1,0,436,207,229,-255,-257,2,307.0,8,438.0,1
0,1,0,484,-524,1008,-275,-250,-25,484.76190476190476,21,485.0,1
0,1,0,12,91,-79,-465,-458,-7,107.71428571428571,7,12.0,0
0,1,0,1511,931,580,-214,-193,-21,260.40909090909093,22,1511.0,1
0,1,1,1531,865,666,-174,-210,36,227.20689655172413,29,1533.0,1
0,1,0,850,415,435,-185,-294,109,390.5,12,847.0,1
0,1,0,509,543,-34,-126,-114,-12,24.571428571428573,7,510.0,0
0,1,0,198,-199,397,-585,-520,-65,351.5,12,200.0,1
0,1,0,1529,900,629,-145,-132,-13,273.2608695652174,23,1526.0,1
1,1,12,1104,-1461,2565,-180,-60,-120,340.9342105263158,76,1101.0,1
1,1,42,739,976,-237,-157,-153,-4,126.11111111111111,18,738.0,1
1,1,18,518,257,261,-122,-391,269,103.36111111111111,36,519.0,1
1,1,42,223,-203,426,-512,-497,-15,149.06666666666666,30,224.0,1
0,1,0,929,1040,-111,-174,-233,59,373.44444444444446,54,-16.0,1
0,1,0,435,-677,1112,-225,-251,26,291.0263157894737,38,426.0,1
0,1,0,1527,356,1171,-167,-275,108,520.6521739130435,23,1526.0,1
1,1,0,997,613,384,-256,-247,-9,232.0,21,1053.0,1
1,1,2,513,483,30,-114,35,-149,51.8421052631579,19,429.0,0
0,1,0,601,-538,1139,-199,-139,-60,298.7631578947368,38,598.0,1
0,1,0,921,484,437,-226,-360,134,390.5833333333333,12,918.0,1
0,1,0,438,-587,1025,-229,-241,12,282.18918918918916,37,431.0,1
0,1,0,839,-233,1072,-196,-316,120,521.1428571428571,21,840.0,1
0,1,44,1026,-5,1031,-105,-466,361,327.0285714285714,35,1028.0,1
0,1,0,894,610,284,-232,-329,97,275.3333333333333,12,897.0,1
1,1,70,446,-427,873,-101,-96,-5,244.0810810810811,37,446.0,1
1,1,78,535,-562,1097,-189,-135,-54,231.72916666666666,48,-565.0,0
0,1,0,941,67,874,-154,-245,91,381.60655737704917,61,940.0,1
0,1,0,272,-726,998,-490,-716,226,466.95454545454544,22,273.0,1
1,1,46,529,-248,777,-200,-528,328,189.75555555555556,45,-232.0,0
1,1,51,1250,468,782,-161,-140,-21,232.08333333333334,36,435.0,0
0,1,0,1276,196,1080,-216,-472,256,467.5,24,1271.0,1
0,1,81,108,238,-130,-652,-481,-171,148.41666666666666,12,233.0,0
0,1,0,415,-455,870,-190,-167,-23,173.8235294117647,51,414.0,1
0,1,10,1203,-470,1673,-204,-228,24,306.09090909090907,55,1180.0,1
0,1,105,864,-420,1284,-208,-229,21,345.7837837837838,37,-430.0,0
0,1,0,766,374,392,-162,-315,153,360.1666666666667,12,767.0,1
0,1,44,575,-933,1508,-232,-70,-162,366.95,40,-935.0,0
0,1,39,943,-498,1441,-215,-188,-27,371.43589743589746,39,945.0,1
0,1,27,509,-448,957,-232,-152,-80,288.11764705882354,34,-451.0,0
0,1,0,987,-20,1007,-160,-296,136,493.0,21,990.0,1
0,1,0,445,-286,731,-151,-133,-18,302.4166666666667,24,-286.0,0
0,1,0,947,-178,1125,-180,-261,81,475.6666666666667,24,945.0,1
0,1,36,1609,-1199,2808,-142,-66,-76,440.625,64,-1216.0,0
0,1,0,873,274,599,-96,-328,232,434.4,15,876.0,1
0,1,24,1036,241,795,-274,-621,347,207.16666666666666,42,235.0,0
0,1,19,1691,-1541,3232,-107,-104,-3,439.35616438356163,73,1697.0,1
0,1,0,824,-471,1295,-215,-179,-36,342.0217391304348,46,-616.0,1
0,1,0,620,-377,997,-233,-268,35,324.1,30,-378.0,0
0,1,0,769,-194,963,-141,-367,226,488.04761904761904,21,770.0,1
0,1,35,807,471,336,-222,-255,33,125.06896551724138,29,824.0,1
0,1,49,32,218,-186,-789,-416,-373,136.4,25,31.0,1
0,1,0,236,-571,807,-441,-45,-396,239.0185185185185,54,235.0,1
1,1,69,676,282,394,-56,0,-56,108.0,35,677.0,1
0,1,0,919,-288,1207,-189,-209,20,478.2,25,912.0,1
0,1,62,442,-245,687,-149,-374,225,257.0,29,-253.0,0
0,1,36,882,-378,1260,-231,-241,10,327.05128205128204,39,883.0,1
0,1,0,857,-136,993,-137,-314,177,471.90909090909093,22,859.0,1
0,1,35,894,-243,1137,-113,-382,269,323.94594594594594,37,895.0,1
0,1,29,456,-474,930,-242,-80,-162,273.88235294117646,34,456.0,1
0,1,57,7,609,-602,-467,-207,-260,241.75,28,628.0,0
0,1,0,1232,538,694,-62,-314,252,389.42105263157896,19,1248.0,1
1,1,59,625,7,618,-200,-737,537,221.91666666666666,36,-2.0,0
0,1,8,1257,-10,1267,-179,-452,273,225.53333333333333,60,457.0,1
1,1,96,569,0,569,-149,-776,627,214.925,40,-22.0,0
0,1,28,1244,-456,1700,-163,-106,-57,240.81690140845072,71,-467.0,0
0,1,13,1185,-1075,2260,-238,-201,-37,408.3454545454546,55,1188.0,1
0,1,35,50,215,-165,-817,-496,-321,218.26666666666668,15,210.0,0
0,1,0,502,280,222,-230,-236,6,289.8181818181818,33,503.0,1
1,1,72,424,-425,849,-111,-107,-4,266.79411764705884,34,-429.0,0
0,1,2,888,428,460,-133,-234,101,133.65714285714284,35,887.0,1
1,1,63,545,-568,1113,-218,-183,-35,262.5581395348837,43,-568.0,0
0,1,41,223,-489,712,-433,-125,-308,255.67741935483872,31,224.0,1
0,1,60,905,-359,1264,-198,-242,44,315.775,40,907.0,1
0,1,0,803,217,586,-168,-337,169,396.375,16,803.0,1
0,1,0,1101,148,953,-192,-527,335,469.8636363636364,22,1104.0,1
0,1,0,732,-477,1209,-271,-273,2,381.75,32,733.0,1
0,1,0,962,-542,1504,-164,-336,172,514.2333333333333,30,966.0,1
1,1,25,37,971,-934,-142,-204,62,292.84375,32,967.0,0
1,1,7,640,457,183,-61,-71,10,96.84210526315789,19,448.0,0
1,1,20,566,-207,773,-282,-486,204,272.7741935483871,31,-240.0,0
0,1,18,229,2413,-2184,-503,-241,-262,455.7959183673469,49,230.0,1
0,1,0,926,-500,1426,-271,-246,-25,449.1875,32,927.0,1
0,1,0,365,-468,833,-220,-237,17,412.2,20,-468.0,0
0,1,0,609,-273,882,-130,-266,136,344.5,58,-818.0,1
0,1,36,7,18,-11,-723,-766,43,100.16666666666667,6,8.0,0
0,1,0,874,749,125,-254,-251,-3,158.625,8,873.0,1
0,1,53,10,3,7,-720,-747,27,145.66666666666666,6,9.0,0
0,1,0,1317,846,471,-249,-222,-27,318.46666666666664,15,1319.0,1
0,1,0,589,-391,980,-201,-208,7,396.24,25,-391.0,0
0,1,13,225,-287,512,-534,-539,5,160.36363636363637,33,-287.0,0
0,1,71,21,19,2,-824,-803,-21,78.125,8,20.0,0
0,1,33,916,1007,-91,-126,-127,1,113.92307692307692,13,920.0,0
0,1,39,174,-209,383,-473,-476,3,134.7,40,174.0,1
0,1,0,458,355,103,-215,-221,6,288.9166666666667,36,459.0,1
0,1,0,706,-504,1210,-229,-232,3,416.2413793103448,29,-504.0,0
1,1,38,823,1442,-619,-106,-100,-6,145.11627906976744,43,1457.0,0
1,1,20,1070,1910,-840,-84,-47,-37,198.6046511627907,43,1046.0,1
1,1,23,481,954,-473,-226,-154,-72,120.71052631578948,38,921.0,0
1,1,14,104,290,-186,-506,-514,8,64.92592592592592,27,261.0,0
0,1,57,84,833,-749,-267,-4,-263,167.97619047619048,42,86.0,1
0,1,38,259,486,-227,-406,-95,-311,186.43478260869566,46,17.0,1
0,1,0,1253,694,559,-116,-98,-18,224.30769230769232,26,694.0,0
0,1,0,244,-335,579,-540,-554,14,358.0,17,245.0,1
0,1,29,421,-588,1009,-193,-61,-132,244.4047619047619,42,-595.0,0
0,1,37,25,-446,471,-471,-121,-350,210.82142857142858,28,25.0,1
0,1,35,947,-380,1327,-168,-221,53,333.0,40,948.0,1
0,1,0,788,-171,959,-239,-329,90,434.1304347826087,23,785.0,1
0,1,69,541,214,327,-143,-415,272,202.52380952380952,21,541.0,1
0,1,0,817,-304,1121,-262,-288,26,438.46153846153845,26,818.0,1
0,1,55,7,-182,189,-746,-470,-276,148.77272727272728,22,8.0,1
1,1,62,20,217,-197,-755,-461,-294,111.0,26,18.0,1
0,1,12,245,-600,845,-422,-106,-316,236.61666666666667,60,244.0,1
1,1,0,622,315,307,-31,-49,18,107.48484848484848,33,293.0,0
0,1,0,875,-356,1231,-216,-226,10,298.0,42,-380.0,0
0,1,0,845,-360,1205,-132,-326,194,568.8181818181819,22,847.0,1
0,1,40,892,-444,1336,-199,-221,22,357.2162162162162,37,-457.0,0
0,1,0,845,-390,1235,-146,-346,200,580.3636363636364,22,843.0,1
0,1,0,928,-293,1221,-118,-243,125,579.6818181818181,22,929.0,1
0,1,0,1066,35,1031,-160,-458,298,485.8695652173913,23,1055.0,1
0,1,27,608,607,1,-175,-178,3,92.25714285714285,35,590.0,0
1,1,75,1226,740,486,-299,-86,-213,111.70491803278688,61,1007.0,1
1,1,58,1203,1477,-274,-91,-129,38,78.3125,64,1219.0,1
0,1,0,298,-266,564,-583,-636,53,257.3636363636364,22,297.0,1
0,1,0,1544,-1343,2887,-293,-137,-156,422.23943661971833,71,-1402.0,0
0,1,0,1075,95,980,-149,-624,475,398.2291666666667,48,1076.0,1
0,1,6,482,-552,1034,-267,-21,-246,180.25396825396825,63,484.0,1
0,1,0,1862,967,895,-215,-278,63,384.75,24,1865.0,1
0,1,0,1141,-386,1527,-189,-251,62,439.0285714285714,35,1144.0,1
0,1,0,263,-153,416,-574,-553,-21,254.5,16,269.0,1
0,1,0,940,207,733,-228,-241,13,360.3809523809524,21,934.0,1
1,1,0,926,1363,-437,-168,-115,-53,131.15151515151516,33,923.0,1
1,1,1,1536,207,1329,-213,-456,243,254.71428571428572,56,1540.0,1
0,1,4,880,-842,1722,-193,-164,-29,376.2391304347826,46,-842.0,0
0,1,11,978,426,552,-206,-179,-27,167.67741935483872,31,977.0,1
0,1,0,261,-304,565,-630,-580,-50,152.55,40,253.0,1
0,1,6,1606,-249,1855,-282,-420,138,383.44,50,1611.0,1
0,1,0,460,-530,990,-228,-235,7,236.02380952380952,42,443.0,1
0,1,0,325,-544,869,-277,-68,-209,245.75675675675674,37,-538.0,0
0,1,12,851,-1369,2220,-264,-177,-87,415.037037037037,54,849.0,1
0,1,1,1228,242,986,-256,-460,204,209.28571428571428,49,1227.0,1
0,1,32,814,-976,1790,-242,-141,-101,420.8837209302326,43,815.0,1
0,1,0,488,539,-51,-241,-244,3,54.75757575757576,33,532.0,0
0,1,7,195,-234,429,-538,-313,-225,179.28571428571428,28,-268.0,0
0,1,4,665,-245,910,-98,-477,379,180.54545454545453,66,629.0,1
0,1,54,1031,-940,1971,-158,-174,16,510.15384615384613,39,-944.0,0
1,1,1,2224,2204,20,-173,-67,-106,34.166666666666664,6,2190.0,0
1,1,11,1221,1202,19,-115,-10,-105,9.2,5,1222.0,0
1,1,0,1632,1644,-12,-162,-52,-110,7.0,1,1632.0,0
0,1,60,421,532,-111,-210,-154,-56,89.03846153846153,26,379.0,1
0,1,1,1223,-88,1311,-180,-737,557,399.3378378378378,74,1221.0,1
0,1,42,532,550,-18,-111,-99,-12,75.3030303030303,33,433.0,1
0,1,0,552,-503,1055,12,-32,44,260.64285714285717,42,543.0,1
0,1,0,289,-322,611,-610,-536,-74,194.9375,32,291.0,1
0,1,2,1511,667,844,-202,-191,-11,217.1315789473684,38,1512.0,1
0,1,7,259,-344,603,-615,-562,-53,167.71428571428572,35,260.0,1
0,1,45,544,519,25,-142,-65,-77,28.8,5,541.0,0
0,1,9,547,-275,822,-260,-536,276,274.06060606060606,33,547.0,1
0,1,0,119,541,-422,-282,-179,-103,197.04347826086956,23,564.0,0
0,1,25,37,526,-489,-269,-33,-236,206.64,25,558.0,0
0,1,0,1758,893,865,-136,-243,107,434.35,20,1759.0,1
0,1,0,473,162,311,-237,-236,-1,269.09090909090907,77,476.0,1
0,1,0,762,579,183,-282,-269,-13,115.24,25,792.0,1
0,1,28,482,-562,1044,-212,-134,-78,232.0,47,-598.0,0
0,1,0,311,-1246,1557,-240,-172,-68,333.85714285714283,49,-1248.0,0
0,1,0,1491,1523,-32,-91,-52,-39,48.4,5,1523.0,0
0,1,1,12,-14,26,-412,-300,-112,119.0,3,-14.0,0
0,1,18,832,-1097,1929,-201,-149,-52,381.54901960784315,51,834.0,1
0,1,0,1218,822,396,-89,-291,202,323.25,44,1213.0,1
0,1,64,168,517,-349,-362,-112,-250,195.0,22,515.0,0
0,1,14,1885,503,1382,-191,-195,4,278.3265306122449,49,517.0,0
0,1,2,542,525,17,-202,74,-276,47.5,4,545.0,0
0,1,22,466,-680,1146,-285,-137,-148,202.375,56,476.0,1
0,1,14,924,-1275,2199,-230,-187,-43,481.1521739130435,46,-1275.0,0
1,1,3,978,1402,-424,-123,-89,-34,103.82051282051282,39,1385.0,0
1,1,36,1560,235,1325,-155,-415,260,315.14285714285717,42,222.0,0
0,1,0,553,551,2,-248,-283,35,61.0,5,537.0,0
0,1,0,1249,386,863,-287,-380,93,456.0,19,1248.0,1
0,1,0,445,20,425,-226,-417,191,198.34782608695653,23,20.0,0
0,1,31,167,805,-638,-324,-144,-180,230.72413793103448,29,819.0,0
0,1,2,572,-667,1239,-231,-157,-74,241.52941176470588,51,-667.0,0
0,1,0,1290,-407,1697,-205,-290,85,472.43243243243245,37,1254.0,1
0,1,0,927,952,-25,-104,-119,15,48.2,10,944.0,0
0,1,0,653,-440,1093,-194,-217,23,233.31372549019608,51,655.0,1
0,1,0,685,-964,1649,-291,-177,-114,325.27450980392155,51,-972.0,0
0,1,1,502,486,16,-131,-110,-21,25.866666666666667,15,483.0,0
0,1,0,1445,-293,1738,-249,-480,231,316.17241379310343,58,1438.0,1
0,1,1,1545,1564,-19,-131,-120,-11,64.46153846153847,13,1569.0,0
0,1,11,142,946,-804,238,221,17,260.1290322580645,31,962.0,0
0,1,0,1508,1493,15,-186,-108,-78,63.0,9,1466.0,0
0,1,0,294,-258,552,-592,-597,5,149.65853658536585,41,303.0,1
0,1,12,724,-1040,1764,-274,243,-517,378.1521739130435,46,-1028.0,0
0,1,20,249,-219,468,-569,-453,-116,222.33333333333334,24,-244.0,0
0,1,0,1013,-667,1680,-201,-217,16,343.8775510204082,49,1014.0,1
0,1,7,1907,857,1050,-287,-235,-52,287.0833333333333,36,857.0,0
1,1,26,473,543,-70,-35,-55,20,71.275,40,476.0,0
1,1,0,597,-658,1255,-126,-87,-39,249.24137931034483,58,-680.0,0
0,1,0,1237,1232,5,-91,-81,-10,73.37777777777778,45,1234.0,0
0,1,86,101,-506,607,-250,-35,-215,243.0,27,-516.0,0
1,1,27,913,-1253,2166,-196,-142,-54,435.76,50,908.0,1
0,1,1,1266,384,882,-168,-129,-39,249.02702702702703,37,388.0,0
0,1,1,417,-502,919,-284,-155,-129,249.52941176470588,34,-437.0,0
0,1,0,986,324,662,-240,-239,-1,376.2352941176471,17,983.0,1
0,1,0,760,392,368,-240,-300,60,302.4166666666667,12,757.0,1
0,1,15,577,-517,1094,-184,-153,-31,313.62857142857143,35,-517.0,0
0,1,1,636,-479,1115,-204,-233,29,293.9189189189189,37,607.0,1
0,1,59,345,1888,-1543,-453,-154,-299,325.04,50,1899.0,0
0,1,5,451,525,-74,-120,-45,-75,66.05263157894737,19,539.0,0
0,1,10,466,-588,1054,-170,-131,-39,257.72727272727275,44,468.0,1
0,1,0,603,578,25,-172,-29,-143,53.96,25,577.0,0
0,1,11,797,-963,1760,-219,-166,-53,361.7755102040816,49,815.0,1
0,1,0,488,499,-11,-101,-69,-32,61.0,7,489.0,0
0,1,0,95,-310,405,-269,-595,326,144.75,36,-304.0,0
0,1,3,263,269,-6,-523,-424,-99,57.94117647058823,17,266.0,0
0,1,0,1575,893,682,-201,-166,-35,180.3783783783784,37,893.0,0
0,1,0,481,519,-38,-101,-52,-49,32.0,9,515.0,0
0,1,0,384,388,-4,-610,-578,-32,83.0,2,383.0,0
0,1,0,469,444,25,-227,-211,-16,244.58536585365854,41,470.0,0
0,1,0,1055,689,366,-242,-310,68,333.27272727272725,11,1056.0,1
0,1,0,993,-712,1705,-196,-245,49,357.0816326530612,49,995.0,1
0,1,0,1013,-285,1298,-211,-346,135,331.1034482758621,58,1022.0,1
0,1,8,677,-451,1128,250,91,159,308.3333333333333,36,-428.0,0
0,1,0,188,-2,190,-476,-493,17,266.625,8,188.0,1
0,1,4,37,554,-517,-486,-171,-315,244.96,25,554.0,0
0,1,0,882,-262,1144,391,453,-62,371.5806451612903,62,883.0,1
0,1,8,582,160,422,-238,-359,121,143.26666666666668,30,567.0,1
0,1,33,1731,824,907,-167,-71,-96,266.2352941176471,34,1731.0,1
0,1,0,323,-438,761,-252,-132,-120,287.1111111111111,27,-454.0,0
0,1,11,410,-495,905,-77,-151,74,273.5882352941176,34,410.0,1
0,1,56,846,17,829,-211,-851,640,273.7631578947368,38,17.0,0
0,1,13,204,-1655,1859,-434,14,-448,428.6136363636364,44,-1664.0,0
0,1,0,658,-822,1480,-222,-134,-88,325.6808510638298,47,-857.0,0
0,1,3,424,-583,1007,-125,-200,75,290.48571428571427,35,419.0,1
0,1,0,2,35,-33,-500,-489,-11,151.0,3,1.0,0
0,1,0,1222,415,807,-179,-218,39,284.7142857142857,28,415.0,0
0,1,31,1911,911,1000,-230,-118,-112,246.975,40,923.0,0
0,1,0,885,-11,896,-219,-433,214,318.54,50,880.0,1
0,1,20,879,-284,1163,-189,-301,112,361.0857142857143,35,-312.0,0
0,1,17,225,-696,921,-463,-55,-408,249.925,40,226.0,1
0,1,12,675,-810,1485,-206,-149,-57,347.1136363636364,44,-824.0,0
0,1,0,1046,742,304,-205,-159,-46,214.14285714285714,14,742.0,0
0,1,36,1269,-839,2108,-189,-161,-28,421.1,50,-834.0,0
0,1,10,967,-250,1217,-176,-403,227,348.9791666666667,48,965.0,1
0,1,0,454,-393,847,-126,-149,23,236.28947368421052,38,455.0,1
0,1,0,1048,-414,1462,-183,-188,5,331.7111111111111,45,-424.0,0
0,1,0,233,-191,424,-554,-576,22,231.78947368421052,19,233.0,1
0,1,0,913,668,245,-136,-344,208,347.55555555555554,9,910.0,1
0,1,0,457,-873,1330,-215,-129,-86,348.2631578947368,38,-873.0,0
0,1,0,1961,783,1178,-269,-162,-107,381.8709677419355,31,1959.0,1
0,1,0,938,-268,1206,-214,-310,96,321.90909090909093,44,-341.0,0
0,1,0,874,-469,1343,-234,-227,-7,348.35,40,875.0,1
0,1,0,468,6,462,-193,-479,286,235.44,25,471.0,1
0,1,5,207,-2223,2430,-499,-25,-474,448.5272727272727,55,-2225.0,0
0,1,0,5,816,-811,-277,-48,-229,282.9642857142857,28,816.0,0
0,1,0,1090,300,790,-240,-251,11,421.94736842105266,19,300.0,0
0,1,0,604,555,49,-154,-110,-44,22.666666666666668,6,603.0,0
0,1,7,727,-888,1615,-197,-52,-145,445.9166666666667,36,-888.0,0
0,1,0,446,-661,1107,-120,-147,27,292.36842105263156,38,447.0,1
0,1,14,1274,1310,-36,-156,-51,-105,168.57954545454547,88,580.0,1
0,1,43,538,792,-254,-282,-77,-205,134.5581395348837,43,446.0,1
1,1,0,1181,414,767,-344,-225,-119,173.37209302325581,43,424.0,0
0,1,25,653,707,-54,-209,-131,-78,169.625,48,284.0,1
0,1,67,164,-11,175,-560,-698,138,111.77777777777777,27,197.0,1
0,1,0,1804,516,1288,-225,-121,-104,316.3170731707317,41,516.0,0
0,1,2,495,-931,1426,-225,-171,-54,336.0238095238095,42,-931.0,0
0,1,0,1098,394,704,-211,-86,-125,202.97142857142856,35,394.0,0
0,1,0,298,-210,508,-536,-590,54,339.0,16,298.0,1
0,1,7,847,289,558,-201,-401,200,223.1851851851852,27,842.0,1
0,1,46,521,-510,1031,-222,-96,-126,257.7435897435897,39,-507.0,0
0,1,0,664,-422,1086,-257,-211,-46,284.75555555555553,45,-519.0,0
0,1,0,920,-11,931,-274,-526,252,309.8333333333333,54,905.0,1
0,1,0,1050,755,295,-193,-153,-40,264.8,10,1044.0,1
0,1,0,285,-414,699,-515,-546,31,435.6875,16,285.0,1
0,1,0,469,-452,921,-105,-46,-59,248.15384615384616,39,493.0,1
0,1,3,874,832,42,-155,25,-180,46.75,4,874.0,0
0,1,0,1071,-932,2003,-251,-140,-111,552.9444444444445,36,-932.0,0
0,1,0,1105,-507,1612,-254,-250,-4,539.4,30,1100.0,1
0,1,0,20,14,6,-769,-717,-52,57.470588235294116,17,18.0,0
0,1,0,433,-439,872,-88,-6,-82,228.0681818181818,44,-434.0,0
1,1,11,581,-511,1092,-185,-70,-115,262.5,44,582.0,1
0,1,0,976,529,447,-201,-175,-26,344.85714285714283,14,974.0,1
0,1,4,531,-696,1227,-202,-114,-88,279.75,44,-696.0,0
0,1,4,798,-497,1295,-188,-121,-67,286.8222222222222,45,799.0,1
0,1,0,109,264,-155,-308,-338,30,368.8510638297872,47,-673.0,1
0,1,16,1193,632,561,-152,-91,-61,123.52380952380952,42,632.0,0
0,1,0,1049,483,566,-196,-193,-3,152.24324324324326,37,1048.0,1
0,1,0,1204,658,546,-185,-189,4,256.8095238095238,21,1200.0,1
0,1,0,476,444,32,-129,-103,-26,53.166666666666664,6,476.0,0
0,1,4,702,-464,1166,-229,-210,-19,244.17021276595744,47,703.0,1
0,1,9,720,-468,1188,-225,-136,-89,255.1086956521739,46,721.0,1
0,1,0,432,480,-48,-99,-2,-97,63.38461538461539,13,479.0,0
0,1,0,249,-453,702,-249,-171,-78,276.03846153846155,26,-474.0,0
1,1,0,1241,647,594,-222,-196,-26,266.0,22,647.0,0
1,1,0,16,49,-33,-687,-745,58,81.46153846153847,13,13.0,0
0,1,14,467,-467,934,-248,-182,-66,362.3076923076923,26,-473.0,0
1,1,27,1272,162,1110,-168,-377,209,281.475,40,172.0,0
1,1,36,944,1375,-431,-30,72,-102,167.2962962962963,27,943.0,1
0,1,9,530,-656,1186,-228,-87,-141,328.77777777777777,36,-656.0,0
0,1,0,890,-447,1337,-195,-132,-63,372.1388888888889,36,-447.0,0
0,1,0,456,-464,920,-239,-59,-180,303.16129032258067,31,-481.0,0
0,1,17,1991,1317,674,-217,-42,-175,207.0,33,1315.0,0
0,1,0,717,-417,1134,-177,-142,-35,285.1,40,-421.0,0
0,1,0,683,-282,965,-262,-200,-62,420.5416666666667,24,690.0,1
0,1,0,959,27,932,-196,-254,58,447.76190476190476,21,933.0,1
0,1,0,530,-402,932,-225,-82,-143,241.175,40,-417.0,0
0,1,0,266,-219,485,-514,-589,75,344.0,16,270.0,1
0,1,1,973,-220,1193,-136,-418,282,318.44444444444446,45,976.0,1
0,1,0,1029,815,214,-262,-429,167,232.16666666666666,12,1029.0,1
0,1,17,175,252,-77,-321,-489,168,195.4814814814815,27,-13.0,1
0,1,6,979,553,426,282,68,214,362.27868852459017,61,-347.0,1
0,1,6,287,564,-277,-16,153,-169,351.875,40,-303.0,1
0,1,0,488,-562,1050,-210,-100,-110,353.741935483871,31,-562.0,0
0,1,0,938,654,284,-161,-223,62,270.72727272727275,11,939.0,1
0,1,43,279,465,-186,-239,-150,-89,179.0,9,467.0,0
0,1,0,874,345,529,-217,-329,112,406.35714285714283,14,876.0,1
0,1,91,498,15,483,-206,-479,273,245.08163265306123,49,499.0,1
0,1,0,903,403,500,-192,-239,47,364.14285714285717,14,905.0,1
0,1,15,225,610,-385,-521,-202,-319,175.25925925925927,27,224.0,1
0,1,0,440,-378,818,-258,-303,45,269.5806451612903,31,-398.0,0
0,1,0,416,-535,951,-200,-163,-37,318.03333333333336,30,-539.0,0
0,1,20,271,641,-370,-502,-112,-390,183.84,25,271.0,1
0,1,0,1132,587,545,-158,-210,52,406.92857142857144,14,1132.0,1
0,1,12,495,-583,1078,-229,-96,-133,283.6666666666667,39,-609.0,0
0,1,33,1125,532,593,-150,-113,-37,189.46666666666667,30,548.0,0
0,1,0,1079,-106,1185,-180,-309,129,530.695652173913,23,1074.0,1
0,1,18,1143,-324,1467,-176,-543,367,344.52272727272725,44,-327.0,0
0,1,46,769,629,140,-74,-69,-5,110.16666666666667,12,770.0,1
0,1,0,1354,-129,1483,-135,-283,148,400.7837837837838,37,1348.0,1
0,1,62,497,-498,995,-205,-201,-4,281.72222222222223,36,495.0,1
0,1,14,424,-436,860,-238,-184,-54,228.36111111111111,36,425.0,1
0,1,0,435,334,101,-194,-184,-10,250.57894736842104,38,436.0,1
0,1,0,957,-199,1156,-206,-342,136,562.8095238095239,21,-199.0,0
0,1,0,1877,-142,2019,-130,-281,151,363.76785714285717,56,1015.0,1
0,1,27,863,-945,1808,-236,-121,-115,352.4117647058824,51,863.0,1
0,1,0,968,-115,1083,-160,-340,180,532.0952380952381,21,969.0,1
0,1,3,532,-453,985,-227,-176,-51,264.44444444444446,36,519.0,1
0,1,0,1115,523,592,-148,-333,185,415.0,15,1113.0,1
0,1,0,335,-445,780,-176,-100,-76,284.7586206896552,29,-448.0,0
0,1,0,1482,199,1283,-107,-281,174,551.1666666666666,24,1481.0,1
1,1,33,1256,689,567,-81,-69,-12,153.51351351351352,37,681.0,0
0,1,0,1098,-377,1475,-161,-246,85,306.03333333333336,60,-541.0,1
1,1,40,824,206,618,-184,-495,311,219.4516129032258,31,207.0,0
1,1,15,674,378,296,-173,-243,70,94.41935483870968,31,675.0,1
1,1,27,1824,789,1035,-63,-90,27,270.2368421052632,38,787.0,0
0,1,19,856,-1110,1966,-176,-175,-1,336.37931034482756,58,856.0,1
0,1,0,502,372,130,-157,-199,42,105.0,9,466.0,0
0,1,0,475,272,203,-210,-205,-5,273.5,32,465.0,1
0,1,0,426,-458,884,-227,-145,-82,338.96153846153845,26,-464.0,0
0,1,0,1238,-504,1742,-81,-252,171,555.875,32,1238.0,1
0,1,41,493,-481,974,-193,-107,-86,281.74285714285713,35,494.0,1
0,1,0,247,-163,410,-519,-594,75,359.9166666666667,12,249.0,1
0,1,0,776,288,488,-172,-301,129,316.81159420289856,69,770.0,1
0,1,19,1054,-1026,2080,-168,-128,-40,460.9130434782609,46,1055.0,1
0,1,63,51,379,-328,-280,-266,-14,189.77777777777777,18,405.0,0
0,1,35,1292,1260,32,-33,-53,20,102.36111111111111,36,1293.0,0
0,1,0,895,458,437,-133,-173,40,379.4166666666667,12,896.0,1
0,1,21,644,378,266,-279,-217,-62,149.41176470588235,17,378.0,0
0,1,0,815,-289,1104,-177,-275,98,445.6,25,816.0,1
0,1,29,590,-881,1471,-218,-230,12,320.97777777777776,45,-873.0,0
0,1,0,269,-265,534,-485,-390,-95,185.40625,32,292.0,1
0,1,36,519,-431,950,-171,-53,-118,222.0735294117647,68,513.0,1
0,1,0,265,468,-203,-265,-183,-82,296.53846153846155,39,-198.0,1
0,1,0,268,-412,680,-178,-89,-89,202.1578947368421,38,273.0,1
0,1,0,536,303,233,-227,-259,32,279.6666666666667,9,537.0,1
0,1,35,214,-186,400,-478,-417,-61,146.13793103448276,29,-190.0,0
1,1,25,1113,-1011,2124,-153,-159,6,371.70175438596493,57,-1017.0,0
1,1,13,619,-536,1155,-168,-148,-20,284.025,40,607.0,1
0,1,11,3184,-236,3420,-1408,-487,-921,316.9888888888889,90,3185.0,1
0,1,11,843,-952,1795,-221,-165,-56,365.85714285714283,49,843.0,1
0,1,0,1068,-68,1136,-201,-297,96,479.25,24,1069.0,1
1,1,47,6,-214,220,-761,-505,-256,85.57142857142857,28,1.0,1
0,1,45,1276,1235,41,-88,-112,24,123.57692307692308,52,1262.0,0
0,1,2,475,-481,956,-163,-137,-26,278.74285714285713,35,-494.0,0
0,1,0,597,358,239,-230,-227,-3,360.66101694915255,59,599.0,1
0,1,18,477,-521,998,-161,-170,9,243.85365853658536,41,480.0,1
0,1,17,228,-1474,1702,-258,-35,-223,440.7105263157895,38,-1479.0,0
1,1,31,13,-165,178,-664,-424,-240,148.75,16,-166.0,0
1,1,1,509,-471,980,-82,-93,11,200.0,56,511.0,1
0,1,16,1056,-142,1198,-262,-340,78,273.06666666666666,45,1056.0,1
0,1,55,1588,-198,1786,-186,-463,277,363.8,50,1590.0,1
0,1,0,1173,439,734,-196,-258,62,381.65,20,1176.0,1
0,1,0,187,-251,438,-491,-543,52,259.63157894736844,19,186.0,1
0,1,2,207,-219,426,-463,-452,-11,206.33333333333334,21,208.0,1
0,1,6,222,-909,1131,-506,-210,-296,248.08695652173913,46,-909.0,0
0,1,44,133,292,-159,-641,-497,-144,100.14285714285714,21,317.0,0
0,1,14,250,-262,512,-512,-499,-13,201.04,25,236.0,1
0,1,0,916,-201,1117,-124,-249,125,546.9047619047619,21,918.0,1
0,1,2,533,189,344,-166,-472,306,142.44117647058823,34,535.0,1
0,1,0,593,344,249,-202,-252,50,355.719298245614,57,-145.0,1
0,1,0,1015,711,304,-181,-212,31,474.7142857142857,7,711.0,0
0,1,52,207,-169,376,-458,-425,-33,138.76666666666668,30,209.0,1
0,1,27,431,-552,983,-177,-180,3,281.14285714285717,35,432.0,1
0,1,45,275,-581,856,-224,-91,-133,257.57575757575756,33,-590.0,0
0,1,6,783,-1334,2117,-193,-125,-68,431.59183673469386,49,781.0,1
0,1,0,627,-67,694,-155,-192,37,376.63157894736844,19,628.0,1
0,1,0,949,487,462,-143,-224,81,376.0769230769231,13,952.0,1
0,1,26,181,-518,699,-263,-114,-149,292.72,25,-525.0,0
0,1,5,1148,1104,44,-189,-150,-39,267.4727272727273,55,394.0,1
0,1,0,484,-569,1053,-190,-124,-66,246.8139534883721,43,484.0,1
0,1,1,476,-379,855,-197,-276,79,237.69444444444446,36,-393.0,0
1,1,23,234,251,-17,-507,-503,-4,44.55555555555556,9,236.0,0
1,1,78,160,483,-323,-236,-146,-90,183.27777777777777,18,489.0,0
0,1,0,1175,455,720,-104,-141,37,220.4848484848485,33,1173.0,1
0,1,0,243,144,99,-538,-543,5,168.5,6,144.0,0
0,1,63,658,617,41,-181,-193,12,73.24375,160,663.0,0
0,1,0,864,-84,948,-219,-298,79,471.45,20,840.0,1
0,1,6,690,-1147,1837,-261,-164,-97,366.70588235294116,51,-1150.0,0
1,1,28,497,615,-118,-203,-162,-41,84.15384615384616,13,512.0,1
1,1,23,565,-484,1049,-179,-166,-13,310.8235294117647,34,548.0,1
0,1,3,1527,585,942,-198,-167,-31,233.65,40,585.0,0
0,1,0,241,-257,498,-566,-617,51,387.46153846153845,13,239.0,1
0,1,26,1430,660,770,-178,-169,-9,228.26470588235293,34,662.0,0
0,1,10,738,373,365,-240,-278,38,99.27272727272727,33,373.0,0
0,1,0,520,117,403,-227,-261,34,262.93333333333334,30,518.0,1
0,1,9,542,-456,998,-201,-286,85,263.2432432432432,37,543.0,1
0,1,55,243,210,33,-605,-543,-62,100.35555555555555,45,69.0,1
1,1,19,833,811,22,-68,-73,5,121.89583333333333,48,834.0,0
0,1,22,260,225,35,-512,-461,-51,131.54347826086956,46,255.0,0
0,1,0,520,459,61,-168,-211,43,186.25,4,519.0,0
0,1,44,773,744,29,-150,-141,-9,113.91428571428571,35,562.0,1
1,1,19,1423,889,534,-96,-74,-22,201.07692307692307,26,1422.0,1
0,1,26,234,187,47,-585,-559,-26,146.35135135135135,37,234.0,0
0,1,39,465,-490,955,-203,-145,-58,266.52777777777777,36,-489.0,0
0,1,0,1028,821,207,-191,-239,48,140.0,14,997.0,1
0,1,0,242,-86,328,-564,-616,52,268.15384615384613,13,243.0,1
0,1,0,343,-924,1267,-309,-334,25,402.81632653061223,49,687.0,1
0,1,0,1288,307,981,-191,-227,36,195.58,50,459.0,1
1,1,46,205,14,191,-544,-795,251,139.23809523809524,21,206.0,1
1,1,31,1848,490,1358,-163,-169,6,350.87179487179486,39,474.0,0
0,1,1,1332,848,484,-235,-182,-53,140.47058823529412,34,848.0,0
0,1,10,255,1184,-929,-289,-177,-112,328.85714285714283,28,1189.0,0
0,1,8,18,-186,204,-707,-486,-221,125.0909090909091,22,16.0,1
0,1,0,275,-604,879,-501,-676,175,422.0,21,277.0,1
1,1,38,18,770,-752,-461,-99,-362,233.91666666666666,36,773.0,0
0,1,0,6,-80,86,-764,-588,-176,159.375,32,214.0,1
1,1,37,472,-508,980,-136,-147,11,276.44444444444446,36,-506.0,0
0,1,0,1317,225,1092,-97,-621,524,512.5833333333334,24,1310.0,1
0,1,44,1,577,-576,-478,-212,-266,230.6153846153846,26,569.0,0
0,1,21,92,2017,-1925,-510,-91,-419,345.0877192982456,57,91.0,1
0,1,0,1189,-1073,2262,-224,-196,-28,435.3269230769231,52,-1073.0,0
0,1,8,1178,-1589,2767,-203,-124,-79,396.7865168539326,89,1180.0,1
1,1,5,439,932,-493,-117,-66,-51,108.68181818181819,44,447.0,1
0,1,0,206,-220,426,-555,-466,-89,116.9,40,186.0,1
0,1,6,783,569,214,-235,-256,21,95.52631578947368,19,569.0,0
0,1,0,1773,1502,271,-158,-128,-30,270.27272727272725,11,1776.0,1
0,1,0,910,98,812,-229,-296,67,414.9,20,913.0,1
0,1,0,833,200,633,-256,-379,123,382.0,17,832.0,1
0,1,0,692,-438,1130,-252,-199,-53,289.3,40,-458.0,0
0,1,0,590,48,542,-178,-507,329,270.46153846153845,26,590.0,1
0,1,24,1352,1073,279,-93,172,-265,129.1578947368421,19,1348.0,1
0,1,0,577,-531,1108,-227,8,-235,251.6046511627907,43,576.0,1
0,1,11,630,-1116,1746,-227,-47,-180,331.5660377358491,53,-1116.0,0
0,1,32,819,365,454,-211,-305,94,110.54166666666667,48,842.0,1
0,1,0,238,-88,326,-513,-554,41,364.7,10,239.0,1
0,1,0,1101,417,684,-222,-216,-6,254.07407407407408,27,417.0,0
0,1,33,386,-457,843,-264,-205,-59,247.7058823529412,34,-464.0,0
0,1,37,426,-490,916,-194,-195,1,221.7674418604651,43,427.0,1
0,1,10,204,-154,358,-496,-571,75,124.54545454545455,33,205.0,1
0,1,95,776,-1168,1944,-258,-205,-53,329.66101694915255,59,-1168.0,0
0,1,64,424,-438,862,-202,-165,-37,251.27777777777777,36,-448.0,0
0,1,0,496,509,-13,-160,1,-161,93.0,3,495.0,0
0,1,0,244,300,-56,-477,-292,-185,73.25,4,300.0,0
0,1,31,471,-438,909,-228,-193,-35,269.2352941176471,34,474.0,1
0,1,15,540,959,-419,-222,-136,-86,225.8421052631579,19,959.0,0
0,1,11,585,-928,1513,-242,-163,-79,326.531914893617,47,-909.0,0
0,1,0,873,-461,1334,-233,-239,6,296.5869565217391,46,-474.0,0
0,1,21,275,-830,1105,-268,-194,-74,311.6,35,-831.0,0
0,1,0,201,249,-48,-449,-314,-135,230.5,36,613.0,1
0,1,0,665,-300,965,-206,-264,58,472.95238095238096,21,666.0,1
0,1,15,258,-235,493,-549,-563,14,190.03703703703704,27,-255.0,0
0,1,85,222,235,-13,-534,-531,-3,78.078125,64,223.0,0
0,1,99,1540,1446,94,-158,-203,45,100.96907216494846,97,1538.0,0
0,1,108,1055,1070,-15,-90,-102,12,96.26470588235294,102,1055.0,0
0,1,88,1883,1826,57,-75,-62,-13,158.6044776119403,134,1885.0,0
0,1,0,184,420,-236,-286,-134,-152,160.66666666666666,18,481.0,0
0,1,15,1390,684,706,-229,-172,-57,190.6216216216216,37,685.0,0
0,1,0,601,218,383,-200,-264,64,345.6666666666667,12,602.0,1
0,1,0,608,116,492,-232,-257,25,241.9318181818182,44,-152.0,1
0,1,0,544,500,44,-170,-199,29,125.0,4,545.0,0
0,1,0,723,-624,1347,-253,-239,-14,366.3243243243243,37,723.0,1
0,1,0,2104,2167,-63,-93,-93,0,83.57142857142857,7,2167.0,0
0,1,9,796,-459,1255,-262,-220,-42,265.2916666666667,48,797.0,1
0,1,9,437,-731,1168,-243,-199,-44,279.8780487804878,41,-731.0,0
0,1,16,583,-408,991,-226,-274,48,282.2857142857143,35,-419.0,0
0,1,1,755,-819,1574,-211,-210,-1,362.20454545454544,44,-819.0,0
0,1,0,566,240,326,-218,-190,-28,295.3636363636364,11,553.0,1
0,1,0,1163,409,754,-183,-193,10,176.71428571428572,42,1164.0,1
0,1,0,1139,-1549,2688,-169,-168,-1,428.8072289156627,83,1145.0,1
1,1,109,420,979,-559,-103,-72,-31,164.15151515151516,33,416.0,1
0,1,48,1210,2156,-946,-341,-161,-180,286.46875,32,2158.0,0
0,1,3,710,-895,1605,-196,-226,30,315.84313725490193,51,710.0,1
0,1,0,729,-416,1145,-208,-239,31,306.0810810810811,37,731.0,1
0,1,1,728,-418,1146,-191,-244,53,203.16071428571428,56,726.0,1
1,1,0,610,-16,626,-246,-199,-47,220.88571428571427,35,-79.0,0
0,1,30,1207,428,779,-237,-196,-41,247.96774193548387,31,426.0,0
0,1,0,1228,589,639,-212,-332,120,426.0,15,1205.0,1
0,1,21,34,256,-222,-842,-546,-296,109.37931034482759,29,33.0,1
0,1,14,948,-2026,2974,-238,-213,-25,461.65625,64,950.0,1
0,1,74,15,-295,310,-753,-480,-273,172.0909090909091,22,15.0,1
0,1,17,567,-409,976,-208,-253,45,285.05882352941177,34,562.0,1
0,1,0,751,-572,1323,-204,-308,104,364.6938775510204,49,-779.0,1
0,1,0,954,489,465,-259,-293,34,385.0833333333333,12,944.0,1
0,1,0,1119,572,547,-212,-358,146,426.53846153846155,13,1107.0,1
0,1,0,565,-433,998,-232,-191,-41,275.1666666666667,36,-434.0,0
0,1,81,40,507,-467,-267,-276,9,232.4,20,508.0,0
1,1,16,204,250,-46,-479,-529,50,203.35714285714286,42,42.0,1
1,1,34,1399,477,922,-173,-235,62,296.2258064516129,31,469.0,0
0,1,12,447,-777,1224,-246,-227,-19,303.5897435897436,39,-777.0,0
0,1,30,340,-423,763,-247,-128,-119,274.32142857142856,28,-428.0,0
0,1,0,717,80,637,-225,-257,32,423.1333333333333,15,718.0,1
0,1,0,1011,6,1005,-268,-281,13,522.578947368421,19,1014.0,1
0,1,0,293,57,236,-532,-526,-6,220.45454545454547,11,300.0,1
0,1,0,728,-218,946,-288,-312,24,398.4583333333333,24,731.0,1
0,1,0,315,-75,390,-463,-453,-10,301.38461538461536,13,316.0,1
0,1,0,767,359,408,-388,-628,240,364.92857142857144,14,359.0,0
0,1,0,1254,623,631,-245,-348,103,425.2,15,1247.0,1
0,1,26,448,-384,832,-225,-123,-102,239.5142857142857,35,439.0,1
0,1,0,749,400,349,-196,-272,76,349.72727272727275,11,768.0,1
0,1,2,419,382,37,-271,-258,-13,116.0,17,304.0,0
0,1,30,623,-371,994,-238,-260,22,260.7368421052632,38,625.0,1
0,1,0,765,509,256,-220,-313,93,288.8,10,766.0,1
0,1,44,878,204,674,-222,-576,354,230.61764705882354,34,193.0,0
0,1,23,1540,220,1320,-133,-576,443,254.4126984126984,63,125.0,0
0,1,6,252,-221,473,-551,-512,-39,178.203125,64,253.0,1
1,1,20,998,1174,-176,-157,-166,9,133.46428571428572,28,998.0,1
1,1,25,987,803,184,-57,-46,-11,138.14285714285714,14,986.0,1
0,1,26,1438,302,1136,-279,-519,240,269.5581395348837,43,298.0,0
0,1,19,13,445,-432,-290,-243,-47,212.8421052631579,19,429.0,0
0,1,12,26,-603,629,-289,-271,-18,216.96969696969697,33,-662.0,0
0,1,0,1179,704,475,-229,-286,57,369.9230769230769,13,1180.0,1
0,1,18,538,712,-174,-61,-66,5,117.92307692307692,13,535.0,1
0,1,0,1443,1238,205,-233,-214,-19,212.0,10,1439.0,1
0,1,17,523,-391,914,-275,-222,-53,285.5,32,524.0,1
0,1,0,867,596,271,-217,-269,52,112.375,24,868.0,1
0,1,0,878,128,750,-223,-306,83,425.1111111111111,18,880.0,1
0,1,21,1374,-583,1957,-55,-94,39,298.32835820895525,67,-602.0,0
0,1,10,417,-1745,2162,-265,-218,-47,458.2340425531915,47,-1751.0,0
1,1,0,34,590,-556,-473,-180,-293,264.0,24,605.0,0
0,1,5,631,-418,1049,-251,-270,19,284.5,38,630.0,1
0,1,1,1194,590,604,-270,-242,-28,211.25,48,389.0,1
0,1,0,1061,-41,1102,-389,-356,-33,466.75,24,1056.0,1
1,1,50,16,1729,-1713,-705,-238,-467,362.9795918367347,49,1717.0,0
1,1,72,415,723,-308,-107,-163,56,117.96,25,741.0,0
1,1,31,545,2100,-1555,-179,-226,47,335.54347826086956,46,546.0,1
1,1,63,629,1093,-464,-239,-216,-23,137.0,32,1096.0,0
0,1,7,1156,897,259,-190,-178,-12,192.0,37,697.0,1
0,1,33,8,-1278,1286,-283,-185,-98,330.3421052631579,38,-1277.0,0
0,1,16,497,-512,1009,-307,-188,-119,234.72093023255815,43,497.0,1
0,1,36,121,-497,618,-141,39,-180,276.8095238095238,21,-472.0,0
0,1,6,695,478,217,-243,-270,27,201.75,32,693.0,1
0,1,0,1361,819,542,-244,-198,-46,154.73529411764707,34,819.0,0
0,1,0,824,592,232,-297,-308,11,257.0,10,825.0,1
0,1,1,508,-400,908,-187,-189,2,248.45945945945945,37,-385.0,0
0,1,0,887,-375,1262,-306,-337,31,472.5925925925926,27,889.0,1
0,1,29,261,249,12,-546,-513,-33,92.03125,32,106.0,1
1,1,0,1150,1934,-784,-227,-174,-53,217.94594594594594,37,1126.0,1
1,1,8,924,1112,-188,-97,-102,5,109.15,20,923.0,1
0,1,13,378,-458,836,-231,-238,7,292.7241379310345,29,-474.0,0
0,1,30,1242,387,855,-258,-181,-77,267.75,32,1240.0,1
0,1,0,821,603,218,-268,-345,77,354.35,40,822.0,1
0,1,13,25,-425,450,-486,-220,-266,193.26923076923077,26,24.0,1
1,1,0,1013,-628,1641,-279,-305,26,390.8809523809524,42,-628.0,0
1,1,34,591,534,57,-150,-126,-24,83.375,8,514.0,0
0,1,29,486,-395,881,-239,-202,-37,234.21621621621622,37,485.0,1
0,1,0,736,5,731,-282,-340,58,388.5263157894737,19,737.0,1
0,1,0,1182,380,802,-216,-394,178,418.9,20,1181.0,1
0,1,0,883,527,356,-214,-335,121,345.90909090909093,11,879.0,1
0,1,16,9,370,-361,-249,-211,-38,211.11764705882354,17,384.0,0
0,1,34,601,869,-268,-179,-178,-1,163.5,14,876.0,0
0,1,14,453,-272,725,-259,-267,8,243.65714285714284,35,452.0,1
0,1,16,439,-433,872,-199,-202,3,310.57142857142856,28,-439.0,0
0,1,46,90,-202,292,-537,-502,-35,145.2,20,-208.0,0
0,1,0,1282,580,702,-221,-340,119,451.875,16,580.0,0
0,1,6,1921,-719,2640,-243,-275,32,495.0,53,1923.0,1
0,1,44,1494,428,1066,-248,-249,1,291.3888888888889,36,434.0,0
0,1,31,928,-1074,2002,-242,-184,-58,414.6458333333333,48,931.0,1
1,1,32,1345,-1305,2650,-227,-199,-28,425.9516129032258,62,1352.0,1
1,1,19,630,410,220,-115,-227,112,136.78947368421052,19,631.0,1
0,1,27,227,189,38,-454,-433,-21,129.5,28,74.0,1
0,1,70,1942,842,1100,-217,-178,-39,294.6842105263158,38,818.0,0
0,1,30,1046,-1158,2204,-247,-180,-67,436.16,50,-1149.0,0
0,1,12,1239,487,752,-184,-143,-41,348.4761904761905,21,485.0,0
0,1,0,1337,503,834,-164,-69,-95,196.6904761904762,42,492.0,0
0,1,0,543,-131,674,-365,-256,-109,377.3888888888889,18,545.0,1
0,1,15,668,-738,1406,-257,-191,-66,405.88235294117646,34,-740.0,0
0,1,0,1049,598,451,-288,-528,240,379.42857142857144,14,1037.0,1
0,1,37,344,-290,634,-284,-528,244,293.9130434782609,23,-282.0,0
0,1,0,483,42,441,-109,-246,137,316.0769230769231,13,474.0,1
0,1,0,932,-431,1363,-195,-269,74,604.0434782608696,23,933.0,1
0,1,0,924,-102,1026,-212,-186,-26,521.65,20,919.0,1
0,1,0,808,151,657,-224,-263,39,443.3333333333333,15,805.0,1
0,1,1,282,-681,963,-590,-227,-363,265.4871794871795,39,-681.0,0
0,1,29,1143,483,660,-150,-158,8,270.5769230769231,26,458.0,0
0,1,50,1847,485,1362,-220,-191,-29,304.77777777777777,45,463.0,0
1,1,48,426,-624,1050,-221,-138,-83,262.4,40,-627.0,0
1,1,1,155,-270,425,-619,-504,-115,134.28125,32,155.0,1
0,1,0,1546,954,592,-184,-125,-59,252.58333333333334,24,1548.0,1
0,1,0,1880,1650,230,-133,-178,45,201.58333333333334,12,1882.0,1
0,1,0,220,-323,543,-536,-489,-47,223.48,25,-323.0,0
0,1,19,1293,456,837,-225,-182,-43,294.07142857142856,28,463.0,0
0,1,0,992,-415,1407,262,48,214,502.0,28,994.0,1
0,1,0,454,14,440,-87,-219,132,357.9166666666667,12,445.0,1
0,1,0,1142,503,639,-241,-153,-88,212.13333333333333,30,512.0,0
0,1,0,975,690,285,-185,-293,108,287.3636363636364,11,975.0,1
0,1,0,479,47,432,-216,-285,69,312.14285714285717,14,475.0,1
0,1,31,616,445,171,-234,-180,-54,133.54545454545453,11,453.0,0
0,1,0,1155,736,419,-185,-296,111,336.84615384615387,13,1150.0,1
0,1,2,746,-621,1367,-223,-125,-98,416.02941176470586,34,-621.0,0
0,1,37,284,-581,865,-223,-163,-60,335.12,25,-576.0,0
0,1,5,948,-973,1921,-197,-171,-26,395.8958333333333,48,949.0,1
0,1,0,779,-1333,2112,-281,-236,-45,483.4186046511628,43,-1333.0,0
0,1,27,1011,-771,1782,-282,-173,-109,409.04651162790697,43,-773.0,0
0,1,0,1082,160,922,-187,-256,69,486.7894736842105,19,1072.0,1
0,1,0,453,114,339,-191,-258,67,258.0,15,455.0,1
0,1,0,77,-262,339,-623,-588,-35,195.94117647058823,17,-262.0,0
0,1,0,954,-208,1162,-164,-357,193,543.7727272727273,22,956.0,1
0,1,0,1065,-189,1254,-202,-311,109,566.9545454545455,22,1042.0,1
0,1,0,1020,-275,1295,-186,-322,136,498.34615384615387,26,1018.0,1
1,1,0,251,409,-158,-492,-283,-209,151.8235294117647,17,409.0,0
1,1,2,337,594,-257,-445,-251,-194,191.5,16,594.0,0
0,1,0,222,-299,521,-602,-502,-100,160.21212121212122,33,-300.0,0
0,1,0,1851,1245,606,-182,-177,-5,226.65384615384616,26,1846.0,1
0,1,0,262,-436,698,-627,-700,73,423.7647058823529,17,265.0,1
0,1,0,463,-507,970,-210,-225,15,245.51282051282053,39,-499.0,0
0,1,0,1173,462,711,-260,-312,52,417.2352941176471,17,1175.0,1
0,1,0,718,146,572,-152,-322,170,264.2037037037037,54,721.0,1
0,1,25,615,494,121,-173,-155,-18,153.625,8,477.0,0
0,1,23,54,-993,1047,-290,-181,-109,408.12,25,-988.0,0
0,1,0,454,394,60,-205,-198,-7,129.75,4,453.0,0
0,1,0,176,-702,878,-580,-567,-13,467.63157894736844,19,-702.0,0
0,1,16,339,210,129,-485,-461,-24,110.76,25,340.0,1
0,1,68,1523,542,981,-233,-200,-33,235.2325581395349,43,517.0,0
0,1,16,978,-1991,2969,-174,-216,42,366.0740740740741,81,980.0,1
0,1,64,763,-1311,2074,-214,-267,53,484.9047619047619,42,-1300.0,0
0,1,2,15,18,-3,-699,-676,-23,32.0,4,19.0,0
0,1,0,1864,-133,1997,-174,-235,61,543.0540540540541,37,-133.0,0
0,1,0,1389,480,909,-130,-152,22,264.8378378378378,37,443.0,0
0,1,33,1622,482,1140,-173,-163,-10,293.075,40,458.0,0
0,1,0,1010,-298,1308,-191,-825,634,444.6666666666667,45,1012.0,1
0,1,0,874,-431,1305,-265,-565,300,382.7291666666667,48,-634.0,1
0,1,0,273,-781,1054,-349,-282,-67,298.0571428571429,35,-790.0,0
0,1,29,564,-991,1555,-307,-51,-256,319.72,50,-986.0,0
0,1,0,522,160,362,-273,-297,24,331.27272727272725,11,506.0,1
0,1,0,706,-395,1101,-188,-348,160,424.34615384615387,26,692.0,1
0,1,57,1278,549,729,-194,-156,-38,177.0,41,551.0,0
0,1,0,1166,693,473,-248,-270,22,370.6923076923077,13,1167.0,1
0,1,0,1037,496,541,-187,-183,-4,202.5,28,1038.0,1
0,1,78,1865,490,1375,-162,-155,-7,386.5833333333333,36,471.0,0
0,1,35,1592,460,1132,-278,-163,-115,300.1842105263158,38,457.0,0
0,1,51,89,105,-16,-248,-186,-62,77.5,2,85.0,0
0,1,0,877,-534,1411,-179,-234,55,570.8,25,878.0,1
0,1,0,376,-89,465,-265,-462,197,170.83870967741936,31,375.0,1
0,1,0,919,-817,1736,-161,-270,109,486.6111111111111,36,920.0,1
0,1,2,825,-874,1699,-197,-192,-5,372.5777777777778,45,828.0,1
0,1,38,1938,496,1442,-186,-153,-33,330.8139534883721,43,491.0,0
0,1,0,869,259,610,-114,-177,63,422.93333333333334,15,873.0,1
0,1,0,887,68,819,-171,-457,286,268.35185185185185,54,889.0,1
0,1,0,859,21,838,-206,-455,249,275.75555555555553,45,-156.0,1
0,1,0,826,55,771,-248,-471,223,281.15555555555557,45,-164.0,1
0,1,0,796,194,602,-182,-318,136,304.8780487804878,41,794.0,1
0,1,1,436,1061,-625,-283,-144,-139,227.6,55,438.0,1
0,1,0,674,-771,1445,-209,-249,40,414.37142857142857,35,-771.0,0
0,1,0,432,49,383,-210,-270,60,343.25,12,433.0,1
0,1,0,470,111,359,-212,-231,19,426.0,9,458.0,1
0,1,0,459,153,306,-202,-282,80,262.5833333333333,12,461.0,1
0,1,0,1045,767,278,-158,-277,119,258.9166666666667,12,1050.0,1
0,1,0,1317,255,1062,-188,-593,405,296.63157894736844,38,250.0,0
0,1,0,1085,571,514,-118,-252,134,379.7857142857143,14,1066.0,1
0,1,0,973,753,220,-145,-205,60,301.7142857142857,7,959.0,1
0,1,24,470,-446,916,-203,-156,-47,286.2121212121212,33,471.0,1
0,1,0,1108,520,588,-175,-133,-42,231.04,25,1106.0,1
0,1,0,609,270,339,-185,-256,71,180.5,18,585.0,1
0,1,0,553,149,404,-103,-265,162,318.2,15,552.0,1
0,1,5,883,-1027,1910,-220,-195,-25,397.125,48,884.0,1
0,1,0,536,-386,922,-73,-119,46,477.2,20,-386.0,0
0,1,25,212,-424,636,-413,-170,-243,237.0,29,213.0,1
0,1,0,1399,714,685,-237,-357,120,475.0,15,1401.0,1
0,1,8,444,-905,1349,-106,-165,59,290.0,46,443.0,1
0,1,2,599,622,-23,-206,-184,-22,205.69230769230768,52,591.0,0
0,1,7,524,-443,967,-107,-198,91,245.65,40,-443.0,0
0,1,0,254,-373,627,-485,-691,206,393.11764705882354,17,253.0,1
0,1,0,453,-468,921,-190,-218,28,242.6,40,-503.0,0
0,1,0,1060,-350,1410,-169,-436,267,519.2222222222222,27,1029.0,1
0,1,0,762,-1180,1942,-175,-157,-18,378.94117647058823,51,760.0,1
0,1,0,474,-191,665,-167,-369,202,216.11428571428573,35,476.0,1
0,1,0,1036,-306,1342,-218,-291,73,537.5,26,1039.0,1
0,1,44,1056,431,625,-201,-237,36,190.1875,32,1049.0,1
0,1,2,686,-581,1267,-146,-156,10,260.44,50,-610.0,0
0,1,0,411,160,251,-229,-276,47,219.33333333333334,18,457.0,1
0,1,6,170,-2012,2182,-512,-175,-337,408.07272727272726,55,204.0,1
0,1,60,13,15,-2,-772,-733,-39,195.66666666666666,3,19.0,0
1,1,2,699,-452,1151,-261,-164,-97,265.02222222222224,45,700.0,1
0,1,0,872,-821,1693,-242,-214,-28,438.7435897435897,39,-821.0,0
0,1,0,1046,-355,1401,-133,-256,123,528.8461538461538,26,1016.0,1
0,1,0,1152,1093,59,-200,-219,19,241.1875,32,1151.0,0
0,1,0,1035,-885,1920,-198,-205,7,441.4318181818182,44,1036.0,1
0,1,0,521,-475,996,-232,-138,-94,312.4848484848485,33,-491.0,0
0,1,29,5,-210,215,-688,-478,-210,117.68,25,7.0,1
0,1,0,999,-300,1299,-213,-302,89,519.24,25,998.0,1
0,1,0,603,-520,1123,-295,-275,-20,290.46938775510205,49,594.0,1
0,1,48,831,-732,1563,-255,-167,-88,386.35,40,832.0,1
0,1,4,613,-482,1095,-191,-160,-31,258.9782608695652,46,-518.0,0
0,1,0,914,452,462,-184,-316,132,361.42857142857144,14,933.0,1
0,1,24,3,552,-549,-509,-157,-352,211.19354838709677,31,545.0,0
0,1,0,503,215,288,-196,-234,38,171.16666666666666,18,468.0,1
0,1,0,263,-400,663,-522,-621,99,350.5263157894737,19,254.0,1
0,1,0,527,202,325,-168,-266,98,230.14285714285714,14,529.0,1
0,1,13,172,-993,1165,-214,-118,-96,341.1818181818182,33,-993.0,0
0,1,0,1040,677,363,-190,-229,39,332.3636363636364,11,1037.0,1
0,1,0,1531,539,992,-217,-206,-11,253.53846153846155,39,531.0,0
0,1,0,250,-447,697,-535,-609,74,362.65,20,261.0,1
0,1,27,1022,484,538,-293,-209,-84,215.96296296296296,27,457.0,0
0,1,0,411,-1418,1829,-250,-224,-26,465.075,40,-1418.0,0
0,1,0,906,-553,1459,-277,-203,-74,524.3571428571429,28,-553.0,0
0,1,0,1652,1152,500,-177,-204,27,195.92,25,1152.0,0
0,1,0,943,-67,1010,-148,-295,147,448.8695652173913,23,-67.0,0
0,1,0,1816,888,928,-99,-271,172,427.04545454545456,22,1808.0,1
0,1,0,246,-581,827,-496,-663,167,419.4,20,248.0,1
0,1,0,537,-374,911,-266,-277,11,402.1304347826087,23,-374.0,0
0,1,25,1141,568,573,-177,-177,0,129.82222222222222,45,565.0,0
0,1,27,1855,217,1638,-258,-573,315,252.27848101265823,79,251.0,0
0,1,0,1122,583,539,-171,-262,91,404.7857142857143,14,583.0,0
0,1,0,435,141,294,-154,-230,76,176.4,20,456.0,1
0,1,13,1209,518,691,-141,-124,-17,200.5,34,516.0,0
0,1,0,1049,123,926,-189,-644,455,487.1904761904762,21,123.0,0
0,1,22,552,-482,1034,-184,-143,-41,293.54285714285714,35,545.0,1
0,1,0,1062,473,589,-227,-309,82,391.3125,16,1073.0,1
0,1,3,2081,1059,1022,-215,-228,13,271.6756756756757,37,1059.0,0
0,1,5,431,-485,916,-109,-114,5,259.5405405405405,37,437.0,1
0,1,0,776,-538,1314,-182,-267,85,557.9166666666666,24,777.0,1
0,1,5,1280,687,593,-226,-120,-106,224.26923076923077,26,1275.0,1
0,1,42,935,1270,-335,-198,-48,-150,191.41176470588235,17,1291.0,0
0,1,6,152,521,-369,-305,-183,-122,213.66666666666666,18,528.0,0
0,1,0,556,427,129,-220,-240,20,238.47727272727272,44,558.0,1
0,1,0,755,551,204,-254,-223,-31,257.625,8,551.0,0
0,1,0,970,662,308,-218,-268,50,273.0833333333333,12,662.0,0
0,1,4,222,-217,439,-582,-572,-10,157.53571428571428,28,225.0,1
0,1,2,481,447,34,-210,-182,-28,45.77777777777778,18,482.0,0
0,1,0,787,-839,1626,-162,-194,32,361.0444444444444,45,-839.0,0
0,1,0,459,161,298,-163,-239,76,208.26666666666668,15,441.0,1
0,1,15,1203,479,724,-202,-135,-67,222.8181818181818,33,476.0,0
0,1,0,1845,1178,667,-137,-190,53,262.0769230769231,26,1178.0,0
0,1,0,910,-250,1160,-199,-294,95,495.25,24,911.0,1
0,1,0,203,-452,655,-397,-185,-212,170.575,40,205.0,1
0,1,26,152,1091,-939,-533,-227,-306,214.125,48,1084.0,0
0,1,0,499,431,68,-248,-218,-30,39.42857142857143,7,498.0,0
0,1,0,975,531,444,-256,-129,-127,290.06666666666666,15,977.0,1
0,1,0,1052,573,479,-160,-260,100,393.38461538461536,13,1053.0,1
0,1,0,495,541,-46,-180,-174,-6,70.14285714285714,7,541.0,0
0,1,0,1052,365,687,-243,-353,110,414.2352941176471,17,1046.0,1
1,1,33,1,183,-182,-718,-530,-188,118.14814814814815,27,-0.0,1
1,1,24,496,325,171,-201,-339,138,99.66666666666667,18,497.0,1
1,1,26,951,2181,-1230,-411,-123,-288,385.71875,32,2192.0,0
1,1,19,1800,1342,458,-58,-58,0,121.3157894736842,38,1346.0,0
1,1,0,1058,769,289,-69,-33,-36,125.86363636363636,22,1059.0,1
0,1,13,554,-483,1037,-318,-193,-125,297.52777777777777,36,556.0,1
0,1,27,487,-470,957,-186,-7,-179,227.25581395348837,43,-462.0,0
0,1,10,455,399,56,-260,-195,-65,221.66666666666666,51,457.0,0
0,1,37,1692,250,1442,-355,-584,229,374.875,40,240.0,0
0,1,0,236,-1826,2062,-503,-125,-378,389.9811320754717,53,238.0,1
1,1,13,1373,-614,1987,-195,-126,-69,379.45283018867923,53,-622.0,0
1,1,30,307,494,-187,-331,-122,-209,126.4,15,476.0,0
0,1,0,523,-604,1127,-210,-255,45,334.97058823529414,34,-604.0,0
0,1,0,1078,-832,1910,-207,-251,44,467.780487804878,41,1071.0,1
0,1,3,1389,459,930,-188,-188,0,220.93617021276594,47,428.0,0
0,1,0,228,-439,667,-514,-616,102,428.8125,16,228.0,1
0,1,3,8,-649,657,-250,-114,-136,259.76,25,-649.0,0
0,1,4,416,387,29,-240,-205,-35,63.5,4,387.0,0
0,1,0,492,-1363,1855,-220,-129,-91,411.44444444444446,45,-1363.0,0
0,1,0,555,-254,809,290,14,276,367.4347826086956,23,556.0,1
0,1,4,504,-452,956,-241,-205,-36,257.56756756756755,37,-456.0,0
0,1,1,502,1383,-881,-282,-123,-159,316.55555555555554,27,1365.0,0
0,1,50,51,-166,217,-556,-354,-202,112.3157894736842,19,-176.0,0
0,1,0,718,-242,960,-246,-354,108,295.7647058823529,34,719.0,1
0,1,0,315,-562,877,-197,-118,-79,283.15625,32,-577.0,0
0,1,0,1249,-869,2118,-237,-147,-90,366.20338983050846,59,1251.0,1
0,1,41,1577,1064,513,-196,-184,-12,152.09375,32,1065.0,0
0,1,0,969,170,799,-172,-314,142,474.94444444444446,18,971.0,1
0,1,13,1709,684,1025,-127,-173,46,157.36923076923077,65,684.0,0
0,1,51,455,1007,-552,-186,-113,-73,177.51612903225808,31,458.0,1
0,1,0,880,-202,1082,-154,-275,121,337.6875,32,883.0,1
0,1,0,1043,-1053,2096,-188,-258,70,501.5,42,-1053.0,0
0,1,0,593,508,85,-91,-90,-1,48.29032258064516,31,649.0,1
0,1,34,456,360,96,-285,-332,47,71.21212121212122,33,475.0,1
0,1,0,214,3,211,-511,-509,-2,110.38095238095238,21,230.0,1
0,1,0,2,475,-473,-467,-90,-377,210.33333333333334,27,471.0,0
0,1,0,1176,-93,1269,-223,-618,395,384.9142857142857,35,-93.0,0
0,1,0,187,142,45,-522,-523,1,158.25,4,188.0,0
0,1,21,1251,208,1043,-191,-547,356,317.6,35,192.0,0
0,1,17,767,-1360,2127,-177,-141,-36,380.17857142857144,56,768.0,1
0,1,0,8,151,-143,-468,-473,5,163.77777777777777,9,7.0,1
1,1,88,734,-1178,1912,-198,-69,-129,330.3666666666667,60,736.0,1
1,1,96,447,-778,1225,-80,-164,84,247.33962264150944,53,439.0,1
0,1,24,34,2074,-2040,-785,-181,-604,422.176,125,35.0,1
1,1,78,781,-863,1644,-90,-66,-24,319.25925925925924,54,782.0,1
0,1,66,23,955,-932,-559,-214,-345,186.46031746031747,63,22.0,1
0,1,0,443,414,29,-116,-219,103,62.0,1,441.0,0
0,1,49,696,-893,1589,-235,-183,-52,357.22727272727275,44,-897.0,0
0,1,0,721,349,372,-210,-264,54,334.5833333333333,12,723.0,1
0,1,0,495,488,7,-108,-76,-32,28.545454545454547,11,475.0,0
0,1,11,631,-1287,1918,-210,-111,-99,395.75,48,-1281.0,0
0,1,19,857,-1055,1912,-221,-190,-31,396.9791666666667,48,-1057.0,0
0,1,1,655,-499,1154,-228,-147,-81,207.27777777777777,54,653.0,1
0,1,0,1419,713,706,-238,-176,-62,306.2608695652174,23,1417.0,1
0,1,0,567,481,86,-211,-318,107,329.5,42,565.0,0
0,1,0,41,495,-454,-285,-101,-184,243.05263157894737,19,473.0,0
0,1,0,1457,878,579,-276,-190,-86,202.92857142857142,28,1446.0,1
0,1,0,1822,1506,316,-234,-219,-15,215.46666666666667,15,1816.0,1
0,1,0,610,296,314,-217,-237,20,282.3636363636364,11,581.0,1
0,1,0,565,526,39,-111,-72,-39,33.9,20,593.0,0
0,1,0,933,-1041,1974,-204,-243,39,434.15555555555557,45,934.0,1
0,1,0,283,-237,520,-549,-580,31,217.33333333333334,24,286.0,1
0,1,3,1468,704,764,-178,-131,-47,189.3170731707317,41,696.0,0
0,1,47,730,-439,1169,-226,-195,-31,285.3333333333333,42,718.0,1
0,1,23,595,-9,604,-194,-537,343,239.51724137931035,29,596.0,1
0,1,3,481,852,-371,-257,-206,-51,243.65079365079364,63,483.0,1
1,1,16,869,-855,1724,-229,-251,22,414.9268292682927,41,871.0,1
1,1,49,1173,711,462,-84,-146,62,171.5,26,704.0,0
0,1,39,1236,1968,-732,-237,-176,-61,249.93103448275863,29,1970.0,0
0,1,23,203,1039,-836,-512,-176,-336,319.3103448275862,29,209.0,1
0,1,42,1253,221,1032,-179,-481,302,317.6857142857143,35,190.0,0
0,1,1,354,474,-120,-286,-288,2,72.44444444444444,18,445.0,0
1,1,38,675,530,145,-163,-209,46,113.46153846153847,13,677.0,1
1,1,10,1041,-1179,2220,-188,-249,61,396.10526315789474,57,1037.0,1
0,1,0,1072,518,554,-202,-316,114,382.73333333333335,15,1071.0,1
0,1,0,911,289,622,-180,-247,67,424.8,15,912.0,1
0,1,15,718,-1035,1753,-127,-189,62,398.8863636363636,44,-1030.0,0
0,1,0,883,321,562,-241,-266,25,397.64285714285717,14,874.0,1
0,1,0,1400,526,874,-168,-189,21,286.43333333333334,30,1375.0,1
0,1,33,1309,-2,1311,-302,-754,452,329.7142857142857,42,-2.0,0
0,1,68,497,-602,1099,-253,-168,-85,286.10526315789474,38,-590.0,0
0,1,1,1250,-739,1989,-217,-231,14,400.1,50,1250.0,1
0,1,0,462,-407,869,-214,-215,1,251.28571428571428,35,-389.0,0
0,1,0,892,393,499,-273,-382,109,378.92857142857144,14,895.0,1
0,1,0,1392,522,870,-244,-193,-51,238.94594594594594,37,1395.0,1
0,1,18,668,-1121,1789,-193,-35,-158,341.7647058823529,51,-1134.0,0
0,1,27,764,-1090,1854,-184,-154,-30,425.9767441860465,43,764.0,1
0,1,0,869,373,496,-143,-555,412,412.9375,16,868.0,1
0,1,0,635,-488,1123,-232,-258,26,428.4,45,631.0,1
0,1,24,867,-1095,1962,-126,-175,49,369.18518518518516,54,869.0,1
0,1,0,771,111,660,-125,-256,131,444.3333333333333,15,772.0,1
0,1,55,204,174,30,-478,-459,-19,130.0,28,84.0,0
1,1,13,662,-1009,1671,-194,-156,-38,345.7916666666667,48,661.0,1
1,1,0,472,478,-6,-87,-107,20,63.30769230769231,26,469.0,0
1,1,0,832,242,590,-177,-768,591,405.3157894736842,38,835.0,1
0,1,9,157,-735,892,-495,-233,-262,252.72222222222223,36,-735.0,0
0,1,0,192,-371,563,-561,-571,10,350.47058823529414,17,207.0,1
0,1,30,469,-619,1088,-246,-188,-58,312.2162162162162,37,-643.0,0
0,1,0,816,-902,1718,-193,-203,10,323.0,54,818.0,1
0,1,60,500,-445,945,-200,-148,-52,263.4166666666667,36,-453.0,0
0,1,1,605,-483,1088,-187,-154,-33,251.20454545454547,44,607.0,1
0,1,0,556,249,307,-228,-274,46,140.05,20,558.0,1
0,1,0,891,-155,1046,-167,-597,430,427.5357142857143,28,892.0,1
0,1,0,1394,666,728,-162,-219,57,342.57142857142856,21,1391.0,1
0,1,0,1412,429,983,-132,-165,33,282.88235294117646,34,1442.0,1
0,1,0,1450,515,935,-186,-193,7,279.0,33,515.0,0
0,1,0,764,-128,892,-226,-323,97,488.10526315789474,19,765.0,1
0,1,0,790,192,598,-238,-219,-19,400.8,15,782.0,1
0,1,21,947,-231,1178,-296,-459,163,285.4418604651163,43,-251.0,0
0,1,0,1560,270,1290,-157,-441,284,402.5,34,265.0,0
0,1,0,561,558,3,-181,-244,63,221.62,50,561.0,0
0,1,12,772,289,483,-186,-447,261,230.95833333333334,24,773.0,1
0,1,0,1036,128,908,-209,-313,104,444.2857142857143,21,1036.0,1
0,1,0,834,-127,961,-195,-507,312,428.9583333333333,24,-127.0,0
0,1,0,1582,908,674,-124,-198,74,429.6875,16,1562.0,1
0,1,0,887,404,483,-229,-319,90,424.25,12,885.0,1
0,1,0,1901,1118,783,-171,-118,-53,299.1923076923077,26,1897.0,1
0,1,0,786,365,421,-201,-305,104,358.7692307692308,13,787.0,1
0,1,46,390,312,78,-139,-118,-21,87.36363636363636,11,262.0,0
0,1,0,947,658,289,-260,-240,-20,254.8181818181818,11,911.0,1
0,1,23,418,-493,911,-288,-93,-195,245.54054054054055,37,-485.0,0
0,1,0,942,-528,1470,-202,-316,114,534.9285714285714,28,941.0,1
0,1,2,1204,-14,1218,-184,-781,597,343.71794871794873,39,-14.0,0
0,1,29,293,878,-585,-490,-176,-314,277.72,25,293.0,1
0,1,0,256,565,-309,-497,-244,-253,231.33333333333334,18,257.0,1
0,1,0,559,420,139,-225,-271,46,217.0,7,561.0,1
0,1,1,535,398,137,-73,-121,48,197.02631578947367,38,547.0,1
0,1,0,927,-342,1269,-268,-302,34,394.06060606060606,33,929.0,1
0,1,12,290,1895,-1605,-469,-185,-284,391.2093023255814,43,292.0,1
0,1,0,504,-441,945,59,-42,101,288.02941176470586,34,509.0,1
0,1,30,5,-578,583,-303,72,-375,225.28125,32,8.0,1
0,1,0,1112,505,607,-195,-327,132,388.4117647058824,17,1120.0,1
0,1,1,656,-500,1156,-180,-135,-45,311.5,40,658.0,1
0,1,14,1594,534,1060,-269,-19,-250,325.0,33,511.0,0
0,1,1,1778,1250,528,-126,16,-142,192.53571428571428,28,1778.0,1
0,1,0,649,-445,1094,-185,-184,-1,345.3125,32,650.0,1
1,1,41,1373,586,787,-205,-77,-128,246.6451612903226,31,597.0,0
1,1,47,934,1227,-293,-83,25,-108,131.95454545454547,22,1241.0,0
1,1,28,1388,430,958,-216,-138,-78,221.1627906976744,43,413.0,0
0,1,0,759,-211,970,-194,-262,68,513.95,20,749.0,1
0,1,7,216,-1260,1476,-522,-42,-480,361.2142857142857,42,-1266.0,0
0,1,0,861,475,386,-253,-298,45,323.8333333333333,12,853.0,1
0,1,0,1015,504,511,-210,-213,3,371.2,15,1017.0,1
0,1,0,264,639,-375,-546,-585,39,267.57142857142856,14,260.0,1
0,1,0,1652,966,686,-203,-38,-165,236.58620689655172,29,966.0,0
1,1,22,607,-498,1105,-149,150,-299,274.65909090909093,44,607.0,1
1,1,58,488,-387,875,-107,203,-310,275.2647058823529,34,489.0,1
0,1,0,964,-834,1798,-60,53,-113,526.0588235294117,34,967.0,1
0,1,0,731,418,313,-216,-255,39,198.91176470588235,34,732.0,1
0,1,0,494,26,468,-223,-276,53,304.125,16,496.0,1
0,1,0,455,60,395,-284,-280,-4,303.46153846153845,13,454.0,1
0,1,0,274,-250,524,-495,-514,19,435.61538461538464,13,274.0,1
0,1,3,872,-618,1490,-238,-152,-86,336.29545454545456,44,-618.0,0
0,1,2,154,799,-645,-503,-102,-401,238.89655172413794,29,790.0,0
0,1,0,1172,545,627,-232,-254,22,375.88235294117646,17,1169.0,1
0,1,24,766,-738,1504,-178,-181,3,314.75,48,-738.0,0
0,1,0,956,389,567,-167,-295,128,395.26666666666665,15,954.0,1
0,1,0,474,-612,1086,-231,-122,-109,288.0833333333333,36,474.0,1
0,1,0,905,659,246,-326,-321,-5,221.54545454545453,11,907.0,1
0,1,0,951,306,645,-224,-277,53,410.4375,16,952.0,1
0,1,30,1288,493,795,-167,-161,-6,269.3333333333333,30,486.0,0
0,1,0,937,-744,1681,-242,-282,40,508.2121212121212,33,938.0,1
0,1,36,290,916,-626,-456,-200,-256,234.73333333333332,30,288.0,1
0,1,0,278,656,-378,-467,-253,-214,208.25,20,278.0,1
0,1,0,722,-364,1086,-193,-275,82,281.075,40,-389.0,0
0,1,4,439,-530,969,-232,-112,-120,272.1388888888889,36,-530.0,0
0,1,4,1426,862,564,-165,-157,-8,175.7741935483871,31,862.0,0
0,1,0,850,364,486,-279,-347,68,369.2142857142857,14,852.0,1
0,1,0,891,-921,1812,-170,-236,66,414.52272727272725,44,894.0,1
0,1,2,409,-539,948,-207,-75,-132,272.42857142857144,35,-539.0,0
0,1,0,812,98,714,-172,-340,168,482.9375,16,816.0,1
0,1,6,1468,603,865,-180,-132,-48,236.83333333333334,36,1467.0,1
0,1,0,443,87,356,-252,-280,28,273.6923076923077,13,444.0,1
0,1,0,550,287,263,-224,-298,74,248.63636363636363,11,550.0,1
0,1,0,865,413,452,-218,-300,82,358.38461538461536,13,862.0,1
0,1,0,83,489,-406,-260,-99,-161,243.375,16,485.0,0
0,1,0,1171,381,790,-211,-260,49,456.05555555555554,18,381.0,0
0,1,0,1247,724,523,-225,-183,-42,259.8095238095238,21,1246.0,1
0,1,0,716,-528,1244,-239,-339,100,486.03846153846155,26,716.0,1
0,1,28,224,-1868,2092,-453,-108,-345,438.51020408163265,49,224.0,1
0,1,0,726,-494,1220,-171,-188,17,286.6046511627907,43,727.0,1
0,1,0,1844,1141,703,-258,-147,-111,244.3448275862069,29,1843.0,1
0,1,0,786,794,-8,-152,-134,-18,130.0,1,799.0,0
0,1,0,229,285,-56,-488,-486,-2,47.0,5,230.0,0
0,1,0,649,624,25,-91,114,-205,110.0,2,642.0,0
0,1,0,1711,1388,323,-177,32,-209,141.17391304347825,23,1704.0,1
0,1,4,699,192,507,-170,-495,325,190.46666666666667,30,192.0,0
0,1,0,667,-697,1364,-147,-182,35,335.7560975609756,41,669.0,1
0,1,0,472,-359,831,-196,-105,-91,291.3333333333333,30,-393.0,0
1,1,0,534,-590,1124,-203,32,-235,254.51063829787233,47,536.0,1
1,1,54,383,-448,831,-121,58,-179,300.9655172413793,29,391.0,1
0,1,0,550,726,-176,-295,-57,-238,402.9761904761905,84,-1062.0,1
0,1,0,1005,-367,1372,-179,-253,74,407.7647058823529,34,1008.0,1
0,1,8,963,-432,1395,-167,-204,37,348.075,40,964.0,1
0,1,0,1400,809,591,-173,-73,-100,204.79310344827587,29,809.0,0
0,1,26,1722,1276,446,-142,-38,-104,190.43478260869566,23,1266.0,0
0,1,0,425,335,90,-114,-89,-25,55.588235294117645,17,318.0,0
0,1,11,1128,265,863,-224,-377,153,272.0,32,257.0,0
0,1,0,1064,763,301,-147,-254,107,320.7,10,1062.0,1
0,1,0,681,-524,1205,-235,-138,-97,246.5,48,683.0,1
0,1,10,512,1696,-1184,-146,-192,46,323.57894736842104,38,512.0,1
0,1,0,711,-956,1667,-323,-25,-298,337.55102040816325,49,-956.0,0
0,1,0,574,335,239,-184,-278,94,160.86666666666667,15,521.0,1
0,1,2,601,-424,1025,-369,-162,-207,314.6666666666667,33,603.0,1
0,1,42,526,637,-111,-122,35,-157,85.78947368421052,19,529.0,1
0,1,10,231,243,-12,-498,-368,-130,128.48936170212767,47,231.0,0
0,1,0,1939,1965,-26,-97,66,-163,19.636363636363637,11,1937.0,0
0,1,0,597,233,364,-277,-532,255,328.0,34,599.0,1
0,1,0,776,-591,1367,-205,-128,-77,308.6666666666667,45,778.0,1
1,1,0,543,473,70,-220,-193,-27,73.0909090909091,33,546.0,0
0,1,0,1006,366,640,-215,-304,89,339.15,20,1006.0,1
0,1,0,805,282,523,-246,-184,-62,371.0,15,799.0,1
0,1,0,760,-522,1282,-213,-86,-127,264.9166666666667,48,761.0,1
0,1,0,646,1720,-1074,-195,-44,-151,334.0,32,657.0,1
0,1,85,350,200,150,-481,-488,7,143.2,10,199.0,0
0,1,5,739,202,537,-193,-464,271,238.5,26,729.0,1
0,1,0,1818,1075,743,-168,-119,-49,237.26666666666668,30,1815.0,1
0,1,14,176,-480,656,-267,-226,-41,281.04347826086956,23,-486.0,0
1,1,0,382,-438,820,-301,-60,-241,231.63888888888889,36,381.0,1
1,1,32,230,-206,436,-584,-376,-208,170.08333333333334,24,226.0,1
0,1,0,2204,1786,418,-146,-100,-46,330.6923076923077,13,2202.0,1
0,1,71,565,-1281,1846,-235,-59,-176,372.3469387755102,49,-1295.0,0
0,1,3,375,-418,793,-215,22,-237,252.7741935483871,31,338.0,1
0,1,0,463,-486,949,-95,-217,122,278.74285714285713,35,463.0,1
0,1,50,258,-1550,1808,-546,-205,-341,441.26190476190476,42,-1556.0,0
0,1,0,566,-390,956,-28,-193,165,272.3142857142857,35,562.0,1
0,1,0,1364,443,921,-192,-156,-36,230.10256410256412,39,443.0,0
0,1,0,1267,710,557,-167,-241,74,349.1875,16,1268.0,1
0,1,9,711,-1359,2070,-170,-101,-69,377.8333333333333,54,-1359.0,0
0,1,0,573,1773,-1200,-203,-196,-7,320.3783783783784,37,591.0,1
0,1,11,1046,-913,1959,282,-37,319,328.79661016949154,59,-913.0,0
0,1,0,864,566,298,-154,-144,-10,82.75757575757575,33,604.0,0
0,1,0,1182,227,955,-274,-292,18,344.0,29,187.0,0
0,1,0,975,567,408,-211,-299,88,351.4166666666667,12,976.0,1
0,1,0,234,-339,573,-576,-629,53,427.07142857142856,14,235.0,1
0,1,80,1925,1618,307,-98,-123,25,128.25925925925927,27,1614.0,0
0,1,0,2257,1358,899,-197,-100,-97,227.0,46,2333.0,1
0,1,0,645,-491,1136,-93,-131,38,299.7894736842105,38,634.0,1
0,1,0,278,-521,799,-497,-573,76,456.5,18,276.0,1
0,1,0,1584,627,957,-228,-130,-98,278.14285714285717,35,592.0,0
0,1,0,580,1815,-1235,-166,-195,29,302.390243902439,41,583.0,1
0,1,0,1653,1154,499,-282,-199,-83,291.1111111111111,18,1655.0,1
0,1,43,206,-224,430,-552,-401,-151,169.35714285714286,28,207.0,1
0,1,0,1272,504,768,-158,-300,142,437.0,18,1273.0,1
0,1,0,788,-609,1397,-167,-166,-1,426.57575757575756,33,-609.0,0
0,1,7,545,-279,824,-185,-426,241,267.3125,32,547.0,1
0,1,0,523,560,-37,-206,-162,-44,126.28571428571429,35,524.0,0
0,1,0,317,-536,853,-575,-552,-23,495.88235294117646,17,316.0,1
0,1,0,254,-459,713,-471,-299,-172,338.5217391304348,23,251.0,1
0,1,11,1135,491,644,-228,-180,-48,201.25,32,1127.0,1
0,1,37,1805,1963,-158,-127,-12,-115,87.5,16,1971.0,0
0,1,0,1316,474,842,-225,-306,81,462.22222222222223,18,1315.0,1
1,1,26,1396,579,817,-111,-141,30,214.25641025641025,39,580.0,0
1,1,18,2018,551,1467,-197,-135,-62,319.5869565217391,46,547.0,0
0,1,0,182,-661,843,-365,-248,-117,329.1698113207547,53,-1110.0,1
0,1,0,1065,560,505,-111,-328,217,398.38461538461536,13,1062.0,1
0,1,25,670,-625,1295,-260,-142,-118,435.3333333333333,30,-627.0,0
0,1,0,1062,300,762,-204,-242,38,311.04,25,1014.0,1
0,1,7,1174,436,738,-239,-153,-86,308.0833333333333,24,431.0,0
0,1,0,1567,972,595,-221,-223,2,225.64,25,972.0,0
0,1,0,752,230,522,-236,-281,45,443.5,12,753.0,1
0,1,0,536,532,4,-254,-244,-10,279.125,48,536.0,0
0,1,0,755,-188,943,-205,-147,-58,470.45,20,756.0,1
0,1,9,256,-267,523,-502,-498,-4,124.04761904761905,42,257.0,1
0,1,25,896,-1275,2171,-211,-137,-74,426.88235294117646,51,889.0,1
0,1,29,249,-864,1113,-495,-159,-336,238.22448979591837,49,249.0,1
0,1,0,546,-410,956,-193,-230,37,285.70588235294116,34,544.0,1
0,1,0,456,-477,933,-113,-221,108,267.13513513513516,37,452.0,1
0,1,0,798,340,458,-173,-325,152,371.3076923076923,13,801.0,1
0,1,0,448,-429,877,-166,-133,-33,268.7352941176471,34,446.0,1
0,1,0,1607,890,717,-140,-103,-37,268.65384615384613,26,1611.0,1
0,1,22,1260,1127,133,-196,-110,-86,91.625,16,1260.0,1
0,1,6,222,-217,439,-580,-440,-140,138.23333333333332,30,222.0,1
0,1,0,266,340,-74,-256,-232,-24,313.375,56,-576.0,1
0,1,38,524,-1328,1852,-257,-73,-184,426.24444444444447,45,525.0,1
0,1,0,622,-478,1100,-303,-225,-78,314.34285714285716,35,609.0,1
0,1,0,617,-421,1038,-285,-251,-34,314.3636363636364,33,609.0,1
0,1,0,509,-436,945,-182,-204,22,294.6969696969697,33,-436.0,0
0,1,0,745,81,664,-201,-310,109,420.8125,16,746.0,1
0,1,0,570,-357,927,-229,-185,-44,301.7741935483871,31,571.0,1
0,1,0,500,-550,1050,-182,-83,-99,275.25,40,-631.0,0
0,1,3,477,-648,1125,-197,-138,-59,257.15909090909093,44,484.0,1
0,1,1,416,287,129,-220,-251,31,221.1315789473684,38,423.0,1
0,1,0,1354,367,987,-237,-314,77,498.05,20,1354.0,1
0,1,31,151,-264,415,-536,-487,-49,213.94444444444446,18,-246.0,0
0,1,0,743,286,457,-231,-276,45,342.92857142857144,14,745.0,1
0,1,0,462,463,-1,-182,218,-400,165.0,1,461.0,0
0,1,41,1325,1857,-532,-221,257,-478,253.15,20,1847.0,0
0,1,48,735,-795,1530,-178,-172,-6,307.06,50,-800.0,0
0,1,0,490,468,22,-183,-197,14,218.27272727272728,33,489.0,0
0,1,8,779,-851,1630,-193,-189,-4,351.1304347826087,46,-851.0,0
0,1,0,829,-504,1333,-219,-285,66,391.1764705882353,34,830.0,1
0,1,0,316,353,-37,-510,-114,-396,81.0,3,317.0,0
0,1,0,786,-873,1659,-165,193,-358,366.9111111111111,45,-873.0,0
0,1,0,2018,2006,12,-77,330,-407,77.66666666666667,3,2005.0,0
0,1,0,433,416,17,-106,314,-420,184.5,2,419.0,0
0,1,32,157,231,-74,-407,-376,-31,62.583333333333336,12,154.0,0
0,1,0,1070,628,442,-208,-298,90,388.3333333333333,12,1074.0,1
0,1,25,1038,269,769,-448,-436,-12,248.9,30,263.0,0
0,1,0,569,-521,1090,-169,-226,57,275.325,40,557.0,1
0,1,18,21,191,-170,-698,-492,-206,147.23529411764707,17,23.0,1
0,1,0,562,-484,1046,-150,-145,-5,315.6875,32,564.0,1
0,1,0,1410,657,753,-175,-191,16,261.0689655172414,29,1409.0,1
0,1,8,484,495,-11,-246,-262,16,232.53333333333333,45,-34.0,1
0,1,2,753,707,46,-178,-171,-7,47.04,25,762.0,0
0,1,7,706,-649,1355,-253,-235,-18,321.0,42,-649.0,0
0,1,0,571,142,429,-228,-300,72,212.8181818181818,22,573.0,1
0,1,17,8,-562,570,-503,-145,-358,272.5416666666667,24,9.0,1
0,1,0,1534,239,1295,-259,-436,177,302.65909090909093,44,233.0,0
0,1,6,1151,502,649,-185,-157,-28,204.41935483870967,31,1154.0,1
0,1,0,539,-252,791,-197,-258,61,362.27272727272725,22,539.0,1
0,1,38,902,-1076,1978,-179,-84,-95,340.47457627118644,59,-1091.0,0
0,1,0,485,442,43,-246,-239,-7,46.6,5,487.0,0
0,1,0,1637,1008,629,-169,-35,-134,251.36,25,1635.0,1
0,1,0,877,753,124,-158,-210,52,95.5,10,860.0,1
0,1,41,578,-1136,1714,-252,-207,-45,374.6222222222222,45,-1128.0,0
0,1,0,761,-258,1019,-242,-185,-57,505.0,20,756.0,1
0,1,0,762,-12,774,-207,-277,70,417.7368421052632,19,763.0,1
0,1,0,571,-23,594,-316,-488,172,238.32142857142858,28,-48.0,0
0,1,35,356,2271,-1915,-282,-163,-119,459.3414634146341,41,2265.0,0
0,1,18,772,-920,1692,-240,-139,-101,331.6078431372549,51,-918.0,0
0,1,55,1988,472,1516,-203,-177,-26,312.8125,48,471.0,0
0,1,0,948,726,222,-161,-147,-14,201.45454545454547,11,949.0,1
0,1,0,563,532,31,-167,-187,20,100.33333333333333,3,563.0,0
0,1,49,1052,2255,-1203,-338,-155,-183,410.9310344827586,29,2264.0,0
0,1,18,870,-1075,1945,-197,-215,18,322.0163934426229,61,-1087.0,0
0,1,18,301,257,44,-513,-500,-13,98.60975609756098,41,303.0,0
0,1,0,999,147,852,-235,-543,308,383.7391304347826,23,147.0,0
0,1,0,761,-174,935,-260,-322,62,463.6190476190476,21,760.0,1
0,1,62,580,1233,-653,-310,-146,-164,269.7391304347826,23,1231.0,0
0,1,23,652,-1189,1841,-261,-169,-92,353.5192307692308,52,-1188.0,0
0,1,0,1087,-1204,2291,-242,-251,9,433.4339622641509,53,1089.0,1
0,1,0,749,-727,1476,-182,-215,33,371.8974358974359,39,748.0,1
0,1,2,631,-708,1339,-207,-233,26,364.44444444444446,36,634.0,1
0,1,44,554,-1142,1696,-275,-142,-133,354.0,47,-1143.0,0
0,1,0,292,335,-43,-103,-70,-33,40.34615384615385,26,301.0,0
0,1,0,374,-270,644,-233,-88,-145,363.6666666666667,21,372.0,1
0,1,0,837,595,242,-235,-256,21,366.14285714285717,7,595.0,0
0,1,1,570,-497,1067,-257,-197,-60,317.09090909090907,33,570.0,1
0,1,0,1946,1364,582,-235,-237,2,270.04761904761904,21,1933.0,1
0,1,12,553,-771,1324,-217,-128,-89,283.6666666666667,48,-780.0,0
1,1,29,2015,-1495,3510,-119,-136,17,506.4782608695652,69,2018.0,1
1,1,20,174,-2176,2350,-453,-228,-225,405.2068965517241,58,175.0,1
0,1,0,585,-534,1119,-208,-212,4,279.95,40,-534.0,0
0,1,0,695,697,-2,-52,295,-347,124.5,2,694.0,0
0,1,32,552,2294,-1742,-321,144,-465,386.55555555555554,45,2305.0,0
0,1,0,770,665,105,-219,-247,28,207.4,35,358.0,1
0,1,0,738,-696,1434,-106,-218,112,415.0857142857143,35,740.0,1
0,1,0,882,-45,927,-247,-383,136,465.2857142857143,21,904.0,1
0,1,0,675,-386,1061,-256,-204,-52,283.5128205128205,39,-409.0,0
0,1,0,1367,1451,-84,-180,-11,-169,199.2,5,1385.0,0
0,1,0,274,207,67,-509,-397,-112,174.25,4,275.0,0
0,1,0,858,805,53,-93,57,-150,152.0,5,858.0,0
0,1,0,945,1073,-128,-191,-129,-62,111.44444444444444,9,976.0,0
1,1,0,952,1504,-552,-62,-25,-37,186.93103448275863,29,950.0,1
1,1,0,1503,247,1256,-153,-442,289,260.4583333333333,48,1484.0,1
0,1,0,633,-632,1265,-184,-177,-7,320.38461538461536,39,-622.0,0
0,1,0,1137,-245,1382,-217,-267,50,506.0357142857143,28,1133.0,1
0,1,21,674,-797,1471,-250,-152,-98,345.2093023255814,43,675.0,1
0,1,68,304,501,-197,-314,-57,-257,167.1875,16,544.0,0
0,1,29,577,-832,1409,-257,-97,-160,326.3488372093023,43,578.0,1
0,1,0,1169,-16,1185,-135,-217,82,498.75,24,1164.0,1
0,1,24,702,-641,1343,-192,-217,25,315.6511627906977,43,703.0,1
0,1,25,886,-1180,2066,-241,-237,-4,428.3541666666667,48,887.0,1
0,1,0,1264,10,1254,-277,-617,340,271.6666666666667,48,10.0,0
0,1,0,1254,147,1107,-191,-337,146,495.6521739130435,23,1253.0,1
1,1,67,270,198,72,-423,-428,5,80.8,25,316.0,1
1,1,78,333,524,-191,-360,-128,-232,105.72,25,568.0,0
0,1,0,1363,20,1343,-154,-658,504,344.22727272727275,44,-6.0,0
0,1,0,815,-563,1378,-254,-254,0,558.96,25,818.0,1
1,1,0,1008,1162,-154,-289,-142,-147,68.20833333333333,24,1177.0,0
1,1,57,590,1035,-445,-133,14,-147,172.34615384615384,26,1033.0,0
0,1,0,844,-914,1758,-203,-161,-42,362.8541666666667,48,843.0,1
0,1,0,988,623,365,-224,-658,434,448.4310344827586,58,990.0,1
0,1,24,268,-571,839,-584,-272,-312,297.7,30,269.0,1
0,1,0,314,-92,406,-459,-406,-53,244.8125,16,297.0,1
0,1,0,1184,463,721,-222,-313,91,416.3888888888889,18,463.0,0
0,1,0,457,483,-26,-113,-98,-15,81.0,3,459.0,0
0,1,0,851,841,10,-201,-153,-48,138.0,1,849.0,0
0,1,0,6,19,-13,-475,-411,-64,82.66666666666667,3,6.0,0
0,1,0,1191,374,817,-182,-191,9,247.24242424242425,33,1185.0,1
0,1,0,1163,-164,1327,-205,-320,115,565.0416666666666,24,1156.0,1
0,1,0,375,28,347,-397,-383,-14,161.85714285714286,21,310.0,1
0,1,5,1034,-1226,2260,-191,-169,-22,456.54,50,1035.0,1
0,1,0,493,493,0,-65,-81,16,61.0,2,491.0,0
0,1,0,1097,273,824,-183,-267,84,457.2105263157895,19,1094.0,1
0,1,0,891,1,890,-230,-274,44,508.6111111111111,18,888.0,1
0,1,0,481,506,-25,-103,-39,-64,42.375,8,480.0,0
0,1,0,1515,600,915,-216,-150,-66,274.57575757575756,33,600.0,0
0,1,0,758,198,560,-187,-307,120,383.73333333333335,15,757.0,1
0,1,0,477,-446,923,-184,-162,-22,268.25,36,478.0,1
0,1,37,485,-506,991,-93,-141,48,297.0,35,487.0,1
0,1,0,974,663,311,-243,-260,17,286.3636363636364,11,963.0,1
0,1,1,1317,-1002,2319,-196,-108,-88,436.79245283018867,53,1318.0,1
0,1,0,318,158,160,-443,-415,-28,149.3,10,313.0,1
0,1,29,277,-344,621,-516,-480,-36,154.31764705882352,85,269.0,1
0,1,0,839,372,467,-77,-320,243,284.6666666666667,18,841.0,1
1,1,54,484,-468,952,-118,-136,18,283.37142857142857,35,485.0,1
1,1,58,1156,389,767,-255,-212,-43,223.35294117647058,34,1156.0,1
0,1,0,1928,1368,560,-219,-245,26,302.05263157894734,19,1929.0,1
0,1,32,421,-542,963,-184,-151,-33,294.45454545454544,33,-534.0,0
0,1,27,250,-580,830,-511,-226,-285,289.741935483871,31,251.0,1
0,1,0,38,-162,200,-664,-471,-193,90.92592592592592,27,38.0,1
0,1,0,1255,-983,2238,-229,-193,-36,387.7758620689655,58,1250.0,1
0,1,9,745,-28,773,-215,-650,435,242.19444444444446,36,746.0,1
0,1,0,269,-730,999,-493,-255,-238,407.11538461538464,26,270.0,1
0,1,8,547,-539,1086,-58,-75,17,252.38095238095238,42,517.0,1
0,1,0,1424,-266,1690,-254,-505,251,346.4901960784314,51,-314.0,0
0,1,23,502,-543,1045,-170,-101,-69,286.81081081081084,37,499.0,1
0,1,4,882,-505,1387,-203,-178,-25,299.8909090909091,55,878.0,1
0,1,0,920,339,581,-223,-343,120,380.3125,16,921.0,1
0,1,0,945,304,641,-209,-407,198,292.7291666666667,48,947.0,1
0,1,0,334,-266,600,-513,-704,191,374.29411764705884,17,329.0,1
0,1,0,269,-110,379,-569,-743,174,325.7142857142857,14,279.0,1
0,1,1,454,-491,945,-130,-116,-14,245.5609756097561,41,456.0,1
0,1,61,519,-476,995,-160,-132,-28,263.3421052631579,38,520.0,1
0,1,13,1173,720,453,-228,-158,-70,188.41666666666666,24,705.0,0
0,1,0,858,318,540,-157,-275,118,384.73333333333335,15,857.0,1
0,1,7,499,-572,1071,-186,1,-187,281.1025641025641,39,-586.0,0
0,1,17,241,-295,536,-477,-524,47,188.75757575757575,33,242.0,1
1,1,11,1434,1134,300,-135,-90,-45,112.96428571428571,28,1135.0,0
1,1,16,1111,1417,-306,-77,-153,76,128.52,25,1430.0,0
0,1,0,832,-692,1524,-175,-213,38,420.8611111111111,36,833.0,1
0,1,0,3,-158,161,-500,-488,-12,147.1818181818182,11,-158.0,0
0,1,0,8,-188,196,-480,-469,-11,182.8181818181818,11,9.0,1
0,1,0,5,-52,57,-444,-449,5,106.4,5,3.0,0
0,1,0,3,-65,68,-496,-496,0,116.16666666666667,6,4.0,0
0,1,0,700,-58,758,-238,-256,18,466.11764705882354,17,701.0,1
0,1,0,1137,39,1098,135,-260,395,592.3157894736842,19,39.0,0
0,1,7,385,400,-15,-245,-199,-46,162.62222222222223,45,27.0,1
1,1,39,529,699,-170,-165,-45,-120,72.44827586206897,29,695.0,0
1,1,18,5,-1573,1578,-728,-136,-592,312.88461538461536,52,-1571.0,0
1,1,29,1442,899,543,-155,-81,-74,144.35897435897436,39,883.0,0
1,1,32,429,1279,-850,-110,-122,12,230.1578947368421,38,1285.0,0
1,1,26,686,2178,-1492,-121,-55,-66,337.84090909090907,44,2178.0,0
0,1,0,679,350,329,-230,-336,106,195.3181818181818,22,678.0,1
0,1,0,1286,670,616,-250,-260,10,221.0,27,1286.0,1
0,1,0,845,-750,1595,-226,-180,-46,454.9428571428571,35,-750.0,0
0,1,0,868,-687,1555,-242,-209,-33,442.9428571428571,35,870.0,1
0,1,0,1076,496,580,-184,-214,30,278.0,21,496.0,0
0,1,0,987,402,585,-234,-299,65,386.0625,16,984.0,1
0,1,11,1379,933,446,-71,-81,10,131.3939393939394,33,1375.0,1
0,1,1,580,346,234,-213,-363,150,113.4090909090909,22,548.0,1
0,1,27,228,890,-662,-452,-228,-224,221.28125,32,899.0,0
0,1,7,767,-634,1401,-276,-294,18,304.8510638297872,47,775.0,1
0,1,2,2,201,-199,-705,-474,-231,123.2,20,201.0,0
0,1,0,368,-931,1299,-274,-298,24,355.69444444444446,36,-931.0,0
0,1,3,673,-444,1117,-216,-212,-4,274.0487804878049,41,659.0,1
0,1,0,1045,671,374,-213,-279,66,304.0769230769231,13,1046.0,1
0,1,0,776,290,486,-195,-275,80,264.56666666666666,30,772.0,1
0,1,22,329,1917,-1588,-349,-200,-149,341.17391304347825,46,1912.0,0
0,1,0,461,612,-151,-228,-272,44,191.8421052631579,38,898.0,1
0,1,0,866,639,227,-159,-197,38,136.0,16,865.0,1
0,1,0,251,486,-235,-497,-545,48,193.0,13,240.0,1
0,1,2,20,268,-248,-747,-410,-337,202.21052631578948,19,19.0,1
0,1,20,18,199,-181,-739,-394,-345,122.85714285714286,42,301.0,1
0,1,49,1491,1336,155,-154,-92,-62,91.58823529411765,17,1478.0,1
0,1,0,776,618,158,-198,-269,71,223.75,8,778.0,1
0,1,29,18,600,-582,-486,-199,-287,248.11111111111111,27,17.0,1
0,1,1,430,-357,787,-219,-361,142,264.03333333333336,30,430.0,1
0,1,0,1028,279,749,-231,-318,87,483.5625,16,279.0,0
0,1,0,1221,420,801,-271,-633,362,635.5,14,420.0,0
0,1,0,2023,1476,547,-185,-263,78,333.1764705882353,17,2016.0,1
0,1,0,1019,-285,1304,-226,-335,109,353.84722222222223,72,1022.0,1
0,1,0,1588,626,962,-191,-182,-9,215.90697674418604,43,626.0,0
0,1,0,257,-2173,2430,-506,-182,-324,403.21311475409834,61,259.0,1
0,1,2,562,313,249,-213,-398,185,184.375,16,313.0,0
0,1,7,1411,734,677,-71,-26,-45,157.5952380952381,42,1405.0,1
0,1,0,865,683,182,-225,-256,31,148.46153846153845,13,866.0,1
0,1,0,291,-1745,2036,-491,-292,-199,480.5348837209302,43,293.0,1
0,1,41,936,-853,1789,-270,-182,-88,329.7962962962963,54,938.0,1
0,1,0,726,562,164,-243,-273,30,106.86666666666666,15,564.0,0
0,1,25,1006,-1391,2397,-249,-204,-45,392.0655737704918,61,1008.0,1
0,1,1,1336,420,916,-178,-179,1,169.51785714285714,56,419.0,0
0,1,0,1247,806,441,-189,-291,102,346.15384615384613,13,1247.0,1
0,1,0,1028,31,997,-204,-583,379,340.9756097560976,41,1029.0,1
0,1,0,1348,885,463,-192,-220,28,242.8421052631579,19,1349.0,1
0,1,0,754,540,214,-154,-160,6,95.9,20,754.0,1
0,1,0,1467,-363,1830,-170,-271,101,512.2777777777778,36,1462.0,1
0,1,3,748,442,306,-203,-403,200,162.23809523809524,21,731.0,1
0,1,0,770,-1218,1988,-227,-243,16,299.6818181818182,66,-1218.0,0
0,1,1,1336,454,882,-173,-165,-8,226.23076923076923,39,454.0,0
0,1,18,1161,246,915,-283,-437,154,184.34920634920636,63,129.0,1
0,1,15,719,-1286,2005,-193,-182,-11,314.26984126984127,63,-1286.0,0
0,1,0,983,-1077,2060,-284,-211,-73,362.0,57,986.0,1
0,1,0,895,-385,1280,208,36,172,430.1875,32,941.0,1
0,1,0,242,203,39,-510,-503,-7,215.6125,80,241.0,0
0,1,0,688,481,207,-241,-294,53,225.46153846153845,26,682.0,1
0,1,10,752,-922,1674,-250,-169,-81,324.47058823529414,51,-925.0,0
0,1,0,1287,851,436,-229,-242,13,301.2142857142857,14,1268.0,1
0,1,0,1347,600,747,-207,-207,0,300.0,25,1347.0,1
0,1,1,452,467,-15,-164,-175,11,56.5,2,467.0,0
0,1,6,1093,772,321,-185,-193,8,111.41176470588235,34,1141.0,1
0,1,0,468,-476,944,-242,-236,-6,455.4761904761905,21,-476.0,0
0,1,0,676,-702,1378,-194,-224,30,313.8863636363636,44,677.0,1
0,1,0,776,-1495,2271,-203,-311,108,431.33962264150944,53,773.0,1
0,1,0,236,-307,543,-464,-453,-11,223.08,25,-307.0,0
0,1,0,744,-1405,2149,-200,-332,132,431.18,50,743.0,1
0,1,6,709,413,296,-195,-325,130,202.625,16,712.0,1
0,1,0,649,-403,1052,-271,-196,-75,313.29411764705884,34,651.0,1
0,1,0,727,776,-49,-262,-325,63,127.91304347826087,23,728.0,0
0,1,0,794,-584,1378,-152,85,-237,309.60869565217394,46,797.0,1
0,1,0,340,-657,997,-291,-214,-77,261.60526315789474,38,-657.0,0
0,1,0,1730,836,894,-227,-199,-28,267.6060606060606,33,1729.0,1
0,1,1,871,-1352,2223,-174,-199,25,329.2647058823529,68,-1352.0,0
0,1,1,403,410,-7,-113,-109,-4,47.333333333333336,3,412.0,0
0,1,0,252,-572,824,-477,-37,-440,266.4375,32,249.0,1
0,1,0,455,148,307,-190,-159,-31,263.5,12,452.0,1
0,1,0,234,-747,981,-610,-505,-105,430.1666666666667,24,233.0,1
0,1,0,543,-234,777,-236,-311,75,403.3,20,544.0,1
0,1,0,3,185,-182,-460,-468,8,132.53846153846155,13,15.0,1
0,1,24,1831,429,1402,-262,-168,-94,319.3181818181818,44,429.0,0
0,1,14,679,-526,1205,-238,-219,-19,272.8888888888889,45,680.0,1
0,1,0,1079,343,736,-236,-401,165,396.42105263157896,19,1077.0,1
0,1,0,1361,398,963,-218,-313,95,392.16,25,398.0,0
0,1,44,603,-470,1073,-266,-182,-84,273.4102564102564,39,-464.0,0
0,1,0,1086,756,330,-251,-280,29,274.8333333333333,12,1066.0,1
0,1,0,272,-520,792,-614,-619,5,394.0,20,268.0,1
0,1,0,720,-439,1159,-239,-222,-17,282.780487804878,41,720.0,1
0,1,9,545,-328,873,-216,-153,-63,281.38709677419354,31,542.0,1
0,1,33,179,-478,657,-274,-118,-156,315.85,20,-455.0,0
0,1,0,1162,882,280,-226,-201,-25,154.72222222222223,18,1151.0,1
0,1,39,1025,895,130,-31,-58,27,79.8125,16,1028.0,1
0,1,0,1125,519,606,-206,-362,156,395.9375,16,1103.0,1
0,1,0,181,-501,682,-498,-228,-270,260.8,30,202.0,1
0,1,46,586,-510,1096,-246,-172,-74,286.36842105263156,38,587.0,1
0,1,0,1002,615,387,-178,-195,17,320.1666666666667,12,997.0,1
0,1,0,12,-262,274,-735,-505,-230,185.16666666666666,18,10.0,1
0,1,0,1270,900,370,-173,-295,122,337.1666666666667,12,900.0,0
0,1,2,1092,537,555,-247,-246,-1,200.5185185185185,27,1084.0,1
0,1,0,16,-433,449,-603,-648,45,659.1428571428571,7,-433.0,0
0,1,0,10,122,-112,-469,-469,0,129.88888888888889,9,9.0,1
0,1,13,1047,-785,1832,-160,-179,19,436.45238095238096,42,1050.0,1
0,1,59,664,-498,1162,-239,-157,-82,321.5945945945946,37,-506.0,0
0,1,35,99,1337,-1238,-680,-167,-513,371.5,38,1343.0,0
0,1,0,445,355,90,-195,-253,58,161.0,24,445.0,0
0,1,0,219,-463,682,-432,-154,-278,274.77777777777777,27,-463.0,0
0,1,12,315,-583,898,-487,-180,-307,255.39473684210526,38,-585.0,0
0,1,6,217,-229,446,-514,-495,-19,203.27272727272728,22,-235.0,0
0,1,61,674,-694,1368,-239,-107,-132,335.0,41,-690.0,0
0,1,0,1448,1393,55,-141,-143,2,99.4,5,1442.0,0
0,1,0,482,275,207,-238,-296,58,242.0,10,483.0,1
0,1,0,1486,546,940,-239,-244,5,337.0,28,1484.0,1
0,1,76,129,214,-85,-512,-433,-79,89.75,8,206.0,0
0,1,0,1508,905,603,-180,-181,1,271.77272727272725,22,905.0,0
0,1,0,840,384,456,-177,-282,105,321.2,15,842.0,1
0,1,0,811,-816,1627,-260,-234,-26,432.8421052631579,38,809.0,1
0,1,42,539,-472,1011,-204,-229,25,296.1764705882353,34,-479.0,0
0,1,9,270,-484,754,-391,-162,-229,271.7,30,-483.0,0
0,1,41,1019,1470,-451,-255,-119,-136,225.55,20,1469.0,0
1,1,39,180,1139,-959,-564,-104,-460,288.4594594594595,37,179.0,1
1,1,40,602,1314,-712,-90,-118,28,219.0909090909091,33,601.0,1
1,1,29,405,1528,-1123,-210,-229,19,242.2391304347826,46,405.0,1
1,1,43,136,-263,399,-579,-576,-3,126.2258064516129,31,137.0,1
0,1,0,284,-308,592,-513,-549,36,400.6,15,283.0,1
0,1,0,734,275,459,-209,-290,81,332.07142857142856,14,732.0,1
0,1,0,980,401,579,-242,-377,135,408.0,15,980.0,1
0,1,12,1303,467,836,-329,-68,-261,229.75675675675674,37,1293.0,1
0,1,66,39,-189,228,-590,-422,-168,157.26666666666668,15,-195.0,0
0,1,0,699,495,204,-160,-223,63,258.0,9,699.0,1
0,1,35,508,-738,1246,-293,-42,-251,427.9,30,-743.0,0
0,1,0,1511,-752,2263,-127,-601,474,654.6111111111111,36,1506.0,1
1,1,0,944,624,320,-135,-158,23,118.46153846153847,26,945.0,1
0,1,22,6,1,5,-743,-750,7,135.5,14,2.0,0
1,1,35,720,-889,1609,-167,-172,5,271.68333333333334,60,-898.0,0
0,1,23,1126,857,269,-237,-142,-95,176.76923076923077,26,761.0,0
0,1,0,966,205,761,-130,-311,181,431.1111111111111,18,953.0,1
0,1,0,767,116,651,-257,-316,59,372.27777777777777,18,116.0,0
0,1,6,777,-886,1663,-249,-157,-92,288.9193548387097,62,777.0,1
0,1,70,747,-602,1349,-108,-254,146,384.6388888888889,36,745.0,1
0,1,0,1263,781,482,-283,-278,-5,219.54545454545453,22,781.0,0
0,1,0,660,-923,1583,-246,-218,-28,340.7659574468085,47,-923.0,0
0,1,0,68,-343,411,-291,-239,-52,567.0,7,-343.0,0
0,1,0,297,-312,609,-609,-618,9,371.3529411764706,17,-312.0,0
0,1,0,969,509,460,-228,-343,115,360.35714285714283,14,970.0,1
0,1,0,1107,-690,1797,-231,-69,-162,350.0769230769231,52,-690.0,0
0,1,52,876,961,-85,-179,-149,-30,270.95348837209303,43,890.0,0
0,1,0,767,35,732,-195,-267,72,449.47058823529414,17,769.0,1
1,1,15,431,-192,623,-109,-430,321,234.03333333333333,30,430.0,1
1,1,7,737,-415,1152,-226,-71,-155,401.06666666666666,30,738.0,1
1,1,19,7,-494,501,-461,-112,-349,226.07692307692307,26,-3.0,1
0,1,0,536,-488,1024,-180,-187,7,277.8918918918919,37,538.0,1
0,1,0,468,-674,1142,-259,-146,-113,275.0,41,467.0,1
0,1,0,310,-669,979,-488,-131,-357,398.3,50,311.0,1
0,1,0,845,193,652,-269,-454,185,476.73333333333335,15,846.0,1
0,1,12,123,479,-356,-396,-183,-213,237.58823529411765,17,485.0,0
0,1,0,599,-1122,1721,-243,-159,-84,425.175,40,-1122.0,0
0,1,22,864,-764,1628,-267,-197,-70,374.13953488372096,43,-764.0,0
0,1,0,848,270,578,-263,-300,37,396.06666666666666,15,847.0,1
0,1,0,764,-1231,1995,-229,-101,-128,361.43636363636364,55,-1231.0,0
0,1,0,890,470,420,-191,-569,378,409.35714285714283,14,893.0,1
0,1,18,262,234,28,-535,-475,-60,168.57142857142858,28,257.0,0
0,1,3,423,-409,832,-242,-201,-41,257.25,32,419.0,1
0,1,58,266,-1536,1802,-496,-192,-304,467.075,40,265.0,1
0,1,10,687,-541,1228,-262,-155,-107,378.21875,32,-539.0,0
0,1,21,195,534,-339,-484,-144,-340,180.77272727272728,22,525.0,0
0,1,3,551,534,17,-205,-147,-58,47.5,2,554.0,0
0,1,4,729,-470,1199,-264,-171,-93,310.2631578947368,38,732.0,1
0,1,0,590,-1,591,-233,-481,248,258.8,25,588.0,1
0,1,2,519,-340,859,-229,-194,-35,313.4074074074074,27,523.0,1
0,1,49,541,-3,544,-207,-454,247,236.48,25,527.0,1
0,1,0,785,-42,827,-162,-277,115,438.7894736842105,19,785.0,1
0,1,0,725,-318,1043,-214,-212,-2,365.2068965517241,29,717.0,1
0,1,0,897,-740,1637,-175,-150,-25,401.5365853658537,41,898.0,1
0,1,0,713,-600,1313,-209,-237,28,387.3529411764706,34,713.0,1
0,1,0,781,-261,1042,-323,-300,-23,490.4761904761905,21,777.0,1
0,1,0,490,415,75,-136,38,-174,121.0,3,483.0,0
0,1,0,445,511,-66,-148,0,-148,76.25,4,511.0,0
0,1,0,11,-50,61,-650,-483,-167,56.857142857142854,7,7.0,0
0,1,0,832,-1193,2025,-200,-225,25,469.7674418604651,43,833.0,1
0,1,10,466,-1336,1802,-260,-124,-136,380.63829787234044,47,-1339.0,0
0,1,0,423,230,193,-294,-329,35,212.4,10,424.0,1
0,1,39,1244,-283,1527,-326,-420,94,406.84615384615387,39,-289.0,0
0,1,50,237,-1574,1811,-478,-101,-377,404.5652173913044,46,-1577.0,0
0,1,0,889,78,811,-139,-603,464,344.2162162162162,37,890.0,1
0,1,0,19,-1,20,-435,-401,-34,98.5,2,19.0,0
0,1,0,732,-289,1021,-266,-304,38,491.3809523809524,21,734.0,1
0,1,15,410,-1039,1449,-304,-178,-126,352.4418604651163,43,411.0,1
0,1,0,741,-428,1169,-211,-274,63,524.2173913043479,23,742.0,1
0,1,57,593,-231,824,-340,-361,21,250.08823529411765,34,-230.0,0
0,1,0,1289,847,442,-243,-251,8,166.57692307692307,26,847.0,0
0,1,0,1329,230,1099,-221,-335,114,483.9130434782609,23,230.0,0
0,1,13,553,-503,1056,-186,-203,17,287.5135135135135,37,-509.0,0
0,1,61,780,290,490,-425,-427,2,256.6111111111111,18,290.0,0
0,1,0,1524,1135,389,-222,-212,-10,191.95,20,1135.0,0
0,1,13,222,-924,1146,-525,-106,-419,295.95,40,-919.0,0
0,1,74,1309,307,1002,-246,-371,125,256.675,40,296.0,0
0,1,0,1177,619,558,-266,-118,-148,242.13636363636363,22,619.0,0
0,1,5,1245,456,789,-211,-134,-77,247.8709677419355,31,459.0,0
0,1,0,513,-832,1345,-195,-153,-42,326.8292682926829,41,514.0,1
0,1,0,739,-212,951,-272,-250,-22,465.42857142857144,21,729.0,1
0,1,0,679,-774,1453,-322,-145,-177,305.2916666666667,48,675.0,1
0,1,24,1043,213,830,-353,-317,-36,299.76666666666665,30,182.0,0
0,1,0,1627,882,745,-242,-239,-3,403.3,20,1664.0,1
1,1,39,1182,1168,14,-85,-43,-42,29.0,2,1165.0,0
1,1,39,1412,1501,-89,-135,-4,-131,121.0,6,1502.0,0
0,1,0,809,73,736,-254,-309,55,423.22222222222223,18,810.0,1
0,1,0,872,-259,1131,-237,-676,439,533.695652173913,23,868.0,1
0,1,24,262,495,-233,-472,-223,-249,157.1764705882353,17,252.0,1
0,1,0,478,-164,642,-268,-333,65,339.2352941176471,34,459.0,1
0,1,0,1081,854,227,-237,-687,450,337.2857142857143,28,578.0,1
0,1,13,738,-896,1634,-265,-179,-86,378.27906976744185,43,-897.0,0
0,1,48,1340,472,868,-257,-220,-37,210.625,40,472.0,0
0,1,21,674,840,-166,-88,25,-113,75.5,20,673.0,1
0,1,0,746,-41,787,-200,-565,365,479.57894736842104,19,746.0,1
0,1,0,826,75,751,-174,-336,162,421.2631578947368,19,827.0,1
0,1,0,1048,-257,1305,-315,-326,11,470.85714285714283,28,1049.0,1
0,1,0,477,-514,991,-204,-153,-51,281.6111111111111,36,-509.0,0
0,1,0,69,291,-222,-284,-289,5,407.6530612244898,49,-826.0,1
0,1,0,1041,739,302,-174,-414,240,196.0,20,987.0,1
0,1,10,2009,1209,800,-134,-170,36,228.34285714285716,35,1201.0,0
0,1,0,31,177,-146,-328,-450,122,224.75,8,30.0,1
0,1,0,502,372,130,-221,-126,-95,171.0,6,501.0,1
0,1,18,334,501,-167,-260,-84,-176,148.08333333333334,12,512.0,0
0,1,0,954,-198,1152,-268,-259,-9,445.65384615384613,26,955.0,1
0,1,0,518,469,49,-222,-262,40,125.8,5,519.0,0
0,1,0,488,237,251,-203,-217,14,333.75,8,490.0,1
0,1,14,534,190,344,-216,-375,159,174.73076923076923,26,533.0,1
0,1,0,487,-384,871,-183,-152,-31,201.42222222222222,45,479.0,1
0,1,0,560,296,264,-196,-175,-21,174.71428571428572,14,536.0,1
0,1,0,545,262,283,-188,-225,37,152.5909090909091,22,536.0,1
0,1,0,883,156,727,-257,-267,10,372.40983606557376,61,884.0,1
0,1,0,397,445,-48,-85,-95,10,56.03333333333333,30,399.0,0
0,1,11,572,-532,1104,-198,-190,-8,279.56410256410254,39,-532.0,0
0,1,0,3,54,-51,-709,-668,-41,137.36363636363637,11,-7.0,0
0,1,0,429,392,37,-164,-54,-110,73.25,4,430.0,0
0,1,0,493,300,193,-199,-120,-79,149.125,16,491.0,1
0,1,0,461,61,400,-221,-290,69,284.57142857142856,14,458.0,1
0,1,12,811,1724,-913,-191,-163,-28,286.35483870967744,31,1731.0,0
0,1,0,934,-327,1261,-200,-250,50,571.8181818181819,22,-327.0,0
0,1,0,375,-526,901,-265,-152,-113,218.0909090909091,44,-479.0,0
0,1,4,658,-1216,1874,-129,-110,-19,282.64383561643837,73,651.0,1
0,1,6,782,-246,1028,-265,-444,179,170.92424242424244,66,785.0,1
0,1,0,244,284,-40,-403,-425,22,54.4,20,245.0,0
0,1,0,1204,638,566,-194,-312,118,450.53846153846155,13,1199.0,1
0,1,0,522,-453,975,-355,-118,-237,253.0487804878049,41,519.0,1
0,1,0,462,62,400,-183,-238,55,291.85714285714283,14,464.0,1
0,1,33,411,-581,992,-330,-138,-192,240.23809523809524,42,-571.0,0
0,1,24,1625,291,1334,-223,-451,228,300.2291666666667,48,245.0,0
0,1,0,473,-1052,1525,-256,-89,-167,401.81081081081084,37,474.0,1
0,1,30,243,545,-302,-526,-245,-281,152.41666666666666,24,550.0,0
0,1,6,495,1140,-645,-403,-176,-227,219.63333333333333,30,1142.0,0
0,1,0,283,-676,959,-291,-207,-84,306.2903225806452,31,-676.0,0
1,1,4,439,-317,756,-194,-503,309,182.7111111111111,45,407.0,1
1,1,0,32,229,-197,-748,-526,-222,109.42307692307692,26,33.0,1
0,1,0,763,526,237,274,-265,539,223.6,10,763.0,1
0,1,0,548,-184,732,-224,-280,56,271.4074074074074,27,548.0,1
0,1,0,840,-369,1209,-311,-315,4,507.9166666666667,24,841.0,1
0,1,2,388,365,23,-71,-87,16,64.41379310344827,29,402.0,0
0,1,2,492,-621,1113,-238,-170,-68,245.7391304347826,46,490.0,1
0,1,0,873,-226,1099,-205,-356,151,398.60714285714283,28,876.0,1
0,1,0,920,126,794,-215,-468,253,221.68,50,-26.0,1
0,1,0,670,-1077,1747,-257,-144,-113,352.44,50,-1077.0,0
0,1,0,517,149,368,-196,-249,53,322.53846153846155,13,510.0,1
0,1,0,276,-392,668,-483,-168,-315,253.4516129032258,31,-420.0,0
0,1,0,499,72,427,-199,-251,52,326.15384615384613,13,496.0,1
0,1,2,1900,1008,892,-185,-146,-39,266.88235294117646,34,1008.0,0
0,1,0,168,6,162,-680,-685,5,252.0,7,6.0,0
0,1,51,737,-528,1265,-286,-260,-26,301.780487804878,41,-529.0,0
0,1,0,77,-225,302,-646,-630,-16,146.33333333333334,21,-241.0,0
0,1,0,494,-433,927,-133,-143,10,245.53846153846155,39,-452.0,0
0,1,0,468,-499,967,-229,-244,15,249.725,40,466.0,1
0,1,0,1045,-264,1309,-149,-286,137,516.3461538461538,26,-264.0,0
0,1,0,598,254,344,-220,-503,283,221.77272727272728,22,627.0,1
0,1,0,435,-361,796,-228,-281,53,347.9166666666667,24,433.0,1
0,1,0,780,-174,954,-278,-271,-7,438.1363636363636,22,778.0,1
0,1,0,730,-157,887,-224,-277,53,345.9230769230769,26,731.0,1
0,1,0,851,171,680,-202,-337,135,400.875,16,808.0,1
0,1,17,345,-419,764,-233,-239,6,280.3225806451613,31,-444.0,0
0,1,0,320,711,-391,-279,-276,-3,240.34146341463415,41,34.0,1
0,1,0,2049,1019,1030,-124,72,-196,324.8484848484849,33,1019.0,0
0,1,12,743,1392,-649,-240,25,-265,185.8,35,1377.0,0
0,1,50,506,195,311,-479,-353,-126,190.3125,16,201.0,0
0,1,10,539,-1066,1605,-133,-304,171,324.44897959183675,49,560.0,1
0,1,0,467,386,81,-258,-264,6,165.6,5,469.0,0
0,1,14,446,-576,1022,-274,-167,-107,220.82978723404256,47,448.0,1
0,1,0,496,183,313,-186,-258,72,278.53846153846155,13,507.0,1
0,1,0,783,-93,876,-193,-296,103,453.23809523809524,21,784.0,1
0,1,0,279,-290,569,-526,-315,-211,153.32432432432432,37,-290.0,0
0,1,0,809,469,340,-276,-287,11,318.1818181818182,11,811.0,1
0,1,0,507,253,254,-178,-249,71,114.47368421052632,19,488.0,1
0,1,0,726,400,326,-312,-272,-40,275.9166666666667,12,727.0,1
0,1,3,315,-147,462,-442,-368,-74,173.58620689655172,29,-178.0,0
0,1,0,555,370,185,-147,-93,-54,67.16666666666667,24,564.0,1
0,1,0,426,404,22,-22,51,-73,36.05,20,411.0,0
0,1,13,1165,-598,1763,-96,-164,68,419.74418604651163,43,1166.0,1
0,1,21,468,-554,1022,-230,-187,-43,237.2093023255814,43,-551.0,0
0,1,53,123,258,-135,-617,-551,-66,126.81818181818181,11,267.0,0
0,1,0,993,-327,1320,-162,-322,160,513.2307692307693,26,990.0,1
0,1,1,38,-610,648,-233,-205,-28,243.53846153846155,26,-618.0,0
0,1,0,483,129,354,-183,-322,139,365.93650793650795,63,-822.0,1
0,1,20,475,572,-97,-235,-182,-53,96.66666666666667,9,574.0,0
0,1,0,951,597,354,-308,-291,-17,170.45833333333334,48,952.0,1
0,1,0,688,492,196,-241,-261,20,211.7,10,687.0,1
0,1,0,943,560,383,-194,-296,102,317.75,12,944.0,1
0,1,0,1050,529,521,-320,-166,-154,359.2142857142857,14,1016.0,1
0,1,12,524,-683,1207,-140,-175,35,240.7450980392157,51,525.0,1
0,1,0,804,-285,1089,-264,-378,114,487.7916666666667,24,825.0,1
0,1,10,54,1173,-1119,-284,-217,-67,277.225,40,1175.0,0
0,1,21,1247,214,1033,-140,-573,433,269.3333333333333,42,1244.0,1
0,1,0,1402,616,786,-191,-163,-28,199.35,40,605.0,0
0,1,0,1019,618,401,-160,-223,63,330.15384615384613,13,1025.0,1
0,1,0,969,556,413,-144,-94,-50,209.05263157894737,19,972.0,1
0,1,1,637,-562,1199,-157,-171,14,231.34615384615384,52,633.0,1
1,1,32,787,-539,1326,-201,-76,-125,328.2926829268293,41,787.0,1
1,1,32,913,-1195,2108,-150,-176,26,402.8679245283019,53,-1199.0,0
0,1,0,980,390,590,-184,-267,83,410.8,15,981.0,1
0,1,13,1229,-1710,2939,-222,-129,-93,519.1071428571429,56,-1710.0,0
0,1,1,626,-516,1142,-193,-185,-8,267.0232558139535,43,-516.0,0
0,1,9,639,-514,1153,-255,-210,-45,223.54901960784315,51,641.0,1
0,1,0,8,-173,181,-804,-813,9,187.88888888888889,9,-2.0,1
0,1,15,106,862,-756,-473,-152,-321,276.8965517241379,29,862.0,0
0,1,0,1007,437,570,-226,-289,63,411.7142857142857,14,1007.0,1
0,1,0,1828,860,968,-198,-324,126,516.6842105263158,19,1830.0,1
0,1,0,972,34,938,-158,-253,95,502.3157894736842,19,971.0,1
0,1,0,1088,387,701,-169,-449,280,429.7368421052632,19,1090.0,1
0,1,14,216,-599,815,-493,-69,-424,233.54054054054055,37,212.0,1
0,1,36,607,-443,1050,-184,-182,-2,258.4102564102564,39,608.0,1
0,1,0,588,-657,1245,-214,-245,31,387.5,32,587.0,1
0,1,12,866,-729,1595,-238,-236,-2,335.27659574468083,47,867.0,1
0,1,1,440,-480,920,-186,-197,11,288.5625,32,-480.0,0
0,1,24,1515,743,772,-169,-170,1,233.5625,32,1512.0,1
0,1,0,599,264,335,-176,-248,72,208.1875,16,602.0,1
0,1,0,1015,480,535,-136,-221,85,392.5,14,1009.0,1
0,1,0,1053,456,597,-206,-731,525,443.84615384615387,52,1060.0,1
0,1,0,268,-153,421,-513,-553,40,343.5833333333333,12,271.0,1
0,1,0,753,-673,1426,-252,-261,9,375.7105263157895,38,754.0,1
0,1,18,402,-528,930,-244,-127,-117,363.28,25,-518.0,0
0,1,0,557,601,-44,-106,-91,-15,32.0,14,574.0,0
0,1,33,1454,277,1177,-239,-398,159,289.4047619047619,42,243.0,0
0,1,2,526,457,69,-56,-71,15,36.35,20,537.0,0
0,1,0,790,-801,1591,-186,-185,-1,451.65714285714284,35,792.0,1
0,1,28,1264,432,832,-157,-197,40,254.78125,32,1259.0,1
0,1,0,986,516,470,-198,-343,145,347.8,15,988.0,1
0,1,0,909,704,205,-211,-273,62,229.44444444444446,9,704.0,0
0,1,0,1048,466,582,-210,-321,111,367.0625,16,1042.0,1
0,1,9,198,-1877,2075,-552,-116,-436,358.86206896551727,58,194.0,1
0,1,8,356,-928,1284,-276,-127,-149,346.4594594594595,37,-928.0,0
0,1,0,840,356,484,-238,-364,126,391.84615384615387,13,356.0,0
0,1,28,265,-865,1130,-512,-203,-309,321.4054054054054,37,266.0,1
0,1,24,634,-1227,1861,-239,-98,-141,427.86046511627904,43,-1230.0,0
0,1,1,705,-941,1646,-171,-149,-22,361.4888888888889,45,-941.0,0
0,1,21,252,-556,808,-490,-186,-304,259.57575757575756,33,-561.0,0
0,1,0,1994,1596,398,-124,-168,44,282.7857142857143,14,1994.0,1
0,1,17,1196,505,691,-174,39,-213,233.96774193548387,31,1210.0,1
0,1,0,398,390,8,27,52,-25,121.75,8,390.0,0
0,1,0,798,371,427,-196,-419,223,214.56521739130434,23,800.0,1
1,1,5,415,-667,1082,-218,-132,-86,278.35,40,-695.0,0
1,1,19,952,-555,1507,-177,-169,-8,353.74418604651163,43,954.0,1
0,1,46,8,468,-460,-441,-188,-253,197.96296296296296,27,464.0,0
0,1,0,575,-60,635,-174,-253,79,308.7142857142857,21,577.0,1
0,1,3,56,581,-525,-262,-63,-199,168.63888888888889,36,570.0,0
1,1,6,585,-910,1495,-291,-116,-175,317.40425531914894,47,-910.0,0
0,1,0,1068,761,307,-188,-205,17,268.09090909090907,11,1064.0,1
0,1,5,115,-820,935,-368,-164,-204,243.68421052631578,38,-820.0,0
0,1,1,864,-1091,1955,-187,-73,-114,418.82978723404256,47,871.0,1
1,1,20,660,667,-7,-132,-33,-99,75.5,2,676.0,0
0,1,12,1340,559,781,-153,-77,-76,237.87878787878788,33,552.0,0
0,1,0,965,707,258,-169,-236,67,328.3333333333333,9,966.0,1
0,1,4,1219,-1134,2353,-191,-164,-27,489.875,48,-1135.0,0
0,1,27,521,-477,998,-209,-124,-85,286.1714285714286,35,-495.0,0
0,1,0,601,-589,1190,-223,-215,-8,329.4166666666667,36,600.0,1
0,1,23,510,498,12,-191,-187,-4,40.0,4,491.0,0
0,1,0,1045,388,657,-230,-331,101,395.29411764705884,17,1044.0,1
0,1,18,138,-444,582,-507,-160,-347,233.5185185185185,27,139.0,1
0,1,0,808,-1017,1825,-210,-237,27,406.3777777777778,45,-1017.0,0
0,1,0,1008,-771,1779,-172,-229,57,400.64444444444445,45,1010.0,1
0,1,39,765,782,-17,-165,-169,4,34.0,1,784.0,0
0,1,11,190,-584,774,-509,-188,-321,293.86206896551727,29,-597.0,0
0,1,0,568,600,-32,-172,-83,-89,49.705882352941174,17,613.0,0
0,1,0,919,831,88,-171,-161,-10,97.77777777777777,9,919.0,0
0,1,0,172,542,-370,-251,-52,-199,155.32142857142858,28,552.0,0
0,1,0,454,82,372,-174,-197,23,317.0,11,451.0,1
0,1,0,960,-1002,1962,-264,-156,-108,513.5526315789474,38,962.0,1
0,1,0,993,523,470,-252,-261,9,346.2142857142857,14,987.0,1
0,1,0,881,-470,1351,-154,-152,-2,341.05,40,882.0,1
0,1,0,1112,-1059,2171,-127,-121,-6,424.1923076923077,52,-1059.0,0
0,1,11,630,-442,1072,-236,-114,-122,366.62068965517244,29,-447.0,0
0,1,17,188,-598,786,-516,-152,-364,244.97142857142856,35,-628.0,0
0,1,0,634,-531,1165,-149,-151,2,260.6222222222222,45,-531.0,0
0,1,0,1639,1270,369,-198,-161,-37,265.06666666666666,15,1640.0,1
0,1,0,1770,856,914,-244,-257,13,453.4761904761905,21,1766.0,1
0,1,0,252,-736,988,-231,-131,-100,444.04545454545456,22,-736.0,0
0,1,0,527,-551,1078,-227,-195,-32,259.14285714285717,42,-558.0,0
0,1,0,968,369,599,-222,-279,57,392.9375,16,970.0,1
0,1,0,1118,486,632,-188,-151,-37,205.0,30,486.0,0
0,1,36,1389,1333,56,-166,-124,-42,76.4,20,1256.0,0
0,1,0,722,-385,1107,-246,-227,-19,473.95652173913044,23,730.0,1
0,1,11,1278,530,748,-192,-178,-14,236.96774193548387,31,1276.0,1
0,1,17,1664,906,758,-284,-121,-163,238.03225806451613,31,926.0,0
0,1,0,1161,658,503,-168,-39,-129,177.96428571428572,28,658.0,0
1,1,4,360,657,-297,-272,-46,-226,135.72,25,647.0,0
1,1,0,438,-521,959,-329,-96,-233,323.9,30,-539.0,0
0,1,4,470,-554,1024,-252,-176,-76,319.59375,32,-554.0,0
1,1,46,1008,1319,-311,-104,16,-120,127.53846153846153,26,1348.0,0
1,1,2,1341,268,1073,-269,-355,86,232.45652173913044,46,296.0,0
0,1,7,1688,256,1432,-279,-374,95,312.17391304347825,46,266.0,0
0,1,17,222,-2012,2234,-397,-46,-351,446.88235294117646,51,-2033.0,0
0,1,0,685,634,51,-172,-161,-11,53.666666666666664,9,690.0,0
0,1,1,825,-405,1230,-222,-243,21,300.325,40,826.0,1
0,1,0,542,-551,1093,-273,-66,-207,306.75,36,547.0,1
0,1,6,158,-581,739,-480,-79,-401,221.6216216216216,37,-601.0,0
0,1,49,484,-494,978,-205,-169,-36,242.5609756097561,41,-496.0,0
0,1,1,1462,910,552,-108,-137,29,214.40740740740742,27,1462.0,1
0,1,0,963,326,637,-192,-160,-32,243.1951219512195,41,963.0,1
0,1,0,731,-989,1720,-211,-163,-48,343.74,50,732.0,1
0,1,0,796,389,407,-201,-260,59,330.0833333333333,12,783.0,1
0,1,0,472,-163,635,-181,-266,85,333.95652173913044,23,474.0,1
1,1,46,707,-821,1528,-184,-66,-118,336.3478260869565,46,704.0,1
1,1,77,1785,491,1294,-159,-141,-18,312.2142857142857,42,1784.0,1
1,1,29,833,973,-140,-88,-166,78,95.36363636363636,22,832.0,1
0,1,33,0,-586,586,-520,-181,-339,232.71428571428572,28,2.0,1
0,1,41,1204,-214,1418,-357,-447,90,339.3488372093023,43,-224.0,0
0,1,0,1050,-459,1509,-211,-305,94,506.56666666666666,30,1053.0,1
0,1,9,747,-519,1266,-218,-127,-91,343.5945945945946,37,750.0,1
0,1,0,503,46,457,-202,-187,-15,314.8157894736842,38,503.0,1
0,1,40,10,3,7,-796,-674,-122,167.38888888888889,18,5.0,0
0,1,14,804,-466,1270,-200,-227,27,252.9875,80,805.0,1
0,1,0,835,-760,1595,-210,-137,-73,369.72093023255815,43,840.0,1
0,1,60,533,-508,1041,-256,-171,-85,320.8787878787879,33,-525.0,0
0,1,0,716,-613,1329,-204,-210,6,408.375,32,-613.0,0
0,1,0,810,-801,1611,-244,-227,-17,356.9555555555556,45,784.0,1
0,1,7,817,-557,1374,-258,-170,-88,296.5531914893617,47,-559.0,0
0,1,0,602,374,228,-62,-187,125,150.41935483870967,31,600.0,1
1,1,25,17,579,-562,-466,-3,-463,210.71052631578948,38,16.0,1
0,1,0,1355,625,730,-184,-28,-156,194.7027027027027,37,625.0,0
0,1,14,206,-188,394,-554,-526,-28,130.2,30,207.0,1
0,1,13,36,-910,946,-257,-83,-174,282.61290322580646,31,-855.0,0
0,1,0,858,-278,1136,-199,-286,87,447.578125,64,859.0,1
0,1,16,39,-567,606,-283,-71,-212,273.54545454545456,22,-548.0,0
0,1,0,568,521,47,-172,-137,-35,121.75,4,569.0,0
0,1,0,789,227,562,-220,-289,69,374.8,15,790.0,1
0,1,32,191,-240,431,-556,-373,-183,145.96666666666667,30,192.0,1
0,1,56,233,-813,1046,-364,-90,-274,287.39473684210526,38,-802.0,0
0,1,0,1226,352,874,-221,-291,70,446.35,20,1226.0,1
0,1,1,468,254,214,-228,-320,92,134.1851851851852,27,462.0,1
0,1,22,869,253,616,-187,-411,224,215.83333333333334,30,866.0,1
0,1,0,571,-1254,1825,-250,-216,-34,313.67241379310343,58,574.0,1
0,1,1,560,399,161,-148,-200,52,242.11904761904762,42,561.0,1
0,1,23,1875,-487,2362,-246,-156,-90,426.3454545454546,55,1876.0,1
1,1,38,28,1676,-1648,-715,57,-772,350.22,50,1665.0,0
1,1,45,1327,860,467,-67,113,-180,113.8780487804878,41,853.0,0
1,1,42,612,2066,-1454,-112,46,-158,320.73333333333335,45,2068.0,0
1,1,52,487,1260,-773,-96,46,-142,209.27777777777777,36,1276.0,0
0,1,3,502,-446,948,-309,3,-312,273.8378378378378,37,-498.0,0
0,1,0,1335,-1715,3050,-156,-177,21,427.5061728395062,81,1316.0,1
1,1,120,517,1002,-485,-48,-42,-6,154.03125,32,509.0,1
0,1,0,527,-479,1006,-262,-247,-15,279.6666666666667,36,-477.0,0
0,1,37,161,459,-298,-270,-91,-179,150.15,20,465.0,0
0,1,0,498,501,-3,-200,-218,18,155.36363636363637,33,495.0,0
0,1,0,477,337,140,-264,-319,55,113.8076923076923,26,477.0,1
0,1,32,149,267,-118,-586,-447,-139,126.61538461538461,13,271.0,0
0,1,0,532,307,225,-194,-219,25,222.0909090909091,11,307.0,0
0,1,12,743,243,500,-178,-485,307,215.25925925925927,27,231.0,0
0,1,19,337,-514,851,-309,-132,-177,307.10714285714283,28,-511.0,0
0,1,0,599,524,75,-168,-189,21,96.28571428571429,7,600.0,0
0,1,0,1259,521,738,-191,-246,55,411.8888888888889,18,521.0,0
1,1,19,533,-802,1335,-239,-178,-61,301.06666666666666,45,-806.0,0
1,1,41,1047,1158,-111,-222,-214,-8,58.27777777777778,18,1044.0,1
0,1,0,476,-465,941,-216,-159,-57,300.741935483871,31,-465.0,0
0,1,0,1260,328,932,-209,-297,88,495.5263157894737,19,1253.0,1
0,1,0,815,269,546,-241,-265,24,378.6666666666667,15,817.0,1
0,1,0,872,408,464,-251,-303,52,343.7142857142857,14,870.0,1
0,1,23,1434,248,1186,-288,-486,198,239.43396226415095,53,212.0,0
0,1,0,778,376,402,-113,-557,444,387.0,15,780.0,1
0,1,0,298,377,-79,-234,-203,-31,202.28571428571428,21,127.0,1
0,1,1,427,-395,822,-252,-248,-4,298.7857142857143,28,-410.0,0
0,1,0,1224,704,520,-193,-202,9,189.74074074074073,27,1220.0,1
0,1,0,862,474,388,-202,-235,33,323.1666666666667,12,845.0,1
0,1,19,461,-511,972,-229,-73,-156,255.15384615384616,39,-529.0,0
0,1,0,632,-227,859,-217,-263,46,490.44444444444446,18,-227.0,0
0,1,22,1405,554,851,-189,-122,-67,173.08163265306123,49,543.0,0
0,1,17,462,262,200,-233,-321,88,175.89285714285714,28,462.0,1
0,1,0,863,512,351,-150,-266,116,332.8333333333333,12,866.0,1
0,1,0,1115,281,834,-211,-315,104,246.2941176470588,34,1109.0,1
0,1,0,1030,-217,1247,-189,-339,150,325.6666666666667,39,1032.0,1
1,1,25,923,1272,-349,-220,-161,-59,247.0,13,1270.0,0
0,1,0,938,619,319,-241,-287,46,364.1111111111111,9,939.0,1
0,1,9,242,1473,-1231,-425,-67,-358,323.28205128205127,39,1473.0,0
0,1,17,766,-473,1239,-227,-134,-93,317.075,40,-489.0,0
0,1,35,787,-412,1199,-204,-195,-9,297.1219512195122,41,-432.0,0
1,1,57,0,1674,-1674,-644,-11,-633,382.5,46,1670.0,0
1,1,86,789,716,73,-178,21,-199,58.588235294117645,17,677.0,0
1,1,65,1340,869,471,-70,18,-88,141.46875,32,876.0,0
1,1,37,563,1980,-1417,-167,-76,-91,338.0243902439024,41,1981.0,0
1,1,65,454,1241,-787,-116,-66,-50,225.44117647058823,34,452.0,1
0,1,0,1003,-188,1191,-234,-520,286,394.96875,32,1004.0,1
0,1,21,477,-477,954,-285,-114,-171,282.29411764705884,34,-481.0,0
0,1,0,578,539,39,-190,-192,2,92.33333333333333,3,573.0,0
0,1,0,822,484,338,-266,-290,24,290.8333333333333,12,822.0,1
0,1,17,614,-408,1022,-129,-162,33,309.27272727272725,33,613.0,1
0,1,43,483,-380,863,-198,-230,32,245.71428571428572,35,484.0,1
0,1,11,246,-1724,1970,-583,-18,-565,408.54,50,248.0,1
0,1,31,1482,523,959,-209,-240,31,288.79411764705884,34,509.0,0
0,1,24,221,945,-724,-526,-151,-375,203.28947368421052,38,220.0,1
0,1,0,407,-13,420,-234,-439,205,174.20689655172413,29,408.0,1
0,1,11,1248,-1367,2615,-206,-69,-137,457.82456140350877,57,-1381.0,0
0,1,0,455,-449,904,-238,-193,-45,216.46938775510205,49,548.0,1
0,1,2,558,-2164,2722,-255,-183,-72,474.17543859649123,57,-2164.0,0
0,1,0,85,951,-866,-339,-56,-283,265.06060606060606,33,949.0,0
0,1,0,170,17,153,-592,-614,22,174.9090909090909,11,180.0,1
0,1,0,530,264,266,-148,-221,73,349.125,8,532.0,1
0,1,0,484,-430,914,-222,-218,-4,222.89743589743588,39,486.0,1
0,1,0,1532,283,1249,-99,-546,447,331.1219512195122,41,267.0,0
0,1,18,252,-1550,1802,-518,33,-551,371.38775510204084,49,232.0,1
0,1,4,2001,232,1769,-214,-500,286,343.61538461538464,52,232.0,0
0,1,0,605,483,122,-227,-190,-37,247.5952380952381,42,606.0,1
0,1,0,984,631,353,-176,-253,77,267.7692307692308,13,955.0,1
0,1,0,478,-393,871,-231,-258,27,248.28571428571428,35,-410.0,0
0,1,0,758,565,193,-174,-294,120,295.875,8,761.0,1
0,1,5,1497,-526,2023,-231,-188,-43,428.8723404255319,47,-528.0,0
0,1,0,1016,-1017,2033,-162,-253,91,527.5897435897435,39,1018.0,1
0,1,55,178,197,-19,-437,-561,124,160.0,4,217.0,0
0,1,8,1385,638,747,-329,-243,-86,225.9090909090909,33,638.0,0
0,1,1,1506,-357,1863,-165,-257,92,389.5833333333333,48,1508.0,1
0,1,0,724,497,227,-94,-280,186,326.55555555555554,9,711.0,1
0,1,0,947,437,510,-169,-305,136,435.75,12,948.0,1
0,1,8,504,792,-288,-295,-158,-137,208.26666666666668,15,798.0,0
0,1,26,514,-799,1313,-175,-115,-60,361.4864864864865,37,-803.0,0
1,1,15,562,-1438,2000,-187,-105,-82,431.5217391304348,46,564.0,1
1,1,36,14,216,-202,-743,-515,-228,119.43478260869566,23,12.0,1
1,1,7,444,-2165,2609,-132,-110,-22,463.5892857142857,56,-2165.0,0
0,1,7,1465,609,856,-210,-202,-8,253.03030303030303,33,1465.0,1
0,1,12,1395,546,849,-228,-222,-6,250.02941176470588,34,1396.0,1
1,1,0,143,520,-377,-264,-152,-112,253.8125,16,546.0,0
1,1,0,54,-358,412,-340,-183,-157,159.0,31,-390.0,0
0,1,0,867,-639,1506,-86,-217,131,466.6060606060606,33,868.0,1
1,1,0,6,-483,489,-260,-146,-114,171.4,35,-487.0,0
1,1,0,138,-396,534,-257,-228,-29,207.35714285714286,28,-443.0,0
0,1,0,871,-741,1612,-77,-262,185,487.9117647058824,34,873.0,1
0,1,78,347,-728,1075,-268,-157,-111,344.80645161290323,31,-733.0,0
0,1,4,1430,198,1232,-163,-547,384,281.6,45,207.0,0
0,1,0,197,200,-3,-538,-159,-379,59.27272727272727,11,174.0,0
0,1,132,1800,1922,-122,-76,298,-374,136.9090909090909,11,1952.0,0
0,1,57,207,-628,835,-222,-201,-21,329.32,25,-630.0,0
1,1,0,420,-556,976,-111,-201,90,280.0,39,-566.0,0
0,1,0,485,-376,861,-216,-109,-107,230.77272727272728,44,483.0,1
0,1,15,448,16,432,-199,-612,413,204.92592592592592,27,442.0,1
0,1,54,482,794,-312,-250,-136,-114,192.2941176470588,17,808.0,0
0,1,0,786,654,132,-213,-287,74,246.28571428571428,7,788.0,1
0,1,0,848,71,777,-187,-320,133,416.0,20,870.0,1
0,1,30,584,815,-231,-296,-35,-261,150.8,15,809.0,0
0,1,0,825,350,475,-208,-299,91,353.0,14,826.0,1
0,1,0,535,359,176,-168,-210,42,269.14285714285717,7,536.0,1
0,1,0,816,568,248,-156,-285,129,288.8888888888889,9,818.0,1
0,1,14,941,-514,1455,-230,-221,-9,379.0263157894737,38,-514.0,0
0,1,22,1291,589,702,-225,-200,-25,212.03030303030303,33,1285.0,1
0,1,17,11,746,-735,-332,-105,-227,280.34615384615387,26,739.0,0
0,1,3,317,-641,958,-403,-172,-231,223.88235294117646,51,404.0,1
0,1,0,262,-16,278,-529,-633,104,271.0,11,252.0,1
0,1,11,1161,253,908,-273,-531,258,293.1875,32,243.0,0
0,1,0,791,-1178,1969,-243,-197,-46,524.5263157894736,38,792.0,1
0,1,4,517,-365,882,-191,-257,66,276.969696969697,33,516.0,1
0,1,4,1705,492,1213,-213,-219,6,272.34090909090907,44,491.0,0
0,1,0,995,586,409,-177,-249,72,326.7692307692308,13,997.0,1
0,1,2,320,529,-209,-217,-216,-1,177.0,10,523.0,0
0,1,0,854,551,303,-242,-311,69,356.22222222222223,9,848.0,1
0,1,35,1158,921,237,-187,-183,-4,174.30769230769232,13,915.0,0
1,1,1,412,-517,929,-146,-157,11,226.2391304347826,46,-589.0,0
1,1,0,498,-400,898,-227,-240,13,282.3529411764706,34,-421.0,0
0,1,0,939,-750,1689,-41,-278,237,479.3333333333333,36,940.0,1
1,1,47,823,666,157,-253,-82,-171,104.15789473684211,19,821.0,1
1,1,0,427,-509,936,-150,-121,-29,265.1794871794872,39,430.0,1
1,1,0,550,-374,924,-209,-215,6,245.69230769230768,39,-414.0,0
0,1,0,713,-730,1443,-73,-203,130,452.24242424242425,33,714.0,1
0,1,0,1311,438,873,-159,-304,145,415.5,22,1314.0,1
0,1,0,904,-486,1390,-192,-228,36,360.6825396825397,63,906.0,1
0,1,53,443,-467,910,-292,-150,-142,233.12820512820514,39,-468.0,0
0,1,0,1117,580,537,-191,-242,51,179.2,30,1119.0,1
0,1,12,1202,-928,2130,-216,-181,-35,379.07142857142856,56,-937.0,0
0,1,0,741,-757,1498,-205,-239,34,394.13157894736844,38,-757.0,0
0,1,0,474,-392,866,-243,-248,5,334.5,26,-392.0,0
0,1,0,1946,991,955,-222,-277,55,350.5925925925926,27,1945.0,1
0,1,0,726,391,335,-207,-354,147,117.3103448275862,29,729.0,1
0,1,21,263,-823,1086,-281,-182,-99,339.5806451612903,31,-825.0,0
0,1,0,849,599,250,-202,-267,65,196.3846153846154,26,845.0,1
0,1,28,821,-485,1306,-243,-158,-85,347.94736842105266,38,822.0,1
0,1,0,966,-353,1319,-180,-337,157,492.85185185185185,27,962.0,1
0,1,2,1086,435,651,-230,-111,-119,215.8,30,1084.0,1
0,1,0,539,382,157,-257,-230,-27,370.8421052631579,38,540.0,1
0,1,0,715,-620,1335,-233,-203,-30,311.5409836065574,61,-910.0,1
0,1,48,861,-910,1771,-214,-114,-100,340.4230769230769,52,-917.0,0
0,1,12,411,414,-3,-227,-204,-23,6.0,2,408.0,0
0,1,10,243,828,-585,-532,-249,-283,214.09677419354838,31,830.0,0
0,1,0,1443,-451,1894,-218,-167,-51,473.45,40,1442.0,1
0,1,36,748,-783,1531,-170,-172,2,307.83673469387753,49,-787.0,0
0,1,0,1513,1340,173,-204,-225,21,185.44444444444446,9,1340.0,0
0,1,46,353,-490,843,-280,-168,-112,260.46875,32,-493.0,0
0,1,0,1182,-297,1479,-200,-239,39,369.4390243902439,41,1181.0,1
0,1,0,864,668,196,-153,-168,15,258.11764705882354,51,865.0,1
0,1,38,1249,435,814,-219,-128,-91,237.88571428571427,35,429.0,0
0,1,0,1149,351,798,-126,-241,115,408.55,20,1145.0,1
0,1,0,838,-654,1492,-224,-240,16,398.6216216216216,37,846.0,1
1,1,72,1003,1364,-361,-70,-58,-12,181.77777777777777,18,1351.0,0
0,1,0,1344,569,775,-193,-155,-38,232.57575757575756,33,1343.0,1
1,1,51,625,211,414,-426,-494,68,189.04545454545453,22,197.0,0
0,1,26,765,470,295,-244,-232,-12,155.26315789473685,19,466.0,0
0,1,0,71,283,-212,-640,-462,-178,92.20833333333333,24,216.0,0
0,1,16,248,202,46,-527,-521,-6,97.25,28,249.0,0
0,1,0,1490,1056,434,-189,-203,14,204.47619047619048,21,1476.0,1
0,1,49,620,-939,1559,-238,-186,-52,389.0,40,-939.0,0
0,1,41,410,0,410,-532,-720,188,230.21052631578948,19,-4.0,0
0,1,0,1563,1201,362,-189,-197,8,238.4,15,1560.0,1
0,1,8,449,-416,865,-206,-239,33,238.0810810810811,37,450.0,1
0,1,0,949,-476,1425,-144,-238,94,375.72222222222223,54,-773.0,1
0,1,19,836,-750,1586,-230,-169,-61,361.79545454545456,44,-754.0,0
0,1,0,719,-505,1224,-223,-247,24,407.9,30,720.0,1
0,1,0,1933,1282,651,-209,-211,2,230.85714285714286,28,1932.0,1
0,1,0,338,318,20,-275,-272,-3,121.4,5,297.0,0
0,1,49,521,845,-324,-229,-137,-92,199.76470588235293,17,853.0,0
1,1,21,1659,1886,-227,-66,-69,3,116.5,20,1658.0,1
1,1,12,292,-210,502,-562,-527,-35,179.89655172413794,29,294.0,1
0,1,0,670,645,25,-214,-221,7,140.5,2,645.0,0
0,1,0,564,-197,761,-234,-423,189,286.44444444444446,27,-197.0,0
0,1,0,439,446,-7,-242,-242,0,290.02702702702703,37,-88.0,1
0,1,0,858,-201,1059,-179,-288,109,454.8333333333333,24,861.0,1
0,1,7,1283,526,757,-301,-141,-160,222.41176470588235,34,1284.0,1
0,1,0,1357,422,935,-194,-282,88,407.39130434782606,23,1345.0,1
0,1,0,984,580,404,-150,-190,40,178.13636363636363,22,986.0,1
0,1,3,619,335,284,-209,-287,78,117.5,24,613.0,1
0,1,0,1688,1025,663,-224,-199,-25,348.57894736842104,19,1681.0,1
0,1,0,899,-618,1517,-174,-218,44,475.75,32,901.0,1
0,1,0,1689,1370,319,-195,-188,-7,202.4,15,1676.0,1
0,1,0,793,-520,1313,-193,-235,42,397.24242424242425,33,790.0,1
0,1,53,369,882,-513,-279,29,-308,290.52941176470586,17,895.0,0
0,1,0,1476,1078,398,-171,47,-218,199.61904761904762,21,1475.0,1
0,1,0,1883,968,915,-248,-127,-121,346.85185185185185,27,968.0,0
0,1,0,1097,649,448,-229,-92,-137,358.0769230769231,13,649.0,0
0,1,14,271,-248,519,-535,-483,-52,155.36363636363637,33,273.0,1
0,1,0,1798,835,963,-243,-150,-93,283.45714285714286,35,1799.0,1
0,1,0,628,-725,1353,-330,-347,17,308.43939393939394,66,-1073.0,1
0,1,0,993,-463,1456,-141,-306,165,386.89473684210526,38,995.0,1
0,1,0,1506,1059,447,-186,-174,-12,266.7647058823529,17,1498.0,1
0,1,0,1528,1316,212,-247,-264,17,236.66666666666666,9,1526.0,1
0,1,0,875,-356,1231,-203,-312,109,473.95348837209303,43,876.0,1
0,1,0,1300,-693,1993,-161,-312,151,484.1818181818182,44,1295.0,1
0,1,5,1123,231,892,-376,-498,122,230.8409090909091,44,176.0,0
0,1,10,336,310,26,-542,-531,-11,140.07692307692307,39,330.0,0
0,1,0,838,658,180,-184,-213,29,301.7142857142857,7,840.0,1
0,1,0,1441,408,1033,-156,-125,-31,249.95,40,1442.0,1
1,1,28,714,-797,1511,-224,-113,-111,328.3404255319149,47,-798.0,0
1,1,35,6,-1327,1333,-670,-7,-663,353.1707317073171,41,-1336.0,0
1,1,12,418,663,-245,-132,-207,75,72.6774193548387,31,658.0,0
1,1,26,139,-2156,2295,-525,-169,-356,462.66,50,-2162.0,0
0,1,1,1022,698,324,-188,-182,-6,128.73333333333332,30,1066.0,1
0,1,0,471,618,-147,-194,-166,-28,197.28571428571428,7,618.0,0
0,1,0,124,-623,747,-286,-183,-103,281.42857142857144,35,-744.0,1
0,1,22,700,-737,1437,-174,-191,17,298.3541666666667,48,701.0,1
0,1,0,1516,973,543,-208,-231,23,256.23809523809524,21,1516.0,1
0,1,0,1441,873,568,-191,-166,-25,163.76470588235293,34,873.0,0
0,1,0,1377,-581,1958,-219,-331,112,463.04545454545456,44,1378.0,1
1,1,33,661,-872,1533,-311,-168,-143,303.78,50,664.0,1
1,1,0,408,851,-443,-243,-168,-75,145.47058823529412,34,392.0,1
1,1,19,716,-725,1441,-223,-29,-194,340.8888888888889,45,720.0,1
0,1,10,999,1527,-528,-136,-119,-17,205.68,25,997.0,1
0,1,13,606,-989,1595,-258,-226,-32,405.36842105263156,38,-989.0,0
0,1,0,506,228,278,-239,-266,27,177.4,15,453.0,1
0,1,0,945,195,750,-254,-337,83,452.29411764705884,17,946.0,1
0,1,39,732,-1013,1745,-257,-128,-129,358.48979591836735,49,-1015.0,0
0,1,0,968,839,129,-190,-230,40,170.625,8,970.0,1
0,1,36,1419,722,697,231,-240,471,225.1875,32,713.0,0
0,1,32,1370,672,698,-312,-26,-286,258.4074074074074,27,671.0,0
0,1,7,490,-673,1163,-157,-148,-9,295.36842105263156,38,488.0,1
0,1,0,869,-479,1348,-272,-294,22,371.27777777777777,36,852.0,1
0,1,7,260,161,99,-423,-411,-12,245.14814814814815,81,1197.0,1
0,1,21,886,590,296,-198,-167,-31,93.71428571428571,28,847.0,1
0,1,13,1602,554,1048,-250,-186,-64,307.20588235294116,34,548.0,0
0,1,0,294,178,116,-612,-646,34,105.85714285714286,7,178.0,0
0,1,0,752,-1403,2155,-241,-25,-216,456.4791666666667,48,752.0,1
0,1,0,625,630,-5,-97,74,-171,45.0,10,625.0,0
0,1,12,14,540,-526,-494,-144,-350,182.575,40,588.0,0
0,1,9,1168,551,617,-222,-211,-11,179.24242424242425,33,1164.0,1
0,1,0,1067,268,799,-279,-339,60,241.84615384615384,39,1062.0,1
0,1,22,789,-967,1756,-282,-174,-108,355.6326530612245,49,790.0,1
0,1,6,1084,707,377,-133,-120,-13,138.69230769230768,26,1075.0,1
0,1,0,542,543,-1,-224,-179,-45,32.8,5,540.0,0
0,1,5,1371,504,867,-227,-83,-144,232.60526315789474,38,486.0,0
1,1,29,227,144,83,-562,-517,-45,279.3965517241379,58,225.0,0
1,1,72,360,443,-83,-264,-262,-2,78.1304347826087,23,314.0,1
0,1,0,659,-512,1171,-265,-241,-24,344.9714285714286,35,661.0,1
0,1,0,505,448,57,-190,-179,-11,24.333333333333332,6,517.0,0
0,1,0,422,-464,886,-230,-181,-49,229.94871794871796,39,-438.0,0
0,1,56,1060,859,201,-175,-128,-47,110.10526315789474,19,856.0,0
0,1,8,536,-1192,1728,-246,-15,-231,352.0816326530612,49,537.0,1
0,1,0,540,520,20,-125,49,-174,56.666666666666664,6,542.0,0
0,1,0,910,-636,1546,-267,-14,-253,525.7586206896551,29,910.0,1
0,1,0,498,413,85,-285,-34,-251,107.2,5,495.0,0
0,1,20,1,70,-69,-697,-614,-83,150.9,30,15.0,0
0,1,21,930,-845,1775,-159,-91,-68,378.04347826086956,46,932.0,1
1,1,52,220,168,52,-483,-536,53,119.0909090909091,11,219.0,0
1,1,62,74,1064,-990,-297,-187,-110,264.27027027027026,37,1069.0,0
0,1,0,1091,746,345,-260,-175,-85,245.0,14,1085.0,1
0,1,0,174,-255,429,-569,-366,-203,183.43478260869566,23,150.0,1
0,1,0,533,507,26,-121,54,-175,43.25,4,502.0,0
0,1,0,13,25,-12,-428,-382,-46,113.5,2,13.0,0
1,1,25,184,-182,366,-536,-397,-139,200.4,20,185.0,1
0,1,0,482,-426,908,-241,-179,-62,254.2,40,482.0,1
0,1,0,520,562,-42,-143,-44,-99,77.5,6,521.0,0
0,1,0,793,-1249,2042,-180,21,-201,423.6986301369863,73,795.0,1
0,1,21,3,-187,190,-713,-491,-222,81.25,28,3.0,1
0,1,16,1043,-1187,2230,-136,-40,-96,309.28169014084506,71,-1175.0,0
0,1,5,476,605,-129,-265,-26,-239,132.25,16,647.0,0
0,1,4,846,-422,1268,-291,-183,-108,303.48837209302326,43,848.0,1
0,1,0,1225,857,368,-178,-148,-30,207.05555555555554,18,1225.0,1
0,1,40,485,461,24,-118,113,-231,20.0,2,446.0,0
0,1,6,439,-553,992,-221,-29,-192,204.27083333333334,48,440.0,1
0,1,19,870,648,222,-193,-181,-12,106.76190476190476,21,871.0,1
0,1,0,364,384,-20,-524,-382,-142,103.33333333333333,21,364.0,0
0,1,0,269,336,-67,-535,-518,-17,79.52,50,272.0,0
0,1,0,932,237,695,-198,-291,93,456.3529411764706,17,933.0,1
0,1,12,1137,-1028,2165,-179,-18,-161,327.22727272727275,66,1136.0,1
0,1,0,603,-354,957,-193,-165,-28,367.40909090909093,44,605.0,1
0,1,0,516,500,16,-75,48,-123,93.5,2,515.0,0
0,1,0,785,-2,787,-220,-162,-58,451.52941176470586,17,784.0,1
0,1,1,1114,163,951,-224,-272,48,260.97297297297297,37,173.0,0
0,1,44,609,-1034,1643,-248,-38,-210,304.6111111111111,54,-1043.0,0
0,1,0,595,573,22,-142,-25,-117,41.61538461538461,13,599.0,0
0,1,9,1481,988,493,-159,-55,-104,177.66666666666666,27,988.0,0
0,1,0,508,492,16,-120,-20,-100,35.666666666666664,6,482.0,0
1,1,0,821,-1932,2753,-188,33,-221,304.032967032967,91,-1177.0,1
1,1,0,607,493,114,-62,19,-81,93.92,25,608.0,1
1,1,30,968,1572,-604,-121,9,-130,176.42857142857142,35,968.0,1
0,1,0,657,-491,1148,-221,-255,34,303.42105263157896,38,658.0,1
0,1,7,1248,935,313,-243,-117,-126,124.17391304347827,23,935.0,0
0,1,47,654,648,6,-293,-247,-46,63.666666666666664,6,676.0,0
0,1,29,757,1335,-578,-296,-41,-255,289.10526315789474,19,1320.0,0
0,1,1,1073,1064,9,-106,-61,-45,96.0,2,1074.0,0
0,1,0,614,607,7,-136,-130,-6,58.46666666666667,15,564.0,0
0,1,0,618,586,32,-132,7,-139,37.86666666666667,15,605.0,0
1,1,12,1209,24,1185,-172,-645,473,375.54285714285714,35,1211.0,1
1,1,0,34,420,-386,-641,-230,-411,190.41379310344828,29,38.0,1
0,1,0,470,474,-4,-105,-2,-103,60.86666666666667,30,501.0,0
0,1,0,1014,586,428,-227,-107,-120,154.78571428571428,28,577.0,0
0,1,13,1292,-270,1562,-190,-432,242,351.93333333333334,45,1293.0,1
0,1,0,448,493,-45,-230,-206,-24,156.7608695652174,46,449.0,0
0,1,0,758,988,-230,269,-254,523,238.1,10,756.0,1
0,1,4,840,465,375,-236,-137,-99,195.41463414634146,41,1068.0,1
0,1,55,745,-961,1706,-223,-154,-69,341.38,50,741.0,1
0,1,0,1743,1113,630,-195,-203,8,233.26923076923077,26,1734.0,1
0,1,10,454,-769,1223,-260,-189,-71,260.89130434782606,46,452.0,1
0,1,17,430,497,-67,-271,-224,-47,161.52272727272728,44,411.0,0
0,1,0,758,286,472,-250,-286,36,379.15384615384613,13,757.0,1
0,1,0,430,-394,824,-230,-192,-38,242.57142857142858,35,430.0,1
0,1,0,982,-137,1119,-185,-318,133,503.1304347826087,23,981.0,1
0,1,0,1245,114,1131,-207,-167,-40,306.69444444444446,36,1243.0,1
0,1,0,1262,289,973,-254,-317,63,518.2631578947369,19,1255.0,1
0,1,0,422,145,277,-225,-311,86,258.51612903225805,31,423.0,1
0,1,0,506,-524,1030,-138,-155,17,264.025,40,-524.0,0
0,1,0,979,-225,1204,-210,-285,75,541.5454545454545,22,979.0,1
0,1,24,90,526,-436,-298,-198,-100,231.38888888888889,18,525.0,0
0,1,59,1135,176,959,-369,-500,131,354.4074074074074,27,174.0,0
0,1,0,1187,240,947,-203,-266,63,260.5833333333333,36,1174.0,1
0,1,2,205,-1628,1833,-533,-168,-365,376.82,50,-1628.0,0
0,1,84,191,-1058,1249,-224,-164,-60,352.4117647058824,34,-1058.0,0
0,1,67,200,-1792,1992,-373,-146,-227,432.89130434782606,46,-1792.0,0
0,1,10,464,-407,871,-224,-216,-8,202.6904761904762,42,439.0,1
0,1,0,962,926,36,-212,-185,-27,317.9056603773585,53,112.0,1
0,1,39,219,-723,942,-477,-163,-314,303.7878787878788,33,-721.0,0
0,1,24,878,-1209,2087,-190,-76,-114,415.7,50,877.0,1
0,1,74,241,219,22,-493,-420,-73,37.0,1,234.0,0
0,1,44,1443,1500,-57,-74,-54,-20,38.0,1,1467.0,0
0,1,0,779,739,40,-141,-149,8,55.666666666666664,3,775.0,0
0,1,52,399,-460,859,-224,-162,-62,322.2962962962963,27,-477.0,0
0,1,0,845,548,297,-148,-192,44,150.66666666666666,21,847.0,1
0,1,3,422,277,145,-196,-313,117,169.62962962962962,27,115.0,1
0,1,0,937,-607,1544,-171,-221,50,393.38461538461536,39,935.0,1
0,1,53,696,1439,-743,-269,-225,-44,221.27272727272728,33,702.0,1
0,1,0,2112,1415,697,-185,-183,-2,305.90909090909093,22,2104.0,1
0,1,34,204,-206,410,-560,-479,-81,163.96153846153845,26,203.0,1
0,1,3,423,-808,1231,-243,-196,-47,246.48979591836735,49,420.0,1
0,1,0,1105,287,818,-190,-300,110,321.1034482758621,29,1104.0,1
1,1,46,929,539,390,-259,-192,-67,155.07407407407408,27,906.0,1
1,1,36,1250,-1919,3169,-115,-85,-30,484.77272727272725,66,1256.0,1
0,1,5,992,600,392,-231,-151,-80,176.08695652173913,23,590.0,0
0,1,1,446,611,-165,-260,-227,-33,178.5625,48,447.0,1
0,1,43,1457,467,990,-98,-108,10,243.78571428571428,42,445.0,0
0,1,0,1178,674,504,-185,-182,-3,228.45454545454547,22,1179.0,1
0,1,5,424,-486,910,-199,-113,-86,239.33333333333334,39,-484.0,0
0,1,0,807,420,387,-205,-276,71,357.8181818181818,11,806.0,1
0,1,90,1378,1529,-151,-154,-52,-102,73.88235294117646,17,1375.0,1
0,1,13,1343,468,875,-213,-164,-49,221.71052631578948,38,1337.0,1
0,1,29,533,-462,995,-219,-172,-47,242.6,40,-439.0,0
0,1,10,589,1207,-618,-175,-169,-6,225.1153846153846,26,623.0,1
0,1,0,1009,441,568,-158,-235,77,413.2142857142857,14,1005.0,1
0,1,64,1340,525,815,-194,-120,-74,250.63636363636363,33,1335.0,1
0,1,24,1442,581,861,-127,-154,27,231.27777777777777,36,616.0,0
0,1,0,928,698,230,-142,-197,55,173.23076923076923,13,927.0,1
0,1,22,1950,1159,791,-151,-190,39,196.4,40,1154.0,0
0,1,9,434,-411,845,-234,-257,23,233.05555555555554,36,436.0,1
0,1,0,491,606,-115,-227,-237,10,208.75510204081633,49,492.0,1
0,1,0,202,-233,435,-481,-450,-31,154.46428571428572,28,-226.0,0
0,1,0,1933,1298,635,-234,-184,-50,295.57142857142856,21,1923.0,1
0,1,47,1518,602,916,-183,-169,-14,239.48717948717947,39,599.0,0
0,1,7,771,-813,1584,-268,-221,-47,391.075,40,-813.0,0
0,1,51,510,-435,945,-252,-121,-131,284.8787878787879,33,510.0,1
0,1,66,1497,590,907,-273,-159,-114,249.78378378378378,37,1487.0,1
1,1,15,837,528,309,-108,-158,50,140.0,20,836.0,1
1,1,27,1032,-1030,2062,-179,-168,-11,463.97727272727275,44,-1028.0,0
0,1,16,878,335,543,-131,-230,99,191.82142857142858,28,879.0,1
0,1,0,197,-315,512,-476,-314,-162,197.73076923076923,26,197.0,1
0,1,4,1287,719,568,-281,-205,-76,205.48275862068965,29,1287.0,1
0,1,0,840,-16,856,-256,-327,71,398.40909090909093,22,841.0,1
0,1,0,794,-249,1043,-182,-318,136,486.72727272727275,22,794.0,1
0,1,67,5,16,-11,-696,-780,84,151.66666666666666,3,8.0,0
0,1,0,1338,424,914,-229,-360,131,447.6190476190476,21,1339.0,1
0,1,14,164,1327,-1163,-511,-190,-321,306.3076923076923,39,162.0,1
1,1,53,207,-15,222,-529,-756,227,127.95454545454545,22,-9.0,0
0,1,0,1289,440,849,-203,-200,-3,228.74545454545455,55,464.0,0
1,1,3,1244,466,778,-195,-150,-45,241.36363636363637,33,451.0,0
0,1,47,1,-16,17,-703,-686,-17,147.66666666666666,21,3.0,0
0,1,78,26,-11,37,-747,-756,9,94.66666666666667,3,7.0,0
0,1,71,8,0,8,-645,-643,-2,42.0,7,-25.0,0
0,1,0,895,-428,1323,-230,-325,95,267.36,50,-281.0,1
0,1,21,1062,1041,21,-167,-71,-96,103.69444444444444,36,1052.0,0
1,1,31,206,196,10,-480,-444,-36,103.25,16,207.0,0
0,1,24,1922,1886,36,-69,-4,-65,112.61538461538461,26,1918.0,0
0,1,16,1056,-525,1581,-160,-62,-98,396.390243902439,41,1057.0,1
0,1,0,794,-897,1691,-193,-229,36,533.6875,32,795.0,1
0,1,0,690,68,622,-191,-550,359,297.07142857142856,42,-190.0,1
0,1,0,430,-289,719,-253,-389,136,222.76470588235293,34,-257.0,0
0,1,11,770,-1250,2020,-242,-190,-52,373.14814814814815,54,-1250.0,0
1,1,17,771,1140,-369,-129,-8,-121,136.16,25,770.0,1
0,1,0,1543,1333,210,-153,-170,17,230.2,10,1540.0,1
0,1,46,333,444,-111,-247,-176,-71,109.875,16,474.0,0
0,1,5,1248,509,739,-170,-187,17,216.8235294117647,34,1247.0,1
0,1,0,709,-823,1532,-196,-204,8,398.7435897435897,39,705.0,1
0,1,0,1095,1053,42,-173,-168,-5,289.6111111111111,54,1093.0,0
0,1,29,1750,500,1250,-274,-109,-165,343.8888888888889,36,510.0,0
0,1,19,250,-316,566,-491,-536,45,205.82758620689654,29,-329.0,0
0,1,11,582,359,223,-410,-461,51,179.86666666666667,15,328.0,0
0,1,0,730,-45,775,-204,-567,363,468.1,20,731.0,1
0,1,0,458,423,35,-117,-43,-74,52.0,15,469.0,0
1,1,36,1280,-1,1281,-277,-776,499,418.3529411764706,34,-33.0,0
0,1,0,750,-278,1028,-216,-330,114,303.55555555555554,36,-276.0,0
0,1,0,302,-412,714,-514,-512,-2,417.27777777777777,18,302.0,1
0,1,5,405,-866,1271,-239,5,-244,346.0,36,-866.0,0
0,1,1,455,-1910,2365,-208,-58,-150,472.3,50,438.0,1
0,1,11,236,333,-97,-480,-480,0,108.14285714285714,7,320.0,0
0,1,3,11,-14,25,-789,-705,-84,46.5,2,6.0,0
0,1,0,1122,693,429,-229,-277,48,317.7142857142857,14,1124.0,1
0,1,35,520,1976,-1456,-195,-95,-100,316.4468085106383,47,2007.0,0
0,1,0,1658,1168,490,-166,-222,56,262.7368421052632,19,1654.0,1
0,1,0,572,437,135,-219,-255,36,228.66666666666666,6,572.0,1
0,1,10,536,-393,929,-220,-127,-93,245.68421052631578,38,535.0,1
0,1,0,779,408,371,-174,-233,59,293.61538461538464,13,780.0,1
0,1,9,1580,614,966,-221,-170,-51,212.11111111111111,45,614.0,0
0,1,0,502,171,331,-248,-218,-30,362.9,10,503.0,1
0,1,0,602,302,300,-414,-317,-97,138.52,25,266.0,0
0,1,65,172,-118,290,-365,-171,-194,92.51612903225806,31,-109.0,0
0,1,14,725,-1285,2010,-216,-196,-20,343.5,58,-1284.0,0
0,1,34,457,209,248,-220,-425,205,96.96825396825396,63,92.0,1
0,1,6,253,-255,508,-465,-364,-101,210.79166666666666,24,236.0,1
0,1,54,28,217,-189,-512,-364,-148,125.3125,16,233.0,0
0,1,10,687,-552,1239,-185,-190,5,313.05128205128204,39,687.0,1
0,1,50,207,250,-43,-571,-446,-125,117.48529411764706,68,210.0,0
0,1,0,1154,794,360,-256,-705,449,406.86486486486484,37,1155.0,1
0,1,0,908,480,428,-230,-305,75,192.4090909090909,22,849.0,1
0,1,3,233,602,-369,-86,-123,37,189.92307692307693,26,253.0,1
0,1,0,1529,1174,355,-336,-281,-55,145.04166666666666,24,1527.0,1
0,1,17,335,617,-282,-288,-226,-62,194.0,14,614.0,0
0,1,0,960,588,372,-165,-243,78,158.0,24,962.0,1
0,1,5,184,705,-521,-292,-273,-19,280.725,40,-127.0,1
1,1,74,663,770,-107,-208,-65,-143,75.72727272727273,33,860.0,0
1,1,36,184,-1677,1861,-419,-85,-334,272.8857142857143,70,-1671.0,0
1,1,64,60,2070,-2010,-503,-210,-293,324.96774193548384,62,2067.0,0
1,1,71,14,1248,-1234,-370,-197,-173,225.07272727272726,55,1252.0,0
1,1,71,177,799,-622,-430,-163,-267,190.48979591836735,49,906.0,1
0,1,0,793,260,533,-307,-521,214,243.08333333333334,24,260.0,0
1,1,49,1386,-7,1393,-253,-829,576,285.188679245283,53,-39.0,0
0,1,24,1456,1891,-435,-150,-193,43,162.5185185185185,27,1454.0,1
0,1,33,666,-1029,1695,-226,-167,-59,371.1521739130435,46,-1019.0,0
0,1,74,1371,445,926,-244,-250,6,263.5,34,1365.0,1
0,1,54,244,-2200,2444,-427,-218,-209,467.0566037735849,53,-2198.0,0
0,1,39,661,-854,1515,-289,-281,-8,273.5272727272727,55,664.0,1
0,1,0,285,282,3,-486,-363,-123,39.42857142857143,21,282.0,0
0,1,0,693,707,-14,-233,-237,4,302.7857142857143,28,693.0,0
0,1,0,1585,1568,17,-122,-134,12,112.5,4,1588.0,0
1,1,99,209,29,180,-594,-668,74,136.4375,16,34.0,0
0,1,58,943,-838,1781,-238,-191,-47,366.5625,48,941.0,1
0,1,18,802,-1030,1832,-165,-136,-29,271.53731343283584,67,803.0,1
0,1,0,464,-510,974,-263,-263,0,280.57142857142856,35,465.0,1
0,1,14,516,992,-476,-84,-83,-1,158.07142857142858,28,523.0,1
0,1,66,1542,495,1047,-232,-211,-21,267.625,40,1543.0,1
0,1,37,1,-2,3,-822,-757,-65,184.66666666666666,12,2.0,0
1,1,29,20,16,4,-839,-731,-108,135.0,16,15.0,0
0,1,68,230,239,-9,-566,-613,47,130.6818181818182,44,84.0,1
0,1,44,551,733,-182,-95,17,-112,86.22727272727273,22,543.0,1
0,1,16,299,197,102,-480,-471,-9,100.5813953488372,43,299.0,1
0,1,7,188,182,6,-462,-546,84,172.77777777777777,81,187.0,0
0,1,35,275,832,-557,-488,-207,-281,239.56,25,274.0,1
0,1,6,909,-993,1902,-312,-198,-114,344.56363636363636,55,912.0,1
0,1,0,1012,728,284,-209,-263,54,269.2,10,1012.0,1
0,1,11,504,-467,971,-158,-127,-31,242.3,40,-478.0,0
0,1,0,696,102,594,-184,-608,424,411.1875,32,-189.0,1
0,1,60,523,-524,1047,-194,-142,-52,280.72972972972974,37,522.0,1
0,1,0,911,725,186,-249,-272,23,282.2857142857143,7,893.0,1
0,1,0,998,442,556,-32,-279,247,392.2857142857143,14,1002.0,1
0,1,18,500,-525,1025,-171,-129,-42,276.7837837837838,37,500.0,1
0,1,8,248,-1303,1551,-436,-264,-172,352.4782608695652,46,268.0,1
0,1,0,961,684,277,-210,-255,45,336.55555555555554,9,962.0,1
0,1,1,860,-513,1373,-277,-236,-41,239.61016949152543,59,866.0,1
0,1,0,1002,793,209,-220,-240,20,255.25,8,992.0,1
0,1,22,1200,-836,2036,-233,55,-288,311.265625,64,-799.0,0
0,1,5,513,201,312,-242,-371,129,117.62962962962963,27,518.0,1
0,1,0,999,460,539,-263,-369,106,394.07142857142856,14,992.0,1
0,1,17,757,-456,1213,-196,-184,-12,236.24074074074073,54,755.0,1
0,1,12,604,-1,605,-197,-506,309,239.5185185185185,27,583.0,1
0,1,0,2128,1506,622,-195,-217,22,266.375,24,2129.0,1
0,1,0,514,-478,992,-193,-257,64,259.87179487179486,39,-496.0,0
0,1,0,1902,1374,528,-254,-329,75,168.0,33,1510.0,1
0,1,17,250,-1775,2025,-209,-161,-48,331.0,60,-1777.0,0
0,1,0,1981,1383,598,-168,-62,-106,223.03846153846155,26,1383.0,0
0,1,30,1203,920,283,-258,-170,-88,89.35483870967742,31,906.0,0
0,1,0,1462,1045,417,-217,49,-266,148.19230769230768,26,1045.0,0
0,1,0,1274,413,861,-273,-155,-118,235.44444444444446,36,413.0,0
0,1,4,231,-188,419,-549,-476,-73,163.27586206896552,29,232.0,1
0,1,19,1491,927,564,-180,-63,-117,150.10526315789474,38,1485.0,1
0,1,0,1107,285,822,-254,-383,129,467.8888888888889,18,1101.0,1
0,1,0,836,360,476,-161,-177,16,148.28947368421052,38,870.0,1
0,1,0,351,335,16,-319,-321,2,177.0,1,335.0,0
0,1,0,1746,1147,599,-191,-211,20,216.71428571428572,28,1756.0,1
0,1,0,1224,384,840,-180,-293,113,480.3333333333333,18,1219.0,1
0,1,15,491,-721,1212,-212,-175,-37,300.775,40,-721.0,0
0,1,25,196,-1791,1987,-455,-120,-335,342.96666666666664,60,-1804.0,0
0,1,0,925,640,285,-101,-205,104,303.7,10,921.0,1
0,1,0,878,431,447,-218,-219,1,222.35,20,879.0,1
0,1,7,1302,716,586,-191,-62,-129,222.30769230769232,26,716.0,0
0,1,0,676,580,96,-227,-250,23,156.83333333333334,6,677.0,0
0,1,0,1117,408,709,-171,-332,161,436.1764705882353,17,408.0,0
0,1,43,50,48,2,-731,-707,-24,132.83333333333334,12,51.0,0
0,1,29,662,-640,1302,-302,-216,-86,206.67948717948718,78,-642.0,0
0,1,55,1087,967,120,-162,-213,51,104.33333333333333,12,1087.0,1
0,1,8,240,-778,1018,-245,-206,-39,310.1875,32,-778.0,0
0,1,0,1375,1179,196,-198,-241,43,185.1818181818182,11,1375.0,1
0,1,0,199,-75,274,-594,-638,44,411.0,7,-75.0,0
0,1,9,264,-245,509,-523,-510,-13,144.0857142857143,35,264.0,1
0,1,35,304,-248,552,-493,-467,-26,218.15384615384616,26,-261.0,0
0,1,13,400,2121,-1721,-296,-44,-252,416.6341463414634,41,2121.0,0
0,1,0,868,-1167,2035,-119,-205,86,388.64814814814815,54,869.0,1
0,1,0,983,-417,1400,-186,-290,104,514.3928571428571,28,984.0,1
0,1,13,544,-950,1494,-306,59,-365,448.6666666666667,33,-951.0,0
0,1,0,669,478,191,-224,-238,14,208.44444444444446,9,670.0,1
1,1,31,626,-533,1159,-214,-201,-13,264.0444444444444,45,625.0,1
0,1,0,1258,549,709,-178,-228,50,234.43333333333334,30,1260.0,1
0,1,0,509,491,18,-98,-132,34,120.67241379310344,58,501.0,0
0,1,0,225,-966,1191,-321,-116,-205,395.73333333333335,30,-966.0,0
0,1,0,180,633,-453,-292,-166,-126,152.8095238095238,42,81.0,1
1,1,46,1096,1368,-272,-370,21,-391,160.72,25,1377.0,0
0,1,41,1763,1216,547,-110,-56,-54,192.63333333333333,30,1208.0,0
0,1,8,1328,547,781,-143,-108,-35,243.87878787878788,33,1324.0,1
0,1,0,1120,-409,1529,-213,-280,67,425.6216216216216,37,-436.0,0
1,1,37,17,224,-207,-760,-542,-218,116.82608695652173,23,15.0,1
0,1,24,251,-2216,2467,-425,-178,-247,424.45762711864404,59,-2210.0,0
0,1,39,140,-1893,2033,-533,7,-540,390.76363636363635,55,142.0,1
0,1,17,267,-578,845,-470,-131,-339,259.3142857142857,35,268.0,1
0,1,0,1043,693,350,-207,-231,24,291.2307692307692,13,1042.0,1
0,1,0,398,568,-170,-274,-184,-90,95.24,25,598.0,0
0,1,0,455,-472,927,-241,-213,-28,214.4047619047619,42,455.0,1
0,1,0,1212,569,643,-196,-335,139,399.0,17,1209.0,1
1,1,42,765,-1159,1924,-260,-114,-146,464.76190476190476,42,-1198.0,0
1,1,58,1652,1530,122,-82,-12,-70,61.285714285714285,21,1494.0,0
0,1,17,228,-2138,2366,-461,-182,-279,401.96610169491527,59,-2134.0,0
0,1,0,819,255,564,-230,-313,83,364.3125,16,822.0,1
0,1,42,1246,-615,1861,-219,-214,-5,266.8705882352941,85,1246.0,1
0,1,0,1580,784,796,-194,-189,-5,284.60714285714283,28,1572.0,1
1,1,7,217,-224,441,-497,-457,-40,199.5,24,216.0,1
1,1,11,384,-587,971,-294,-209,-85,239.125,40,386.0,1
0,1,7,356,-543,899,-231,-165,-66,255.44117647058823,34,-543.0,0
0,1,13,396,-469,865,-280,-153,-127,174.75862068965517,58,-510.0,0
0,1,0,1005,-260,1265,-209,-306,97,432.94594594594594,37,1007.0,1
0,1,0,1449,918,531,-186,-278,92,386.5,14,1450.0,1
1,1,75,606,445,161,-210,-92,-118,101.72222222222223,18,421.0,0
0,1,0,479,-775,1254,-116,-169,53,304.0243902439024,41,470.0,1
1,1,64,536,711,-175,-89,-5,-84,88.6,15,691.0,0
1,1,29,191,1677,-1486,-653,-141,-512,308.08,50,1687.0,0
1,1,40,790,1238,-448,-211,-33,-178,125.65714285714286,35,787.0,1
1,1,36,692,2097,-1405,-122,-80,-42,320.7906976744186,43,2080.0,0
0,1,10,1175,1188,-13,-175,-164,-11,38.0,1,1187.0,0
1,1,0,313,-548,861,-231,-89,-142,236.91666666666666,36,-540.0,0
1,1,34,931,588,343,-210,-137,-73,179.26315789473685,19,589.0,0
0,1,61,294,-435,729,-234,-128,-106,278.0,26,-438.0,0
0,1,0,737,269,468,-171,-416,245,236.75,24,738.0,1
1,1,7,447,-485,932,-228,-136,-92,260.44444444444446,36,-484.0,0
1,1,43,901,415,486,-188,-177,-11,177.26923076923077,26,900.0,1
1,1,60,493,582,-89,-75,-163,88,60.0,26,494.0,0
0,1,0,558,510,48,-141,-183,42,282.5934065934066,91,559.0,0
0,1,32,149,1118,-969,-266,-125,-141,395.5416666666667,24,1110.0,0
0,1,0,37,22,15,-875,-805,-70,81.25,8,35.0,0
0,1,24,587,522,65,-131,-169,38,64.90243902439025,41,542.0,0
0,1,0,809,-391,1200,-206,-193,-13,225.92727272727274,55,761.0,1
0,1,0,476,480,-4,-212,-199,-13,41.857142857142854,21,544.0,0
0,1,0,1255,-143,1398,-141,-266,125,540.5769230769231,26,1235.0,1
0,1,1,243,212,31,-454,-248,-206,69.95,40,245.0,0
0,1,2,479,502,-23,350,356,-6,35.9,10,479.0,0
0,1,22,1518,472,1046,-257,-220,-37,285.0810810810811,37,1498.0,1
0,1,1,1607,663,944,-166,-86,-80,204.73469387755102,49,1614.0,1
0,1,5,37,70,-33,-822,-855,33,112.5,2,36.0,0
0,1,1,1196,1158,38,-193,-179,-14,91.44444444444444,9,1152.0,0
0,1,15,838,-876,1714,-293,-252,-41,312.1111111111111,54,-857.0,0
0,1,0,523,519,4,-106,-113,7,140.0,2,522.0,0
0,1,15,42,2,40,-729,-737,8,77.4,10,60.0,0
0,1,3,773,788,-15,-195,-191,-4,26.533333333333335,15,771.0,0
0,1,2,648,1246,-598,-319,-68,-251,220.4516129032258,31,1361.0,1
0,1,11,544,-476,1020,-393,-157,-236,210.24074074074073,54,648.0,1
0,1,5,1383,257,1126,-305,-532,227,247.75510204081633,49,234.0,0
0,1,14,448,565,-117,-253,-55,-198,235.69767441860466,43,449.0,1
0,1,23,161,-317,478,-548,-476,-72,159.27586206896552,29,-319.0,0
0,1,0,940,212,728,-163,-240,77,348.1904761904762,21,941.0,1
0,1,0,1151,1169,-18,-99,-59,-40,35.125,8,1148.0,0
1,1,24,623,197,426,-155,-415,260,173.375,32,624.0,1
1,1,36,248,575,-327,-547,-205,-342,175.04347826086956,23,247.0,1
0,1,0,791,-377,1168,-221,-142,-79,349.27777777777777,36,-377.0,0
0,1,0,912,423,489,-178,-257,79,347.7142857142857,14,913.0,1
0,1,0,933,200,733,-201,-215,14,404.36842105263156,19,936.0,1
0,1,2,515,472,43,-52,57,-109,64.0,4,519.0,0
0,1,0,10,-38,48,-743,-709,-34,47.44444444444444,9,15.0,0
0,1,0,1396,387,1009,-261,-510,249,198.5,58,340.0,0
0,1,0,663,686,-23,-180,-107,-73,37.5,12,704.0,0
1,1,0,0,-16,16,-798,-726,-72,84.15,20,5.0,0
1,1,0,1146,824,322,-271,-171,-100,167.9,20,1148.0,1
0,1,0,315,375,-60,-636,-626,-10,72.75,12,316.0,0
0,1,55,1229,1222,7,-282,-317,35,68.0,1,1230.0,0
0,1,0,181,189,-8,-514,-583,69,133.5,50,180.0,0
0,1,0,344,385,-41,-543,-503,-40,60.111111111111114,9,346.0,0
0,1,10,1294,1300,-6,-172,-87,-85,9.75,8,1293.0,0
0,1,0,885,586,299,-295,-155,-140,150.06896551724137,29,512.0,0
0,1,0,286,-247,533,-566,-442,-124,163.13513513513513,37,287.0,1
0,1,24,436,648,-212,-363,-215,-148,153.23529411764707,17,669.0,0
0,1,16,857,-1143,2000,-173,-142,-31,332.91525423728814,59,867.0,1
0,1,0,23,22,1,-872,-763,-109,82.2,15,26.0,0
0,1,0,778,988,-210,-235,-197,-38,135.46666666666667,15,988.0,0
0,1,3,442,-450,892,-139,-186,47,251.19444444444446,36,447.0,1
0,1,0,7,-32,39,-564,-510,-54,123.66666666666667,3,4.0,0
0,1,8,190,871,-681,-507,-149,-358,221.37142857142857,35,190.0,1
0,1,0,1108,278,830,-169,-360,191,481.77777777777777,18,1110.0,1
0,1,0,21,155,-134,-466,-502,36,96.11363636363636,44,23.0,1
1,1,110,217,-4,221,-510,-752,242,112.4,35,217.0,1
0,1,0,872,569,303,-219,-239,20,268.6666666666667,12,873.0,1
0,1,0,702,-431,1133,-245,-318,73,500.8695652173913,23,701.0,1
0,1,0,701,-156,857,-127,-529,402,380.0769230769231,26,707.0,1
0,1,52,63,-216,279,-582,-481,-101,163.0,17,-213.0,0
0,1,0,2053,1190,863,-306,-200,-106,323.51851851851853,27,1190.0,0
0,1,13,591,-1201,1792,-261,-153,-108,329.68518518518516,54,-1201.0,0
0,1,30,225,-229,454,-477,-461,-16,195.04,25,227.0,1
0,1,26,584,-192,776,-185,-408,223,234.94285714285715,35,-201.0,0
0,1,0,235,59,176,-535,-543,8,254.71428571428572,7,237.0,1
0,1,8,599,-497,1096,260,167,93,358.6333333333333,30,-498.0,0
0,1,0,348,-397,745,-208,-142,-66,230.85714285714286,35,-427.0,0
1,1,44,713,-1113,1826,-170,-121,-49,239.64473684210526,76,711.0,1
1,1,72,521,697,-176,-116,-112,-4,67.91304347826087,23,560.0,1
1,1,49,545,-941,1486,-138,4,-142,219.59420289855072,69,547.0,1
0,1,2,924,1343,-419,-181,-15,-166,150.3783783783784,74,916.0,1
1,1,56,161,-188,349,-458,-396,-62,110.4,30,162.0,1
0,1,15,1415,1263,152,-155,-84,-71,104.25,16,1402.0,1
0,1,0,653,-798,1451,-242,-248,6,473.258064516129,31,655.0,1
0,1,52,76,2,74,-300,-522,222,114.0909090909091,11,13.0,0
0,1,0,183,450,-267,-247,-212,-35,190.26666666666668,15,480.0,0
0,1,0,1033,338,695,-211,-291,80,384.3157894736842,19,1036.0,1
1,1,59,1421,425,996,-142,-98,-44,180.94545454545454,55,427.0,0
1,1,0,1587,-2,1589,-85,-453,368,266.63492063492066,63,-25.0,0
0,1,50,1126,575,551,-414,-193,-221,153.1818181818182,44,503.0,0
0,1,0,883,609,274,-298,-284,-14,258.27272727272725,11,886.0,1
0,1,21,471,-377,848,-245,-203,-42,255.42424242424244,33,-377.0,0
0,1,0,645,154,491,-220,-320,100,386.6923076923077,13,637.0,1
0,1,0,644,-614,1258,-285,-236,-49,289.06976744186045,43,-614.0,0
0,1,31,1365,644,721,-311,-131,-180,212.75757575757575,33,639.0,0
0,1,0,889,492,397,-205,-227,22,372.3636363636364,11,886.0,1
0,1,27,358,-598,956,-271,-184,-87,284.24242424242425,33,-599.0,0
0,1,0,421,4,417,-241,-254,13,325.84615384615387,13,413.0,1
0,1,0,1486,772,714,-260,-183,-77,266.55555555555554,27,772.0,0
0,1,0,1357,218,1139,-316,-508,192,298.8205128205128,39,1358.0,1
0,1,72,1317,224,1093,-167,-493,326,245.0408163265306,49,178.0,0
0,1,0,352,-448,800,-279,-250,-29,301.10714285714283,28,297.0,1
1,1,0,871,-247,1118,-186,-310,124,393.6034482758621,58,871.0,1
0,1,25,276,502,-226,-277,-220,-57,91.12,25,275.0,1
0,1,11,870,-548,1418,-214,-244,30,350.95,40,872.0,1
1,1,64,243,-205,448,-542,-521,-21,184.41666666666666,24,228.0,1
1,1,57,1205,711,494,-220,-147,-73,143.8780487804878,41,670.0,0
1,1,65,727,1222,-495,-216,-196,-20,166.53333333333333,30,1230.0,0
0,1,0,1666,825,841,-158,-86,-72,290.2903225806452,31,1669.0,1
0,1,0,1216,737,479,-150,-260,110,366.2142857142857,14,1218.0,1
1,1,33,238,238,0,-443,-453,10,86.24324324324324,37,237.0,0
1,1,0,779,-1183,1962,-182,-175,-7,411.4583333333333,48,777.0,1
0,1,87,181,211,-30,-404,-508,104,153.0,5,217.0,0
0,1,0,1096,612,484,-249,-308,59,382.84615384615387,13,1080.0,1
0,1,31,1912,1035,877,-164,-208,44,226.1315789473684,38,1028.0,0
0,1,0,826,-495,1321,-164,-276,112,352.2280701754386,57,828.0,1
0,1,0,1639,490,1149,-208,-55,-153,254.04651162790697,43,1640.0,1
0,1,17,542,-467,1009,-227,-192,-35,274.6756756756757,37,-481.0,0
0,1,0,616,-1277,1893,-211,-242,31,485.6666666666667,39,617.0,1
0,1,0,239,251,-12,-506,-371,-135,6.0,1,238.0,0
0,1,36,204,-252,456,-575,-468,-107,169.5185185185185,27,-261.0,0
0,1,0,1586,614,972,-212,-55,-157,278.7142857142857,35,614.0,0
0,1,0,554,-1227,1781,-203,-89,-114,509.8,35,-1227.0,0
0,1,0,595,-442,1037,-175,-44,-131,268.2368421052632,38,-442.0,0
0,1,0,2149,1979,170,-171,-123,-48,153.9090909090909,11,1979.0,0
0,1,0,588,651,-63,-175,-102,-73,260.02777777777777,36,165.0,1
0,1,0,320,-996,1316,-277,-200,-77,410.15625,32,-996.0,0
0,1,0,1216,642,574,-271,-277,6,395.4,15,1216.0,1
0,1,20,480,-500,980,-225,-227,2,289.6470588235294,34,-499.0,0
0,1,0,495,491,4,-252,-131,-121,246.24528301886792,53,481.0,0
0,1,0,799,-1201,2000,-208,-203,-5,455.22727272727275,44,-1201.0,0
0,1,0,524,-385,909,-131,-62,-69,231.94871794871796,39,-385.0,0
0,1,1,1548,654,894,-196,-98,-98,247.83783783783784,37,629.0,0
0,1,0,336,-189,525,-490,-376,-114,165.91666666666666,48,233.0,1
0,1,0,773,-752,1525,-170,-142,-28,351.59090909090907,44,776.0,1
0,1,0,1894,1374,520,-250,-267,17,220.95652173913044,23,1893.0,1
0,1,30,0,-254,254,-729,-379,-350,88.0,28,-2.0,1
0,1,0,1081,251,830,-220,-202,-18,379.27272727272725,22,1080.0,1
0,1,0,496,-565,1061,-213,-212,-1,358.0,30,497.0,1
0,1,13,233,311,-78,-477,-404,-73,140.87777777777777,90,307.0,0
0,1,0,1133,1211,-78,-219,-175,-44,348.75,44,1142.0,0
0,1,35,2004,1250,754,-204,-207,3,215.0,34,1260.0,0
0,1,0,278,-1226,1504,-607,-749,142,548.3571428571429,28,279.0,1
0,1,0,1039,-683,1722,-261,-802,541,581.6875,32,1040.0,1
0,1,42,118,254,-136,-518,-551,33,134.66666666666666,9,253.0,0
0,1,21,19,226,-207,-728,-403,-325,160.59375,32,13.0,1
0,1,8,296,305,-9,-421,-428,7,33.0,1,303.0,0
0,1,0,923,810,113,-393,-232,-161,134.42857142857142,35,1083.0,1
0,1,0,915,1317,-402,-542,-46,-496,227.43333333333334,90,2130.0,1
0,1,8,1245,387,858,-199,-231,32,231.30555555555554,36,387.0,0
0,1,0,1459,1422,37,-176,-113,-63,97.3913043478261,23,1563.0,1
1,1,0,549,-882,1431,-310,-151,-159,175.6346153846154,104,719.0,1
0,1,21,212,-214,426,-483,-392,-91,119.13953488372093,43,214.0,1
0,1,20,595,223,372,-182,-403,221,192.15384615384616,26,190.0,0
0,1,11,216,1272,-1056,-449,-6,-443,171.40506329113924,79,1384.0,1
0,1,49,278,476,-198,-263,-91,-172,137.31034482758622,58,765.0,1
0,1,0,487,158,329,-272,-311,39,274.3333333333333,12,469.0,1
0,1,0,988,-253,1241,-245,-325,80,545.0,23,988.0,1
0,1,53,405,-464,869,-222,-237,15,317.7857142857143,28,-485.0,0
0,1,0,1028,-177,1205,-208,-342,134,490.0,25,1010.0,1
0,1,0,1056,-179,1235,-207,-306,99,575.6363636363636,22,1057.0,1
0,1,0,456,-479,935,-180,-233,53,222.8139534883721,43,460.0,1
0,1,31,445,-851,1296,-276,-234,-42,415.741935483871,31,-853.0,0
0,1,0,577,-615,1192,-224,-196,-28,363.4848484848485,33,590.0,1
0,1,0,1511,686,825,-171,-276,105,295.625,32,1571.0,1
0,1,0,828,-1065,1893,-264,-142,-122,628.5,30,828.0,1
0,1,0,1027,-946,1973,-294,-372,78,565.4571428571429,35,1028.0,1
0,1,0,597,-774,1371,-239,-187,-52,311.97727272727275,44,599.0,1
1,1,31,663,-1259,1922,-235,-81,-154,312.3225806451613,62,-1277.0,0
1,1,32,592,-1961,2553,-308,-33,-275,400.90625,64,-1982.0,0
0,1,0,951,-442,1393,-176,-336,160,572.48,25,952.0,1
0,1,35,181,206,-25,-264,-485,221,224.37037037037038,27,-92.0,1
0,1,15,572,-1211,1783,-362,-199,-163,231.25581395348837,86,656.0,1
1,1,35,890,782,108,-197,-120,-77,73.12903225806451,31,959.0,1
1,1,26,164,-1041,1205,-288,-39,-249,271.84444444444443,45,-1041.0,0
0,1,46,1271,-850,2121,-189,-221,32,406.0576923076923,52,-851.0,0
0,1,0,741,-1299,2040,-264,-244,-20,393.25,52,-1299.0,0
0,1,0,588,-814,1402,-225,-170,-55,378.4864864864865,37,570.0,1
0,1,15,24,-236,260,-565,-468,-97,139.78947368421052,19,-237.0,0
0,1,0,925,-174,1099,-246,-317,71,508.40909090909093,22,929.0,1
0,1,27,251,231,20,-535,-464,-71,147.46,50,248.0,0
0,1,0,647,-461,1108,-260,-274,14,448.32,25,648.0,1
0,1,0,127,338,-211,-266,-254,-12,286.7142857142857,7,338.0,0
0,1,0,814,491,323,-269,-320,51,293.8333333333333,12,812.0,1
0,1,0,233,-237,470,-607,-556,-51,371.3076923076923,13,-237.0,0
0,1,0,9,-137,146,-495,-503,8,146.4,10,8.0,1
0,1,54,510,-586,1096,-215,-196,-19,263.4,45,510.0,1
0,1,84,185,1341,-1156,-658,-161,-497,345.77777777777777,36,1358.0,0
1,1,9,205,-183,388,-483,-459,-24,182.2173913043478,23,204.0,1
1,1,8,800,465,335,-65,-157,92,125.1842105263158,38,867.0,1
0,1,41,1259,687,572,-159,-125,-34,185.1290322580645,31,686.0,0
0,1,1,656,-850,1506,-222,-138,-84,311.0612244897959,49,-850.0,0
0,1,20,1068,-19,1087,-196,-807,611,318.3333333333333,39,1073.0,1
0,1,0,1599,968,631,-132,-185,53,302.8181818181818,22,1603.0,1
0,1,27,814,-718,1532,-262,-158,-104,310.2040816326531,49,-713.0,0
0,1,0,1046,715,331,-186,-275,89,323.27272727272725,11,715.0,0
0,1,0,1,343,-342,-482,-505,23,171.35,20,-0.0,1
0,1,0,1241,260,981,-139,-253,114,368.82142857142856,28,1242.0,1
0,1,0,1489,788,701,-213,-300,87,431.8235294117647,17,788.0,0
0,1,32,277,-506,783,-270,-156,-114,260.8,30,-504.0,0
0,1,17,1056,454,602,-187,-134,-53,225.26923076923077,26,453.0,0
0,1,0,599,415,184,-191,-230,39,260.5,8,600.0,1
0,1,41,885,1304,-419,-490,-83,-407,258.1666666666667,18,1312.0,0
0,1,10,270,-678,948,-300,-257,-43,290.6363636363636,33,-688.0,0
0,1,0,225,-157,382,-555,-565,10,347.90909090909093,11,226.0,1
0,1,0,692,461,231,-282,-253,-29,229.86486486486487,37,693.0,1
0,1,55,72,1293,-1221,-673,-188,-485,307.9761904761905,42,1294.0,0
0,1,23,2154,-262,2416,-202,-563,361,396.1111111111111,63,2157.0,1
0,1,36,1896,-203,2099,-350,-467,117,381.7857142857143,56,1898.0,1
0,1,0,881,-184,1065,-242,-279,37,492.90909090909093,22,882.0,1
0,1,6,944,-1065,2009,-233,-238,5,280.30555555555554,72,951.0,1
1,1,39,1063,496,567,-236,-183,-53,260.0,22,478.0,0
1,1,26,77,-1173,1250,-461,-164,-297,361.8,35,-1175.0,0
0,1,28,127,-438,565,-234,-136,-98,298.05263157894734,19,-439.0,0
0,1,0,1032,958,74,-194,-184,-10,63.27272727272727,11,958.0,0
0,1,22,1655,-251,1906,-281,-479,198,380.2692307692308,52,1662.0,1
0,1,4,1199,601,598,-148,-140,-8,176.27272727272728,33,601.0,0
0,1,3,1673,1753,-80,-106,-133,27,60.714285714285715,7,1672.0,0
0,1,0,14,544,-530,-757,-261,-496,378.2916666666667,24,15.0,1
0,1,8,155,-954,1109,-582,-309,-273,281.3255813953488,43,162.0,1
0,1,0,980,-676,1656,-243,-322,79,504.030303030303,33,1099.0,1
0,1,0,860,-252,1112,-174,-240,66,509.54545454545456,22,861.0,1
1,1,16,1,205,-204,-768,-566,-202,156.6875,16,1.0,1
1,1,17,648,-1146,1794,-247,-122,-125,297.31666666666666,60,651.0,1
0,1,0,1569,662,907,-248,-407,159,429.3636363636364,22,1570.0,1
0,1,0,186,-215,401,-508,-286,-222,298.05882352941177,17,187.0,1
0,1,1,469,1091,-622,-186,-231,45,219.07407407407408,27,468.0,1
1,1,40,182,448,-266,-439,-232,-207,132.16666666666666,24,444.0,0
1,1,38,249,421,-172,-410,-235,-175,128.94117647058823,17,248.0,1
0,1,64,408,401,7,-197,-208,11,160.42857142857142,56,-45.0,1
0,1,31,1851,193,1658,-72,-242,170,311.1320754716981,53,200.0,0
0,1,0,1368,468,900,-180,-257,77,364.68,25,468.0,0
0,1,22,869,480,389,350,-286,636,167.83333333333334,24,469.0,0
0,1,0,424,-85,509,-211,-260,49,376.0,14,418.0,1
0,1,16,1244,-212,1456,-256,-559,303,355.79545454545456,44,1246.0,1
0,1,31,22,175,-153,-744,-525,-219,141.5,16,191.0,0
0,1,30,441,216,225,-253,-417,164,148.3,20,201.0,0
0,1,9,599,276,323,-190,-370,180,115.37142857142857,35,600.0,1
0,1,0,1185,865,320,-217,-128,-89,292.3636363636364,11,865.0,0
0,1,0,898,592,306,-235,-263,28,251.83333333333334,12,899.0,1
0,1,0,829,586,243,-186,-308,122,278.8,10,830.0,1
0,1,0,755,801,-46,-299,-194,-105,95.0,8,801.0,0
0,1,0,920,-796,1716,-218,-162,-56,548.0,31,921.0,1
0,1,40,332,238,94,-469,-461,-8,97.58333333333333,12,332.0,0
0,1,0,314,323,-9,-477,-486,9,67.94285714285714,35,310.0,0
0,1,0,420,-534,954,-233,-336,103,390.56,25,426.0,1
0,1,0,721,-219,940,-215,-307,92,421.0869565217391,23,724.0,1
0,1,0,281,307,-26,-523,-518,-5,91.75,4,279.0,0
0,1,4,1517,775,742,-184,-128,-56,217.5,34,1515.0,1
0,1,15,723,-907,1630,-227,-160,-67,360.73333333333335,45,-899.0,0
0,1,15,515,-695,1210,-219,-144,-75,205.72413793103448,58,-567.0,1
0,1,0,1005,347,658,-223,-325,102,424.5625,16,998.0,1
0,1,0,1841,566,1275,-226,-166,-60,354.1666666666667,36,566.0,0
0,1,0,952,740,212,-136,-192,56,308.125,8,944.0,1
0,1,4,471,-466,937,-223,-160,-63,241.52631578947367,38,472.0,1
0,1,0,1197,447,750,-173,-245,72,450.8235294117647,17,447.0,0
0,1,3,169,-1518,1687,-490,-84,-406,346.3061224489796,49,-1518.0,0
0,1,26,470,-426,896,-190,-228,38,302.56666666666666,30,-437.0,0
0,1,0,978,-1029,2007,-292,-140,-152,448.0,45,-1029.0,0
0,1,0,1257,-1112,2369,-153,-67,-86,474.4,50,-1112.0,0
0,1,20,900,430,470,-159,-198,39,206.77272727272728,22,898.0,1
0,1,0,1421,576,845,-206,-248,42,440.6,20,1422.0,1
0,1,0,1720,1163,557,-177,-141,-36,193.86206896551724,29,1718.0,1
0,1,0,252,19,233,-552,-716,164,128.6,25,255.0,1
0,1,21,241,-446,687,-533,-169,-364,243.43333333333334,30,242.0,1
0,1,5,195,-1613,1808,-471,-109,-362,377.125,48,196.0,1
0,1,0,1875,1218,657,-161,-125,-36,196.15151515151516,33,1218.0,0
0,1,3,448,-537,985,-235,-115,-120,282.6857142857143,35,-537.0,0
0,1,0,258,-256,514,-479,-601,122,337.6875,16,255.0,1
0,1,0,1059,536,523,-187,-268,81,353.3333333333333,15,536.0,0
0,1,2,2050,1407,643,-143,-76,-67,206.96774193548387,31,1407.0,0
0,1,35,1728,740,988,-208,-195,-13,200.8125,48,746.0,0
0,1,0,515,-514,1029,-171,-63,-108,241.11363636363637,44,514.0,1
0,1,3,488,-587,1075,-193,-82,-111,237.95652173913044,46,499.0,1
0,1,0,867,-374,1241,-171,-202,31,327.46,50,-569.0,1
0,1,0,269,569,-300,-515,-417,-98,344.8888888888889,9,270.0,1
0,1,22,890,-1014,1904,-156,-145,-11,397.2916666666667,48,-1008.0,0
0,1,0,1026,229,797,-176,-513,337,393.27272727272725,22,1027.0,1
0,1,3,239,-557,796,-538,-35,-503,239.86111111111111,36,-557.0,0
0,1,0,298,-31,329,-495,-736,241,138.62962962962962,27,299.0,1
0,1,0,215,-206,421,-490,-318,-172,122.76470588235294,34,-198.0,0
0,1,3,526,-537,1063,-213,-7,-206,256.0975609756098,41,518.0,1
0,1,30,426,200,226,-235,-241,6,192.0,42,426.0,1
0,1,54,1249,-479,1728,-280,-186,-94,360.8125,48,1251.0,1
0,1,54,8,-212,220,-793,-472,-321,152.04545454545453,22,9.0,1
0,1,0,1567,1266,301,-166,-224,58,202.4,15,1555.0,1
0,1,25,1166,269,897,-194,-181,-13,301.46666666666664,30,1174.0,1
0,1,50,248,-801,1049,-673,-135,-538,279.0416666666667,48,278.0,1
0,1,0,917,619,298,-203,-253,50,276.27272727272725,11,918.0,1
0,1,0,1955,1468,487,-156,-147,-9,217.0909090909091,22,1941.0,1
0,1,42,256,304,-48,-469,-468,-1,108.36666666666666,30,258.0,0
0,1,0,617,-774,1391,-208,-196,-12,324.1860465116279,43,618.0,1
0,1,0,1,-1440,1441,-646,-314,-332,458.55882352941177,34,2.0,1
0,1,23,1150,483,667,-198,-187,-11,181.58333333333334,36,1150.0,1
0,1,86,701,-1121,1822,-270,-185,-85,403.68888888888887,45,703.0,1
0,1,19,1272,1313,-41,-241,-157,-84,93.3225806451613,31,1382.0,0
0,1,0,557,-465,1022,-183,-220,37,260.275,40,558.0,1
0,1,0,759,-622,1381,-146,-201,55,354.0,39,-622.0,0
0,1,10,1601,965,636,-189,-181,-8,160.17948717948718,39,1599.0,1
0,1,34,713,-791,1504,-161,-151,-10,276.6181818181818,55,715.0,1
0,1,42,249,-780,1029,-648,-163,-485,274.1111111111111,45,-778.0,0
0,1,0,931,-475,1406,-226,-279,53,545.4230769230769,26,932.0,1
0,1,36,660,-1436,2096,-202,-190,-12,439.27272727272725,44,-1436.0,0
0,1,41,424,1554,-1130,-530,-135,-395,308.57894736842104,38,1541.0,0
0,1,0,1996,1506,490,-136,-263,127,240.0952380952381,21,1992.0,1
0,1,0,1809,823,986,-159,-163,4,352.60714285714283,28,823.0,0
0,1,0,728,-900,1628,-142,-154,12,304.8679245283019,53,722.0,1
0,1,54,679,2281,-1602,-337,-195,-142,356.4222222222222,45,2308.0,0
0,1,0,644,-747,1391,-194,-146,-48,316.5681818181818,44,-747.0,0
0,1,70,6,-606,612,-474,-174,-300,251.53846153846155,26,1.0,1
0,1,0,1117,-175,1292,-202,-325,123,514.6153846153846,26,1120.0,1
0,1,0,730,312,418,-229,-232,3,333.8333333333333,12,726.0,1
0,1,56,192,1964,-1772,-513,-50,-463,370.42,50,190.0,1
0,1,0,504,-455,959,-284,-286,2,539.3888888888889,18,505.0,1
0,1,0,442,-308,750,-261,-260,-1,507.6666666666667,15,-308.0,0
0,1,44,33,215,-182,-792,-540,-252,124.0,22,36.0,1
0,1,11,545,-436,981,-231,-305,74,292.2647058823529,34,546.0,1
0,1,0,1451,365,1086,-261,-387,126,533.047619047619,21,1451.0,1
0,1,5,497,490,7,-238,-242,4,153.825,40,500.0,0
0,1,0,1743,1091,652,-174,-180,6,246.07407407407408,27,1752.0,1
0,1,5,467,253,214,-368,-490,122,168.15384615384616,13,253.0,0
0,1,0,1581,34,1547,-189,-690,501,510.65625,32,1579.0,1
0,1,0,510,312,198,-163,-175,12,170.0,9,459.0,1
0,1,17,251,-1482,1733,-476,-242,-234,358.7551020408163,49,244.0,1
0,1,5,627,-967,1594,-218,-207,-11,323.265306122449,49,630.0,1
0,1,0,722,-515,1237,-189,-255,66,335.64864864864865,37,714.0,1
0,1,17,1567,496,1071,-145,-246,101,332.71875,32,1568.0,1
0,1,0,1479,702,777,-199,-177,-22,217.14285714285714,35,1461.0,1
0,1,9,1214,546,668,-98,-114,16,206.45454545454547,33,1215.0,1
0,1,0,929,-926,1855,-219,-249,30,463.225,40,930.0,1
0,1,28,429,-490,919,-285,-271,-14,247.51351351351352,37,430.0,1
0,1,39,1417,230,1187,-247,-446,199,295.95238095238096,42,207.0,0
0,1,0,931,-532,1463,-283,-299,16,505.8965517241379,29,932.0,1
0,1,26,174,956,-782,-486,-189,-297,239.82857142857142,35,177.0,1
0,1,19,814,-744,1558,-224,-246,22,310.82,50,-747.0,0
0,1,19,1294,955,339,-252,-203,-49,124.03703703703704,27,940.0,0
0,1,27,383,-431,814,-262,-193,-69,316.46153846153845,26,-452.0,0
0,1,16,241,-2110,2351,-489,-128,-361,441.31481481481484,54,-2121.0,0
0,1,16,917,303,614,-174,-428,254,214.25,32,918.0,1
0,1,0,220,-481,701,-503,-534,31,414.7647058823529,17,221.0,1
0,1,24,732,-768,1500,-142,-200,58,319.5777777777778,45,735.0,1
0,1,33,290,-545,835,-260,-175,-85,305.77777777777777,27,-547.0,0
0,1,0,249,-10,259,-573,-592,19,277.4,10,252.0,1
0,1,0,250,1138,-888,-548,-248,-300,251.05263157894737,38,249.0,1
0,1,2,923,-799,1722,-300,-87,-213,345.16326530612247,49,924.0,1
0,1,0,242,-47,289,-556,-557,1,312.2,10,245.0,1
0,1,0,591,-363,954,-182,-285,103,348.92857142857144,28,591.0,1
0,1,17,322,520,-198,-515,-119,-396,174.45,20,520.0,0
0,1,0,878,-91,969,-228,-586,358,503.1363636363636,22,879.0,1
0,1,5,1163,440,723,-138,-215,77,162.2439024390244,41,1116.0,1
0,1,0,119,-455,574,-369,-146,-223,273.53225806451616,62,614.0,1
0,1,0,774,830,-56,-227,-118,-109,83.85714285714286,7,830.0,0
0,1,0,1635,1080,555,-195,-134,-61,229.48,25,1080.0,0
0,1,0,203,69,134,-621,-547,-74,247.83333333333334,6,202.0,1
0,1,0,198,-201,399,-528,-482,-46,218.1,20,199.0,1
0,1,0,1156,603,553,-185,-503,318,278.54545454545456,22,1153.0,1
0,1,23,370,-919,1289,-237,-214,-23,340.18918918918916,37,-909.0,0
0,1,0,272,-223,495,-537,-516,-21,223.54545454545453,22,278.0,1
0,1,0,1847,1180,667,-167,-151,-16,251.85185185185185,27,1180.0,0
0,1,0,670,496,174,-242,-228,-14,277.57142857142856,7,496.0,0
0,1,0,623,10,613,-260,-626,366,294.7391304347826,46,-332.0,1
0,1,0,739,571,168,-224,-290,66,236.375,8,739.0,1
0,1,0,741,659,82,-141,-324,183,227.0,7,742.0,0
0,1,51,233,-564,797,-284,-257,-27,278.7857142857143,28,-563.0,0
0,1,0,843,403,440,-190,-307,117,330.93333333333334,15,845.0,1
0,1,58,254,1307,-1053,-475,-255,-220,276.02564102564105,39,253.0,1
0,1,23,2,-8,10,-522,-495,-27,3.0,1,1.0,0
0,1,0,1485,898,587,-233,-310,77,348.6470588235294,17,898.0,0
0,1,0,308,146,162,-507,-544,37,245.57142857142858,7,302.0,1
0,1,43,1927,2059,-132,-184,-138,-46,82.26666666666667,15,1925.0,1
1,1,29,1860,524,1336,-233,-186,-47,287.8510638297872,47,498.0,0
0,1,51,207,-208,415,-525,-497,-28,138.12820512820514,39,29.0,1
0,1,0,1045,-512,1557,-223,-329,106,529.1666666666666,30,-512.0,0
0,1,22,310,276,34,-512,-529,17,102.58620689655173,29,154.0,1
0,1,13,220,255,-35,-526,-382,-144,189.46938775510205,49,221.0,0
0,1,14,1573,83,1490,-249,-90,-159,225.15277777777777,72,81.0,0
0,1,0,1024,504,520,-221,-289,68,389.1333333333333,15,1025.0,1
0,1,0,861,498,363,-255,-272,17,347.27272727272725,11,863.0,1
1,1,39,177,-203,380,-538,-514,-24,123.1470588235294,34,175.0,1
0,1,0,1354,1442,-88,-201,-78,-123,122.42857142857143,7,1442.0,0
0,1,8,679,-2193,2872,-243,-96,-147,470.655737704918,61,-2194.0,0
0,1,34,640,-512,1152,-210,-151,-59,320.47222222222223,36,642.0,1
0,1,0,435,28,407,-183,-221,38,329.7857142857143,14,437.0,1
0,1,28,392,-559,951,-175,-96,-79,342.57142857142856,28,-560.0,0
0,1,0,273,-605,878,-553,-517,-36,426.09090909090907,22,275.0,1
0,1,29,1553,480,1073,-112,-131,19,227.94827586206895,58,1555.0,1
0,1,18,500,447,53,-157,-185,28,70.40384615384616,52,481.0,0
0,1,16,797,794,3,-33,-44,11,80.72727272727273,55,787.0,0
1,1,7,853,-1649,2502,-57,-100,43,390.25757575757575,66,-1649.0,0
1,1,12,9,2210,-2201,-761,-204,-557,367.0,61,8.0,1
1,1,28,463,-503,966,-98,-89,-9,239.33333333333334,42,464.0,1
1,1,45,830,937,-107,-249,-33,-216,67.8,20,933.0,0
1,1,35,0,-884,884,-477,-225,-252,234.30769230769232,39,-895.0,0
0,1,29,687,-927,1614,-138,-130,-8,353.65909090909093,44,-877.0,0
0,1,16,10,-242,252,-736,-405,-331,138.94117647058823,34,8.0,1
1,1,23,1515,1375,140,-142,25,-167,94.9375,16,1517.0,1
1,1,20,219,-78,297,-448,-75,-373,131.4814814814815,27,219.0,1
0,1,6,764,2104,-1340,-156,21,-177,345.2368421052632,38,2092.0,0
0,1,0,1528,544,984,-202,-73,-129,260.3076923076923,39,524.0,0
0,1,0,996,451,545,-113,-237,124,365.9375,16,997.0,1
0,1,49,559,-794,1353,-193,-123,-70,340.2307692307692,39,-778.0,0
0,1,27,725,482,243,-132,47,-179,82.39285714285714,28,724.0,1
0,1,63,772,2054,-1282,-251,-119,-132,321.3333333333333,39,2055.0,0
0,1,26,229,65,164,-465,-179,-286,91.14285714285714,21,211.0,1
0,1,0,766,-159,925,-195,-245,50,239.75,40,767.0,1
0,1,65,7,-15,22,-757,-731,-26,122.26666666666667,45,4.0,0
0,1,32,1,6,-5,-735,-640,-95,178.85714285714286,21,1.0,0
0,1,2,8,16,-8,-734,-715,-19,75.91666666666667,24,8.0,0
0,1,39,20,20,0,-695,-678,-17,95.16666666666667,6,-22.0,0
0,1,0,1088,-395,1483,-194,-625,431,555.0689655172414,29,-395.0,0
0,1,0,210,-585,795,-518,-274,-244,314.84313725490193,51,-949.0,1
0,1,0,1219,957,262,-253,-267,14,248.27272727272728,11,957.0,0
0,1,22,236,-86,322,-398,-73,-325,108.68571428571428,35,236.0,1
0,1,0,899,561,338,-242,-192,-50,324.0,12,898.0,1
0,1,0,300,-182,482,-545,-576,31,333.06666666666666,15,301.0,1
0,1,25,562,-1105,1667,-254,-195,-59,387.8837209302326,43,-1114.0,0
0,1,21,104,-797,901,-320,-129,-191,281.28125,32,-811.0,0
0,1,0,292,-428,720,-522,-537,15,245.03125,32,278.0,1
0,1,0,1517,1034,483,-30,-33,3,188.6,25,1516.0,1
0,1,0,699,-725,1424,-198,-337,139,398.72222222222223,36,696.0,1
0,1,30,717,-1242,1959,-295,-183,-112,350.23636363636365,55,718.0,1
0,1,28,194,-558,752,-222,-153,-69,280.53846153846155,26,-552.0,0
0,1,0,230,-312,542,-564,-450,-114,163.3939393939394,33,231.0,1
0,1,0,3,64,-61,-762,-764,2,46.0,14,4.0,0
0,1,3,682,-969,1651,-242,106,-348,264.2769230769231,65,-954.0,0
0,1,4,1831,1838,-7,-162,-1,-161,46.5,2,1835.0,0
0,1,61,575,-1099,1674,-232,-139,-93,335.9387755102041,49,-1117.0,0
0,1,34,426,-581,1007,-212,-163,-49,201.8985507246377,69,310.0,1
1,1,58,895,-891,1786,-184,-165,-19,338.4727272727273,55,896.0,1
0,1,0,768,143,625,-165,-386,221,446.46666666666664,15,770.0,1
0,1,37,255,-165,420,-559,-478,-81,194.72727272727272,22,-167.0,0
0,1,0,640,650,-10,-246,-223,-23,227.625,40,630.0,0
0,1,0,28,153,-125,-501,-482,-19,177.75,8,15.0,1
0,1,19,1139,1868,-729,-141,-18,-123,279.36,25,1860.0,0
0,1,0,954,-1142,2096,-175,-60,-115,470.6,45,956.0,1
0,1,0,773,-646,1419,-204,-748,544,566.5862068965517,29,775.0,1
0,1,0,1893,1265,628,-210,-156,-54,197.1875,32,1265.0,0
0,1,7,1497,695,802,-228,-132,-96,277.3333333333333,30,1500.0,1
0,1,0,277,-47,324,-489,-509,20,283.8333333333333,12,275.0,1
0,1,0,284,-56,340,-539,-546,7,248.71428571428572,14,284.0,1
0,1,24,200,-218,418,-500,-473,-27,153.26666666666668,30,-242.0,0
0,1,30,948,460,488,-300,-220,-80,192.28,25,461.0,0
0,1,0,940,580,360,-192,-279,87,334.27272727272725,11,940.0,1
0,1,12,283,-1781,2064,-466,-169,-297,378.43636363636364,55,-1780.0,0
0,1,60,480,185,295,-188,-407,219,172.85714285714286,35,43.0,1
0,1,5,251,-220,471,-567,-579,12,204.25,24,250.0,1
0,1,0,671,-543,1214,-224,-296,72,490.08,25,671.0,1
0,1,33,856,-319,1175,-183,-430,247,288.6190476190476,42,-321.0,0
0,1,1,635,-1057,1692,-273,-155,-118,342.16326530612247,49,-1057.0,0
0,1,1,537,-621,1158,-225,-200,-25,354.09090909090907,33,537.0,1
0,1,0,712,-499,1211,-202,-177,-25,284.1111111111111,45,715.0,1
0,1,0,1158,742,416,-196,-425,229,346.42857142857144,14,1128.0,1
0,1,32,2,-257,259,-757,-475,-282,147.3421052631579,38,1.0,1
0,1,47,745,-1045,1790,-186,-213,27,396.7173913043478,46,-1075.0,0
0,1,17,1134,-778,1912,-288,-158,-130,469.3414634146341,41,1133.0,1
0,1,0,1500,570,930,-247,-178,-69,234.68421052631578,38,554.0,0
0,1,6,1864,866,998,-242,-204,-38,247.975,40,866.0,0
0,1,2,10,-37,47,-666,-495,-171,117.93333333333334,15,-40.0,0
0,1,0,527,566,-39,-211,-243,32,188.64864864864865,37,528.0,0
0,1,16,6,170,-164,-748,-556,-192,120.3125,16,5.0,1
0,1,0,865,716,149,-213,-279,66,296.8333333333333,6,864.0,1
0,1,0,718,-806,1524,-151,-239,88,332.63829787234044,47,719.0,1
0,1,74,1650,1459,191,-141,-185,44,135.46666666666667,15,1448.0,0
0,1,2,224,-1291,1515,-461,-200,-261,388.7560975609756,41,223.0,1
1,1,57,177,-13,190,-385,-719,334,130.08695652173913,23,175.0,1
0,1,0,1749,1241,508,-239,-256,17,249.04761904761904,21,1752.0,1
0,1,3,1439,468,971,-212,-210,-2,217.26666666666668,45,468.0,0
0,1,0,896,-375,1271,-178,-214,36,348.6190476190476,42,897.0,1
1,1,19,1961,2111,-150,-82,-52,-30,79.23529411764706,17,2118.0,0
1,1,26,447,683,-236,-266,-194,-72,143.88235294117646,17,692.0,0
0,1,91,596,1004,-408,-415,-136,-279,210.91304347826087,23,1034.0,0
0,1,43,699,-1125,1824,-187,-161,-26,371.34,50,-1117.0,0
0,1,0,1277,264,1013,-269,-310,41,415.04,25,1275.0,1
0,1,0,630,-367,997,-337,-343,6,315.59375,32,631.0,1
0,1,0,1189,575,614,-155,-239,84,167.1818181818182,44,1238.0,1
0,1,16,498,648,-150,-227,-78,-149,108.77777777777777,18,617.0,0
0,1,6,568,-857,1425,-264,-215,-49,318.7111111111111,45,569.0,1
0,1,15,1256,1073,183,-28,-27,-1,99.75,16,1245.0,1
1,1,45,1591,519,1072,-246,-211,-35,261.5365853658537,41,513.0,0
1,1,41,1707,523,1184,-157,-191,34,290.9756097560976,41,497.0,0
0,1,0,1067,606,461,-183,-379,196,353.125,16,1067.0,1
1,1,25,299,3,296,-553,-765,212,125.68,25,299.0,1
0,1,0,1045,607,438,-195,-470,275,343.4,15,1024.0,1
0,1,0,1896,1243,653,-189,-278,89,268.44,25,1889.0,1
0,1,0,872,216,656,-228,-698,470,340.8095238095238,42,874.0,1
0,1,19,5,-180,185,-725,-518,-207,119.36842105263158,19,-188.0,0
0,1,5,641,-528,1169,-259,-262,3,261.6666666666667,45,643.0,1
0,1,0,211,458,-247,-469,-478,9,346.625,8,209.0,1
0,1,4,141,579,-438,-544,-283,-261,202.64,25,579.0,0
1,1,25,251,-184,435,-471,-490,19,117.34210526315789,38,248.0,1
1,1,13,486,917,-431,-113,-62,-51,155.80769230769232,26,484.0,1
0,1,0,914,-352,1266,-219,-337,118,535.625,24,915.0,1
0,1,0,725,431,294,-148,-180,32,159.05555555555554,18,726.0,1
0,1,64,2027,2002,25,-151,-127,-24,60.0,1,2008.0,0
0,1,2,331,-1306,1637,-261,-62,-199,416.75,40,-1329.0,0
0,1,0,486,219,267,-237,-282,45,248.0,11,481.0,1
0,1,0,1046,-360,1406,-266,-331,65,490.17241379310343,29,1045.0,1
0,1,38,265,421,-156,-459,-136,-323,147.7,20,222.0,1
0,1,0,794,-182,976,-239,-234,-5,433.1304347826087,23,796.0,1
0,1,33,275,440,-165,-483,-279,-204,146.0,30,180.0,1
0,1,0,784,-58,842,-263,-356,93,456.42105263157896,19,786.0,1
0,1,11,543,977,-434,-272,-170,-102,207.23809523809524,21,984.0,0
0,1,13,285,-238,523,-482,-506,24,208.03703703703704,27,286.0,1
0,1,33,232,-491,723,-229,-163,-66,310.60869565217394,23,-492.0,0
0,1,49,473,-504,977,-210,-28,-182,298.030303030303,33,-517.0,0
0,1,0,1033,745,288,-225,-288,63,175.25,44,774.0,0
1,1,27,516,-610,1126,-182,-186,4,306.6756756756757,37,517.0,1
0,1,24,169,-776,945,-309,-261,-48,344.4074074074074,27,-751.0,0
0,1,0,1067,693,374,-297,-515,218,332.2307692307692,13,1069.0,1
0,1,8,1169,419,750,271,139,132,193.25641025641025,39,419.0,0
0,1,32,909,364,545,-188,-181,-7,176.2,30,360.0,0
0,1,6,424,-644,1068,-204,-157,-47,302.2,35,-640.0,0
0,1,23,1305,469,836,-294,-81,-213,251.6,35,473.0,0
0,1,0,787,-92,879,-292,-308,16,482.2105263157895,19,790.0,1
0,1,6,508,-885,1393,-296,-233,-63,312.8636363636364,44,508.0,1
0,1,45,1131,391,740,-257,-261,4,263.32142857142856,28,388.0,0
0,1,0,750,-393,1143,-221,-338,117,463.16,25,753.0,1
0,1,14,235,-612,847,-525,-218,-307,202.46666666666667,45,246.0,1
0,1,0,279,-1263,1542,-523,-658,135,578.925925925926,27,279.0,1
0,1,36,1030,-610,1640,-177,-136,-41,313.7692307692308,52,-614.0,0
0,1,39,200,-466,666,-261,-214,-47,313.77272727272725,22,-483.0,0
0,1,0,760,274,486,-206,-325,119,358.5,14,761.0,1
0,1,17,487,-494,981,-195,-193,-2,257.43243243243245,37,-489.0,0
0,1,45,508,0,508,-182,-471,289,201.60714285714286,28,-10.0,0
0,1,0,978,-81,1059,-177,-315,138,483.3181818181818,22,974.0,1
0,1,39,1042,-236,1278,-330,-537,207,309.3488372093023,43,-235.0,0
0,1,3,1187,436,751,-282,-174,-108,260.37931034482756,29,1200.0,1
0,1,2,895,-710,1605,-189,-130,-59,331.74468085106383,47,896.0,1
0,1,34,844,945,-101,-230,-167,-63,109.125,8,940.0,0
0,1,0,770,678,92,-179,-250,71,165.66666666666666,6,772.0,0
0,1,27,478,-446,924,-222,-194,-28,301.25,32,-453.0,0
0,1,0,840,667,173,-246,-273,27,201.88888888888889,9,843.0,1
0,1,42,264,1757,-1493,-280,-192,-88,415.0857142857143,35,1761.0,0
0,1,15,297,-241,538,-447,-496,49,213.8846153846154,26,298.0,1
0,1,0,897,94,803,-175,-628,453,433.04545454545456,22,898.0,1
0,1,38,231,-270,501,-475,-458,-17,181.14285714285714,28,228.0,1
0,1,0,453,-15,468,-228,-480,252,239.69230769230768,39,-205.0,1
0,1,0,904,-445,1349,-232,-324,92,501.8888888888889,27,904.0,1
0,1,16,472,-450,922,-204,-175,-29,295.1875,32,475.0,1
0,1,40,136,-438,574,-260,-156,-104,314.89473684210526,19,-460.0,0
0,1,0,886,-530,1416,-210,-307,97,495.6551724137931,29,885.0,1
0,1,30,324,490,-166,-248,-174,-74,171.3,10,495.0,0
0,1,22,32,253,-221,-725,-432,-293,117.65384615384616,26,266.0,0
0,1,0,4,196,-192,-430,-444,14,175.1818181818182,11,9.0,1
0,1,0,724,-681,1405,-225,-87,-138,262.9056603773585,53,-681.0,0
0,1,10,746,-1255,2001,-193,-197,4,352.625,56,747.0,1
0,1,3,544,-959,1503,-294,-98,-196,390.1794871794872,39,546.0,1
0,1,0,6,-164,170,-474,-486,12,129.3846153846154,13,-164.0,0
0,1,48,14,19,-5,-860,-782,-78,65.5,4,14.0,0
0,1,0,1434,-359,1793,-176,-417,241,352.1132075471698,53,1435.0,1
1,1,0,942,-927,1869,-216,-2,-214,322.8305084745763,59,-927.0,0
1,1,0,641,432,209,-205,-81,-124,90.95238095238095,21,644.0,1
0,1,0,834,321,513,-187,-278,91,383.42857142857144,14,834.0,1
0,1,28,376,557,-181,-483,-197,-286,135.95454545454547,22,568.0,0
0,1,40,846,794,52,-155,-154,-1,112.52777777777777,36,847.0,0
1,1,28,1235,927,308,-36,-39,3,120.30555555555556,36,1236.0,1
0,1,15,1330,1297,33,-96,-116,20,91.36046511627907,86,1332.0,0
0,1,12,918,236,682,-401,-368,-33,263.72,25,250.0,0
0,1,0,802,-918,1720,-208,-8,-200,336.52941176470586,51,-918.0,0
0,1,12,129,214,-85,-252,-486,234,86.36363636363636,33,127.0,0
0,1,0,769,-1170,1939,-137,-199,62,368.0,53,762.0,1
0,1,14,1544,270,1274,-224,-428,204,305.1666666666667,42,1543.0,1
0,1,54,1486,443,1043,-173,-206,33,308.97058823529414,34,441.0,0
0,1,0,719,273,446,-254,-328,74,338.7142857142857,14,720.0,1
0,1,15,1322,686,636,-131,-144,13,201.75,32,689.0,0
0,1,30,1345,276,1069,-293,-367,74,319.61764705882354,34,256.0,0
0,1,0,826,-975,1801,-164,-153,-11,352.5576923076923,52,828.0,1
0,1,0,10,2,8,-661,-629,-32,67.51724137931035,29,12.0,0
1,1,26,1541,491,1050,-169,-147,-22,225.25,48,1538.0,1
1,1,30,1013,632,381,-90,-97,7,121.02631578947368,38,1016.0,1
0,1,3,586,-488,1074,-214,-242,28,308.6857142857143,35,589.0,1
0,1,15,1222,448,774,-177,-135,-42,209.47222222222223,36,446.0,0
0,1,11,310,-553,863,-231,-156,-75,347.28,25,-562.0,0
0,1,0,1198,702,496,-317,-350,33,393.84615384615387,13,1199.0,1
0,1,13,943,862,81,-106,-125,19,125.45714285714286,70,945.0,0
0,1,0,910,456,454,-175,-275,100,368.61538461538464,13,907.0,1
0,1,16,245,-305,550,-555,-472,-83,179.56666666666666,30,-292.0,0
0,1,0,630,-544,1174,-247,-230,-17,336.90384615384613,52,-827.0,1
0,1,5,668,-1154,1822,-204,-223,19,378.9791666666667,48,669.0,1
0,1,0,595,-297,892,-222,-259,37,349.1551724137931,58,596.0,1
0,1,40,258,-1697,1955,-448,-125,-323,334.05172413793105,58,-1679.0,0
1,1,17,472,-504,976,-230,-55,-175,198.15686274509804,51,-490.0,0
1,1,13,783,-957,1740,-213,-101,-112,308.91379310344826,58,786.0,1
1,1,12,311,241,70,-490,-456,-34,120.02702702702703,37,294.0,0
0,1,0,490,-445,935,-225,-200,-25,187.79245283018867,53,484.0,1
1,1,89,12,173,-161,-751,-471,-280,130.86363636363637,22,179.0,0
1,1,59,770,-766,1536,-239,-234,-5,311.0408163265306,49,-769.0,0
0,1,0,938,-165,1103,-188,-309,121,456.25,24,906.0,1
0,1,9,890,1087,-197,-172,-196,24,83.4090909090909,22,1087.0,0
0,1,39,854,-1294,2148,-187,-188,1,367.8965517241379,58,-1295.0,0
0,1,35,231,1033,-802,-500,-255,-245,196.390243902439,41,230.0,1
1,1,27,481,-495,976,-238,-80,-158,245.2093023255814,43,482.0,1
0,1,0,274,-87,361,-483,-572,89,326.3333333333333,12,276.0,1
0,1,0,453,507,-54,-254,-83,-171,89.2,15,526.0,0
0,1,0,915,-591,1506,-101,-207,106,355.3720930232558,43,915.0,1
1,1,53,1529,1544,-15,-171,-42,-129,33.0,1,1541.0,0
1,1,33,779,247,532,-434,-372,-62,255.38095238095238,21,230.0,0
1,1,29,293,-495,788,-235,-104,-131,231.69444444444446,36,-528.0,0
1,1,50,1060,469,591,-219,-164,-55,190.2258064516129,31,468.0,0
0,1,0,564,223,341,-126,-491,365,186.22448979591837,49,565.0,1
0,1,0,801,-701,1502,-179,-133,-46,319.33870967741933,62,-932.0,1
1,1,31,1728,2069,-341,-267,-85,-182,187.55555555555554,18,2074.0,0
1,1,10,1410,1498,-88,-172,-29,-143,99.625,8,1509.0,0
1,1,44,1242,1219,23,-149,-52,-97,33.0,1,1216.0,0
1,1,43,1093,1396,-303,-141,-59,-82,123.125,24,1409.0,0
1,1,41,1024,214,810,-387,-361,-26,287.1111111111111,27,229.0,0
0,1,41,270,-511,781,-482,-89,-393,260.258064516129,31,272.0,1
0,1,30,274,-491,765,-484,-161,-323,260.59375,32,274.0,1
0,1,0,1782,1299,483,-133,-152,19,237.5,20,1774.0,1
0,1,70,1397,575,822,-177,-53,-124,230.2,35,1398.0,1
0,1,29,7,205,-198,-775,-367,-408,151.3,20,223.0,0
0,1,13,437,-492,929,-99,18,-117,223.44444444444446,45,439.0,1
0,1,29,429,-466,895,-137,-17,-120,263.8285714285714,35,426.0,1
0,1,56,1420,207,1213,-180,-457,277,281.8636363636364,44,214.0,0
0,1,0,1065,-626,1691,-184,-169,-15,381.0888888888889,45,-626.0,0
0,1,0,449,-468,917,-175,-114,-61,262.1111111111111,36,-488.0,0
1,1,22,499,-616,1115,-191,-111,-80,251.38297872340425,47,507.0,1
0,1,9,638,616,22,-165,-111,-54,55.5,4,645.0,0
0,1,0,1605,1230,375,-188,-159,-29,169.0,22,1230.0,0
0,1,0,483,-258,741,-199,-293,94,356.57142857142856,21,482.0,1
0,1,23,568,-282,850,-205,-391,186,239.55555555555554,36,-278.0,0
0,1,0,1512,1062,450,-211,-221,10,347.84615384615387,13,1062.0,0
1,1,46,917,1309,-392,-145,-108,-37,91.2051282051282,39,911.0,1
0,1,18,1106,1039,67,-117,-178,61,96.82432432432432,74,1108.0,0
1,1,50,13,312,-299,-662,-483,-179,90.74358974358974,39,11.0,1
0,1,29,1964,878,1086,-62,-91,29,201.3148148148148,54,1965.0,1
0,1,31,1580,667,913,-109,-224,115,277.62666666666667,75,1581.0,1
0,1,14,296,451,-155,-271,-264,-7,130.0,11,457.0,0
0,1,0,197,-303,500,-495,-249,-246,368.375,16,191.0,1
0,1,13,1968,1266,702,-204,-207,3,172.425,40,1268.0,0
0,1,5,206,-468,674,-464,-156,-308,194.92105263157896,38,207.0,1
0,1,0,1810,911,899,-252,-141,-111,274.8484848484849,33,911.0,0
0,1,0,539,355,184,-239,-254,15,340.5625,48,532.0,1
0,1,10,173,-604,777,-522,-237,-285,222.1578947368421,38,175.0,1
0,1,7,853,827,26,-75,73,-148,69.27272727272727,11,808.0,0
0,1,11,226,-603,829,-267,-155,-112,230.54054054054055,37,-603.0,0
0,1,11,633,-687,1320,-164,-198,34,301.29545454545456,44,634.0,1
0,1,0,1409,1134,275,-219,-174,-45,109.91666666666667,24,1134.0,0
0,1,0,230,-198,428,-621,-624,3,336.84615384615387,13,228.0,1
0,1,1,512,477,35,-273,-175,-98,62.166666666666664,6,469.0,0
0,1,0,446,461,-15,-187,-131,-56,18.0,1,443.0,0
0,1,0,893,383,510,-188,-242,54,335.4375,16,903.0,1
0,1,0,759,-1216,1975,-152,-196,44,355.7837837837838,74,757.0,1
0,1,0,2025,378,1647,-225,-323,98,539.258064516129,31,2026.0,1
0,1,1,556,-486,1042,-234,-11,-223,238.37209302325581,43,547.0,1
0,1,0,587,288,299,-266,-266,0,316.0,10,586.0,1
0,1,0,1,-181,182,-725,-396,-329,116.32,25,2.0,1
0,1,0,145,-38,183,-556,-579,23,279.2857142857143,7,144.0,1
0,1,12,307,-1017,1324,-454,-125,-329,314.8095238095238,42,-1007.0,0
0,1,0,1519,915,604,-209,-144,-65,204.16666666666666,30,915.0,0
0,1,0,669,-1378,2047,-190,-132,-58,316.46875,64,670.0,1
0,1,19,1009,-1036,2045,-137,-173,36,355.9824561403509,57,1009.0,1
0,1,0,1454,821,633,-129,-192,63,277.0,23,1449.0,1
0,1,6,795,-1176,1971,-195,-101,-94,371.3207547169811,53,-1176.0,0
0,1,0,191,591,-400,-546,-249,-297,181.11111111111111,36,192.0,1
0,1,54,278,-616,894,-237,-221,-16,311.62068965517244,29,-614.0,0
0,1,0,1299,-268,1567,-165,-701,536,332.7,50,1298.0,1
0,1,1,454,446,8,-104,-44,-60,54.8,5,452.0,0
0,1,43,315,-722,1037,-570,-197,-373,260.95238095238096,42,316.0,1
0,1,0,461,-509,970,-209,-404,195,373.75471698113205,53,-1006.0,1
0,1,42,890,1202,-312,-322,-266,-56,201.0,16,1221.0,0
0,1,19,231,-258,489,-533,-520,-13,158.26666666666668,30,-258.0,0
0,1,0,771,-904,1675,-290,-221,-69,371.44444444444446,45,-904.0,0
0,1,4,1964,1456,508,-235,-158,-77,191.37037037037038,27,1963.0,1
0,1,0,669,-897,1566,-249,-232,-17,359.69767441860466,43,-897.0,0
0,1,11,381,451,-70,-307,-210,-97,233.53658536585365,41,382.0,0
0,1,4,215,-205,420,-546,-471,-75,183.14285714285714,21,214.0,1
0,1,19,297,-225,522,-502,-423,-79,140.1578947368421,38,298.0,1
0,1,0,1533,865,668,-233,-167,-66,249.92307692307693,26,1533.0,1
0,1,0,524,952,-428,-198,-220,22,201.3181818181818,22,535.0,1
0,1,9,835,-969,1804,-188,-209,21,320.10714285714283,56,830.0,1
0,1,0,825,-767,1592,-218,-282,64,339.8936170212766,47,827.0,1
0,1,0,1338,-217,1555,-187,-593,406,520.90625,32,1336.0,1
0,1,19,472,-363,835,-236,-119,-117,295.85714285714283,28,472.0,1
0,1,4,418,-449,867,-222,-219,-3,325.3333333333333,27,420.0,1
0,1,9,979,607,372,-143,-174,31,160.2173913043478,23,987.0,1
0,1,34,29,441,-412,-401,-58,-343,187.25,28,436.0,0
0,1,0,719,-855,1574,-171,-295,124,379.0238095238095,42,720.0,1
0,1,0,1040,564,476,-297,-254,-43,233.5151515151515,33,1042.0,1
0,1,0,865,-513,1378,-146,-297,151,488.9655172413793,29,868.0,1
0,1,24,1230,294,936,-186,-445,259,220.9111111111111,45,291.0,0
0,1,66,610,628,-18,-84,-7,-77,90.80952380952381,21,613.0,0
0,1,0,540,-432,972,-142,-170,28,311.2903225806452,31,-432.0,0
0,1,30,182,1006,-824,-450,-122,-328,263.52941176470586,34,182.0,1
0,1,0,603,-284,887,-530,-545,15,255.94285714285715,35,242.0,1
0,1,11,790,-514,1304,-193,-132,-61,358.0833333333333,36,792.0,1
0,1,18,985,1222,-237,-277,-88,-189,142.15384615384616,13,1223.0,0
0,1,0,716,-1399,2115,-165,-78,-87,374.91379310344826,58,717.0,1
0,1,36,200,-1109,1309,-459,-65,-394,336.6,40,201.0,1
0,1,0,1115,-197,1312,-152,-1,-151,540.92,25,1106.0,1
0,1,12,1165,243,922,-240,-455,215,223.09302325581396,43,257.0,0
0,1,0,532,-326,858,-292,-186,-106,353.5416666666667,24,533.0,1
0,1,0,571,466,105,-226,-234,8,238.15625,32,146.0,1
0,1,0,515,-291,806,-251,-49,-202,378.6666666666667,21,512.0,1
0,1,17,1327,744,583,-215,-230,15,181.875,32,1328.0,1
1,1,48,8,-2,10,-740,-698,-42,112.13636363636364,22,7.0,0
0,1,0,1667,1077,590,-157,-182,25,194.06666666666666,30,1666.0,1
1,1,59,4,266,-262,-804,-398,-406,127.16666666666667,24,1.0,1
1,1,43,299,1981,-1682,-491,-28,-463,393.70454545454544,44,298.0,1
1,1,45,270,1334,-1064,-566,-114,-452,287.28205128205127,39,268.0,1
0,1,0,877,286,591,-127,-222,95,407.0,15,873.0,1
0,1,27,855,938,-83,-237,-211,-26,100.14285714285714,7,935.0,0
0,1,113,1328,311,1017,-314,-532,218,268.7894736842105,38,302.0,0
0,1,51,732,-952,1684,-275,-166,-109,337.2040816326531,49,739.0,1
0,1,30,409,-525,934,-202,-61,-141,279.3529411764706,34,-523.0,0
0,1,0,1206,229,977,-197,-199,2,520.8421052631579,19,1204.0,1
0,1,0,229,-274,503,-365,-286,-79,344.2631578947368,57,231.0,1
0,1,0,957,220,737,-165,-318,153,456.0,17,958.0,1
0,1,3,1995,1232,763,-180,-107,-73,203.75,36,1992.0,1
0,1,1,1403,877,526,-182,-47,-135,190.67857142857142,28,1399.0,1
1,1,18,423,1143,-720,-120,-65,-55,186.35135135135135,37,422.0,1
1,1,18,864,-1021,1885,-178,-234,56,428.6363636363636,44,-1019.0,0
0,1,22,1149,-606,1755,-262,-107,-155,384.6666666666667,45,-601.0,0
0,1,51,179,549,-370,-307,-216,-91,185.1578947368421,19,548.0,0
0,1,0,870,495,375,-185,-299,114,318.2307692307692,13,869.0,1
0,1,25,117,-267,384,-438,-401,-37,132.36363636363637,44,222.0,1
0,1,13,908,-589,1497,-202,-121,-81,294.2916666666667,72,910.0,1
0,1,0,1701,1228,473,-182,-107,-75,353.35714285714283,14,1701.0,1
0,1,0,884,-391,1275,-268,-323,55,563.3913043478261,23,890.0,1
0,1,0,1379,916,463,-208,-128,-80,189.36,25,916.0,0
1,1,28,1299,200,1099,-255,-439,184,276.1219512195122,41,203.0,0
0,1,50,239,255,-16,-451,-474,23,107.85714285714286,35,79.0,1
0,1,69,1622,-184,1806,-362,-352,-10,327.3859649122807,57,-188.0,0
0,1,22,101,-1594,1695,-414,-212,-202,449.39473684210526,38,-1613.0,0
0,1,13,587,-595,1182,-268,-138,-130,302.7692307692308,39,-598.0,0
0,1,36,191,211,-20,-500,-479,-21,110.53571428571429,28,192.0,0
1,1,0,25,13,12,-649,-626,-23,169.11764705882354,17,25.0,0
0,1,20,716,-1024,1740,-234,-171,-63,424.65,40,-1013.0,0
0,1,0,868,-383,1251,-219,-292,73,503.44,25,864.0,1
0,1,0,1905,1574,331,-198,-86,-112,288.6666666666667,12,1574.0,0
0,1,17,827,-866,1693,-193,-122,-71,345.53061224489795,49,-874.0,0
1,1,108,661,828,-167,-194,-83,-111,90.18181818181819,22,834.0,0
0,1,41,566,492,74,-209,-187,-22,122.66666666666667,63,918.0,1
0,1,3,673,-1041,1714,-178,-67,-111,264.5,64,669.0,1
0,1,11,23,567,-544,-286,-64,-222,210.23076923076923,26,573.0,0
0,1,0,1736,1302,434,-163,-12,-151,360.25,12,1723.0,1
0,1,0,385,-551,936,-264,-50,-214,229.9512195121951,41,-558.0,0
0,1,21,195,-205,400,-527,-469,-58,195.9090909090909,22,195.0,1
0,1,10,566,-529,1095,-187,-113,-74,329.2647058823529,34,567.0,1
0,1,45,16,270,-254,-695,-404,-291,113.06451612903226,31,272.0,0
0,1,22,1830,953,877,-327,-230,-97,248.6,35,947.0,0
0,1,0,984,764,220,-231,-269,38,228.1,10,987.0,1
0,1,51,199,230,-31,-553,-403,-150,90.75,4,225.0,0
0,1,0,743,-802,1545,-239,-307,68,468.4848484848485,33,-802.0,0
0,1,16,222,488,-266,-517,-178,-339,152.6,25,221.0,1
0,1,0,855,-721,1576,-347,-273,-74,348.8,45,856.0,1
0,1,0,736,-495,1231,-231,-246,15,321.13157894736844,38,736.0,1
0,1,13,504,-535,1039,-177,-191,14,349.0,30,499.0,1
0,1,0,11,-100,111,-500,-494,-6,165.42857142857142,7,12.0,1
0,1,0,630,1,629,-183,-519,336,457.2352941176471,17,631.0,1
0,1,0,217,210,7,-560,-413,-147,98.84210526315789,19,204.0,0
0,1,0,1154,787,367,-268,-261,-7,319.8333333333333,12,787.0,0
0,1,0,853,-807,1660,-174,-303,129,488.015625,64,834.0,1
0,1,67,479,-596,1075,-177,-239,62,337.375,32,-591.0,0
0,1,0,932,227,705,-289,-325,36,417.7647058823529,17,932.0,1
0,1,28,561,-823,1384,-299,-201,-98,267.11764705882354,51,-828.0,0
0,1,0,393,361,32,-278,-75,-203,95.14285714285714,7,422.0,0
0,1,0,30,37,-7,-660,-514,-146,96.66666666666667,3,18.0,0
0,1,0,259,1700,-1441,-520,-238,-282,326.7111111111111,45,1700.0,0
0,1,72,1077,300,777,-207,-515,308,237.6,35,298.0,0
0,1,0,551,-1166,1717,-334,-250,-84,356.70212765957444,47,553.0,1
0,1,15,240,518,-278,-533,-191,-342,189.30434782608697,23,519.0,0
0,1,39,205,-704,909,-517,-189,-328,214.53333333333333,45,206.0,1
0,1,21,141,247,-106,-562,-510,-52,149.14285714285714,7,252.0,0
0,1,23,447,-1211,1658,-286,-145,-141,315.0,52,-1210.0,0
0,1,7,213,-234,447,-492,-490,-2,181.875,24,-235.0,0
0,1,0,1813,986,827,-228,-286,58,269.61290322580646,31,986.0,0
0,1,0,678,-1009,1687,-293,-199,-94,356.6595744680851,47,676.0,1
0,1,18,603,-432,1035,-216,-189,-27,282.8857142857143,35,589.0,1
0,1,39,496,-483,979,-241,-185,-56,251.3421052631579,38,497.0,1
0,1,18,784,-812,1596,-221,-106,-115,324.2448979591837,49,-812.0,0
0,1,0,418,216,202,-299,-373,74,204.5609756097561,41,417.0,1
0,1,23,1095,950,145,-180,-185,5,282.14285714285717,49,1086.0,1
0,1,47,1111,5,1106,-184,-740,556,338.8378378378378,37,1110.0,1
0,1,3,930,-561,1491,-257,-157,-100,303.8979591836735,49,-561.0,0
0,1,15,525,-184,709,-219,-426,207,290.0,26,526.0,1
0,1,9,2056,1321,735,-127,-101,-26,218.57575757575756,33,2048.0,1
0,1,0,1105,710,395,-223,-247,24,349.46153846153845,13,1106.0,1
0,1,9,769,510,259,-220,-223,3,255.11627906976744,43,770.0,1
0,1,12,926,-1240,2166,-168,-64,-104,348.3125,64,925.0,1
0,1,0,447,577,-130,-129,21,-150,102.66666666666667,3,443.0,1
0,1,0,804,526,278,-140,-446,306,368.9,10,802.0,1
0,1,0,823,186,637,-178,-329,151,418.1875,16,816.0,1
0,1,43,459,445,14,-187,-180,-7,218.82692307692307,52,-96.0,1
0,1,49,592,1313,-721,-347,-223,-124,284.0,25,1317.0,0
0,1,71,445,-456,901,-265,-193,-72,254.11111111111111,36,446.0,1
0,1,0,1606,1179,427,-230,-214,-16,234.68421052631578,19,1609.0,1
0,1,3,644,-770,1414,-168,-205,37,322.04545454545456,44,644.0,1
0,1,17,1211,532,679,-103,-26,-77,203.6875,32,534.0,0
0,1,24,398,675,-277,-260,-188,-72,158.6875,16,666.0,0
0,1,0,479,489,-10,-74,-80,6,21.833333333333332,6,483.0,0
0,1,6,839,-984,1823,-164,-123,-41,373.7843137254902,51,-989.0,0
0,1,0,530,470,60,-238,-241,3,140.0,2,498.0,0
0,1,0,512,467,45,-117,-96,-21,25.434782608695652,23,552.0,0
0,1,0,454,-415,869,-241,-193,-48,273.4375,32,-418.0,0
0,1,11,263,486,-223,-407,-127,-280,167.11764705882354,17,486.0,0
0,1,0,1053,-406,1459,272,-12,284,500.8666666666667,30,-406.0,0
0,1,17,1821,254,1567,-175,-367,192,347.1333333333333,45,251.0,0
0,1,10,834,2120,-1286,-343,-190,-153,381.72727272727275,33,2120.0,0
0,1,0,1985,1393,592,-198,-85,-113,267.95652173913044,23,1989.0,1
0,1,10,1695,262,1433,-216,-341,125,363.6923076923077,39,260.0,0
0,1,15,650,-655,1305,-234,-154,-80,309.1190476190476,42,-655.0,0
1,1,58,149,-28,177,-528,-732,204,133.73684210526315,19,134.0,1
0,1,7,923,-804,1727,-151,-183,32,383.1777777777778,45,-806.0,0
0,1,7,254,-234,488,-529,-507,-22,182.85185185185185,27,224.0,1
0,1,0,230,44,186,-535,-602,67,242.77777777777777,9,231.0,1
0,1,0,492,468,24,-191,-154,-37,53.80952380952381,21,474.0,0
0,1,0,244,237,7,-554,-534,-20,102.08333333333333,12,254.0,0
0,1,21,606,-1178,1784,-193,-105,-88,401.8,45,-1187.0,0
0,1,0,415,-35,450,-241,-285,44,294.5882352941176,17,441.0,1
0,1,3,909,251,658,-244,-444,200,200.91666666666666,36,902.0,1
0,1,0,223,496,-273,-481,-377,-104,272.89130434782606,46,220.0,1
1,1,0,432,435,-3,-291,-328,37,67.68,25,429.0,0
1,1,0,970,-1026,1996,-178,-239,61,422.0,47,944.0,1
0,1,10,17,-1639,1656,-385,-191,-194,329.14,50,-1639.0,0
0,1,8,472,-485,957,-243,-132,-111,271.34285714285716,35,-480.0,0
0,1,11,799,813,-14,-97,-36,-61,44.27272727272727,11,804.0,0
0,1,24,577,538,39,-231,-196,-35,46.0,3,584.0,0
0,1,1,990,-805,1795,-248,-300,52,324.6,55,975.0,1
0,1,0,1544,376,1168,-159,-676,517,485.77777777777777,27,1535.0,1
0,1,9,493,-393,886,-222,-249,27,306.41379310344826,29,-396.0,0
0,1,0,887,-292,1179,-257,-521,264,280.1111111111111,45,889.0,1
0,1,2,263,-211,474,-503,-487,-16,149.84375,32,265.0,1
0,1,6,435,-483,918,-214,-250,36,230.66666666666666,39,-483.0,0
0,1,0,837,322,515,-235,-299,64,380.07142857142856,14,322.0,0
0,1,0,954,661,293,-197,-262,65,323.6,10,948.0,1
0,1,0,188,181,7,-555,-530,-25,76.1,10,164.0,0
0,1,0,480,483,-3,-243,-153,-90,92.26315789473684,19,428.0,0
0,1,0,1123,1116,7,-165,-145,-20,45.0,3,1128.0,0
0,1,50,1192,189,1003,-373,-486,113,328.4375,32,159.0,0
0,1,23,1223,-44,1267,-175,-736,561,337.780487804878,41,1230.0,1
0,1,15,205,-1084,1289,-495,-198,-297,313.0,42,205.0,1
0,1,7,177,-195,372,-509,-453,-56,190.0,20,-207.0,0
0,1,16,1098,477,621,-228,-191,-37,230.03703703703704,27,464.0,0
0,1,0,16,14,2,-789,-378,-411,191.71428571428572,7,19.0,0
0,1,24,157,-239,396,-512,-425,-87,191.47619047619048,21,158.0,1
0,1,0,1356,363,993,-188,-255,67,311.125,32,1358.0,1
0,1,2,478,548,-70,-220,-150,-70,180.1219512195122,41,154.0,1
0,1,0,889,455,434,-182,-200,18,178.41666666666666,24,888.0,1
0,1,18,1260,659,601,-244,-148,-96,205.58620689655172,29,672.0,0
0,1,11,1251,639,612,-158,-133,-25,198.43333333333334,30,640.0,0
0,1,0,1324,665,659,-98,-406,308,479.8666666666667,15,1305.0,1
0,1,33,186,-227,413,-548,-495,-53,155.03571428571428,28,-229.0,0
0,1,0,801,720,81,-218,-168,-50,277.1063829787234,47,801.0,0
0,1,0,221,144,77,-537,-149,-388,79.33333333333333,3,222.0,0
0,1,0,834,109,725,-161,-624,463,403.0,34,834.0,1
0,1,4,989,-1568,2557,-185,-195,10,453.57142857142856,56,990.0,1
0,1,0,1520,855,665,-354,-281,-73,217.13333333333333,30,1521.0,1
0,1,18,731,1809,-1078,-188,-140,-48,259.8,40,1817.0,0
0,1,0,387,553,-166,-291,-221,-70,100.38461538461539,13,523.0,0
0,1,36,923,-490,1413,-191,-159,-32,308.3673469387755,49,926.0,1
0,1,12,225,-533,758,-461,-139,-322,214.07894736842104,38,226.0,1
0,1,0,1172,1223,-51,-210,-303,93,359.9655172413793,58,167.0,1
0,1,0,1649,1005,644,-182,-171,-11,226.41379310344828,29,1652.0,1
0,1,0,914,445,469,-215,-262,47,348.07142857142856,14,916.0,1
0,1,39,233,-216,449,-515,-425,-90,190.16666666666666,24,233.0,1
0,1,0,922,437,485,-218,-276,58,381.0769230769231,13,920.0,1
0,1,0,695,166,529,-256,-269,13,419.38461538461536,13,686.0,1
0,1,0,471,-293,764,-222,-146,-76,240.54545454545453,33,445.0,1
0,1,0,475,325,150,-266,-286,20,183.5,8,466.0,1
0,1,0,11,420,-409,-238,-93,-145,171.68,25,424.0,0
0,1,7,177,600,-423,-270,-139,-131,215.1578947368421,19,591.0,0
0,1,0,571,-616,1187,-296,-130,-166,336.30555555555554,36,-616.0,0
0,1,41,458,445,13,-241,-216,-25,83.62903225806451,62,456.0,0
0,1,54,1208,1135,73,-222,-194,-28,93.27272727272727,33,1208.0,0
1,1,44,1502,1421,81,-140,-140,0,88.9047619047619,21,1505.0,0
1,1,0,1082,-212,1294,-217,-528,311,296.15555555555557,45,-218.0,0
0,1,0,546,-1088,1634,-209,-209,0,315.59615384615387,52,-1088.0,0
0,1,13,839,1673,-834,-297,-206,-91,365.22727272727275,22,1657.0,0
0,1,0,1560,1131,429,-164,-52,-112,154.40740740740742,27,1131.0,0
0,1,0,733,-623,1356,-244,-228,-16,465.82758620689657,29,735.0,1
0,1,10,525,-530,1055,-265,-177,-88,255.6829268292683,41,518.0,1
0,1,0,790,-1052,1842,-163,-78,-85,383.1875,48,792.0,1
0,1,0,861,-392,1253,-199,-290,91,509.36,25,861.0,1
0,1,5,2040,1288,752,-234,-198,-36,240.06451612903226,31,2041.0,1
0,1,0,1669,1147,522,-97,-48,-49,199.57692307692307,26,1147.0,0
0,1,0,31,-2,33,-758,-282,-476,239.57142857142858,7,29.0,0
0,1,29,1252,483,769,-252,-169,-83,239.03125,32,479.0,0
0,1,0,878,-238,1116,-219,-255,36,551.25,20,866.0,1
0,1,0,386,-537,923,-235,-218,-17,309.73333333333335,30,-524.0,0
0,1,0,1030,496,534,-178,-307,129,442.15384615384613,13,1031.0,1
0,1,29,1941,1026,915,-243,-116,-127,257.8857142857143,35,1034.0,0
0,1,0,954,655,299,-143,-244,101,310.72727272727275,11,957.0,1
0,1,25,1550,511,1039,-226,-128,-98,244.88636363636363,44,463.0,0
0,1,33,454,-467,921,-204,-132,-72,251.21621621621622,37,-468.0,0
0,1,0,678,-609,1287,-208,-106,-102,293.92857142857144,42,-609.0,0
0,1,0,312,-146,458,-493,-564,71,411.5833333333333,12,310.0,1
0,1,32,424,-524,948,-228,-171,-57,292.84375,32,-524.0,0
0,1,25,601,-555,1156,-195,-147,-48,253.88888888888889,45,-552.0,0
1,1,24,1285,616,669,-188,-199,11,146.04255319148936,47,1277.0,1
1,1,16,1245,1973,-728,-203,-146,-57,231.6875,32,1243.0,1
0,1,0,1453,-530,1983,-245,-301,56,537.5405405405405,37,1449.0,1
0,1,0,1568,1318,250,-162,-165,3,155.4,15,1561.0,1
0,1,0,397,-537,934,-207,-189,-18,243.89743589743588,39,395.0,1
0,1,0,1654,1492,162,-133,-139,6,149.0909090909091,11,1492.0,0
0,1,0,825,-880,1705,-176,-157,-19,358.27659574468083,47,-880.0,0
0,1,0,744,-520,1264,-166,-302,136,372.8235294117647,34,745.0,1
0,1,0,449,-445,894,-159,-165,6,266.2647058823529,34,450.0,1
0,1,0,829,541,288,-204,-237,33,332.77777777777777,9,830.0,1
0,1,31,646,631,15,-245,-228,-17,283.0408163265306,49,646.0,0
0,1,2,1447,-265,1712,-250,-393,143,339.27777777777777,54,-276.0,0
0,1,0,1602,1283,319,-142,-157,15,201.625,16,1604.0,1
1,1,0,749,644,105,-237,-256,19,169.57142857142858,28,736.0,0
0,1,0,1831,1247,584,-117,-294,177,292.5238095238095,21,1813.0,1
0,1,5,275,-266,541,-491,-443,-48,206.46153846153845,26,268.0,1
0,1,0,1565,1325,240,-228,-129,-99,113.94736842105263,19,1560.0,1
0,1,0,672,-559,1231,-197,-225,28,278.25,56,663.0,1
0,1,2,186,-330,516,-522,-465,-57,300.72222222222223,18,-330.0,0
1,1,0,514,533,-19,-207,-220,13,171.91836734693877,49,515.0,0
0,1,3,1513,795,718,-250,-162,-88,160.38636363636363,44,1514.0,1
0,1,11,232,189,43,-457,-312,-145,167.05882352941177,17,233.0,0
0,1,2,611,-958,1569,-228,-79,-149,326.0625,48,611.0,1
0,1,1,755,-910,1665,-210,-224,14,350.9574468085106,47,756.0,1
0,1,0,1380,581,799,-161,-217,56,306.5357142857143,28,1379.0,1
0,1,0,1455,418,1037,-285,-245,-40,279.81081081081084,37,414.0,0
0,1,4,192,-312,504,-536,-455,-81,179.96296296296296,27,171.0,1
0,1,0,1030,-695,1725,-247,-235,-12,507.05882352941177,34,-695.0,0
0,1,2,451,1019,-568,-292,-219,-73,175.09375,32,1005.0,0
0,1,0,29,263,-234,-772,-465,-307,111.33333333333333,30,28.0,1
0,1,0,1374,948,426,-284,-161,-123,126.57575757575758,33,1375.0,1
0,1,0,1554,1091,463,-204,-205,1,172.07407407407408,27,1091.0,0
0,1,0,693,496,197,-402,-264,-138,142.6875,32,691.0,1
0,1,0,396,-1036,1432,-221,-154,-67,277.078431372549,51,-1036.0,0
0,1,0,427,-349,776,-217,-240,23,297.34615384615387,26,427.0,1
0,1,33,384,-1062,1446,-253,-127,-126,328.02272727272725,44,-1069.0,0
0,1,32,911,1418,-507,-102,-98,-4,157.9375,32,910.0,1
0,1,8,700,-860,1560,-267,-183,-84,249.79365079365078,63,702.0,1
0,1,61,703,-937,1640,-217,-164,-53,260.27868852459017,61,703.0,1
0,1,0,1466,409,1057,-230,-254,24,297.3142857142857,35,1478.0,1
0,1,1,116,245,-129,-582,-528,-54,183.28571428571428,7,245.0,0
0,1,13,1112,1362,-250,-56,-18,-38,125.75,20,1369.0,0
0,1,0,1218,847,371,-268,-187,-81,156.56521739130434,23,1203.0,1
0,1,6,1321,264,1057,-344,-472,128,341.125,32,242.0,0
0,1,0,439,-949,1388,-275,-184,-91,329.95238095238096,42,-949.0,0
0,1,0,1436,1128,308,-264,-234,-30,100.44444444444444,27,1435.0,1
0,1,0,1701,967,734,-203,-343,140,314.7083333333333,24,1702.0,1
0,1,0,653,15,638,-215,-592,377,296.35483870967744,31,-55.0,0
0,1,0,1451,988,463,-452,-55,-397,217.91666666666666,12,1439.0,1
0,1,0,223,85,138,-477,-532,55,130.6,10,228.0,1
1,1,51,810,1482,-672,-85,-141,56,175.51351351351352,37,1473.0,0
0,1,0,1807,835,972,-214,-456,242,374.2857142857143,28,1830.0,1
0,1,1,177,382,-205,-254,-62,-192,135.90769230769232,65,366.0,0
0,1,0,1633,1016,617,-222,-299,77,318.04761904761904,21,1633.0,1
0,1,0,661,546,115,-212,-268,56,277.7368421052632,38,664.0,1
0,1,35,249,-219,468,-475,-455,-20,191.03846153846155,26,-235.0,0
0,1,0,729,777,-48,-228,-217,-11,113.66666666666667,21,737.0,0
0,1,0,566,515,51,-254,-221,-33,274.85,40,567.0,0
0,1,0,1435,1067,368,-303,-237,-66,169.9,20,1067.0,0
0,1,5,60,1013,-953,-285,-97,-188,250.18421052631578,38,1012.0,0
0,1,0,945,345,600,-192,-228,36,374.6875,16,345.0,0
0,1,1,37,-20,57,-622,-652,30,40.0,15,51.0,0
0,1,17,437,532,-95,-103,-86,-17,65.42105263157895,19,545.0,0
0,1,0,963,-230,1193,-223,-234,11,496.75,24,964.0,1
1,1,33,12,259,-247,-821,-553,-268,142.91666666666666,24,7.0,1
0,1,0,997,-133,1130,-262,-324,62,518.9090909090909,22,993.0,1
0,1,0,152,686,-534,-313,-125,-188,233.04545454545453,22,686.0,0
0,1,0,1137,-881,2018,-180,-238,58,408.2040816326531,49,-881.0,0
0,1,57,259,-669,928,-520,-275,-245,302.53125,32,-677.0,0
0,1,0,510,470,40,-247,-248,1,73.18181818181819,11,504.0,0
0,1,22,238,-222,460,-559,-557,-2,197.625,24,239.0,1
0,1,0,423,385,38,-93,-114,21,61.0,11,422.0,0
0,1,3,840,-484,1324,-262,-208,-54,374.6666666666667,36,-504.0,0
0,1,0,582,551,31,-200,-199,-1,44.6,5,582.0,0
0,1,0,959,570,389,-277,-360,83,357.09090909090907,11,961.0,1
0,1,0,1093,-415,1508,-221,-335,114,543.1785714285714,28,1096.0,1
0,1,0,537,-27,564,-219,-593,374,468.2432432432432,37,-533.0,1
0,1,11,475,-676,1151,-196,-143,-53,314.86486486486484,37,-676.0,0
0,1,0,551,-585,1136,-246,-114,-132,308.60526315789474,38,-585.0,0
0,1,10,334,2087,-1753,-270,-135,-135,481.0833333333333,36,2091.0,0
0,1,8,467,-489,956,-253,-169,-84,248.225,40,-498.0,0
0,1,9,836,-715,1551,-253,-182,-71,362.8837209302326,43,-719.0,0
0,1,0,1043,144,899,-209,-352,143,481.2105263157895,19,1042.0,1
0,1,0,372,-471,843,-236,-484,248,232.9189189189189,37,-268.0,1
0,1,18,1031,1846,-815,-563,-205,-358,344.84615384615387,26,1869.0,0
0,1,24,245,-185,430,-552,-442,-110,180.625,24,235.0,1
1,1,1,153,459,-306,-237,-144,-93,178.55555555555554,18,464.0,0
0,1,0,124,683,-559,-604,-640,36,618.6666666666666,9,683.0,0
0,1,0,451,-608,1059,-197,-22,-175,275.2105263157895,38,-608.0,0
0,1,25,4,-997,1001,-276,-199,-77,243.4,40,-996.0,0
0,1,0,447,503,-56,-199,-197,-2,74.5,6,494.0,0
0,1,36,123,513,-390,-300,-181,-119,180.65217391304347,23,530.0,0
0,1,57,339,-547,886,-248,-206,-42,260.55882352941177,34,-546.0,0
0,1,0,452,339,113,-191,-209,18,82.41176470588235,17,402.0,0
1,1,10,466,-484,950,-184,-197,13,288.42424242424244,33,465.0,1
1,1,4,315,12,303,-246,-495,249,166.74418604651163,43,-63.0,0
0,1,0,955,636,319,-244,-280,36,263.3636363636364,11,928.0,1
0,1,27,213,217,-4,-511,-507,-4,142.78125,32,214.0,0
0,1,22,196,185,11,-393,-564,171,146.95238095238096,21,198.0,0
0,1,0,952,60,892,-214,-289,75,456.8,20,954.0,1
0,1,10,344,-223,567,-452,-395,-57,172.74193548387098,31,345.0,1
0,1,20,453,-512,965,-233,-217,-16,267.44444444444446,36,454.0,1
0,1,0,909,512,397,-217,-297,80,300.85714285714283,14,911.0,1
0,1,0,1264,430,834,-185,-366,181,516.0,17,1266.0,1
1,1,23,679,-441,1120,-236,-233,-3,301.55263157894734,38,677.0,1
1,1,40,200,1718,-1518,-310,-58,-252,378.4390243902439,41,1712.0,0
0,1,24,792,-1080,1872,-221,-113,-108,329.89830508474574,59,793.0,1
0,1,41,537,543,-6,-169,-163,-6,25.0,1,530.0,0
0,1,0,714,-372,1086,-271,-354,83,504.6818181818182,22,715.0,1
0,1,13,929,-1006,1935,-194,-170,-24,363.5740740740741,54,-1003.0,0
0,1,0,902,-1234,2136,-206,-236,30,434.3673469387755,49,903.0,1
0,1,5,581,-531,1112,-221,-197,-24,304.9166666666667,36,-531.0,0
0,1,0,1415,835,580,-240,-226,-14,231.68,25,1416.0,1
0,1,0,586,477,109,-194,-219,25,92.45454545454545,11,477.0,0
0,1,0,1183,991,192,-203,-183,-20,158.0,13,1182.0,1
0,1,6,760,-836,1596,-209,-192,-17,332.9791666666667,48,-836.0,0
0,1,0,1232,882,350,-230,-288,58,295.75,12,1228.0,1
0,1,22,164,252,-88,-452,-506,54,81.86363636363636,22,165.0,0
0,1,0,583,-712,1295,-165,-205,40,346.56756756756755,37,583.0,1
0,1,0,1023,-334,1357,-197,-330,133,393.07142857142856,56,-732.0,1
0,1,0,992,-247,1239,-236,-341,105,488.0,26,995.0,1
0,1,17,730,-775,1505,-252,-169,-83,346.95454545454544,44,731.0,1
0,1,0,793,265,528,-125,-217,92,379.35714285714283,14,795.0,1
0,1,15,651,377,274,-123,-125,2,121.77272727272727,22,373.0,0
1,1,46,751,1449,-698,-96,-13,-83,233.27586206896552,29,749.0,1
1,1,47,1211,313,898,-226,-422,196,255.91666666666666,36,323.0,0
0,1,0,949,639,310,-278,-204,-74,164.57894736842104,19,951.0,1
0,1,23,29,461,-432,-278,-269,-9,246.6875,16,450.0,0
0,1,11,196,-179,375,-433,-447,14,170.57142857142858,21,-183.0,0
0,1,15,100,206,-106,-181,-473,292,205.4,15,211.0,0
0,1,0,943,-1190,2133,-222,-189,-33,486.72727272727275,44,-1190.0,0
0,1,0,1511,1207,304,-199,-187,-12,172.8235294117647,17,1207.0,0
0,1,4,217,-186,403,-485,-437,-48,152.84615384615384,26,218.0,1
0,1,0,687,136,551,-203,-293,90,369.53333333333336,15,689.0,1
0,1,27,1942,293,1649,-192,-512,320,349.875,48,289.0,0
0,1,26,3,71,-68,-754,-678,-76,141.72222222222223,36,9.0,0
0,1,18,658,-896,1554,-186,-102,-84,382.4047619047619,42,658.0,1
0,1,0,1322,554,768,-189,-131,-58,208.6216216216216,37,1314.0,1
0,1,12,570,-894,1464,-214,-2,-212,270.6111111111111,54,570.0,1
0,1,44,978,-1159,2137,-183,-208,25,390.1454545454545,55,-1155.0,0
0,1,52,149,197,-48,-416,-517,101,124.04761904761905,21,115.0,0
0,1,0,1029,630,399,-157,-263,106,352.9166666666667,12,1030.0,1
0,1,8,869,570,299,-166,-185,19,118.83333333333333,24,864.0,1
0,1,18,1052,-869,1921,-203,-188,-15,379.74,50,1046.0,1
0,1,17,462,-355,817,-196,-97,-99,222.0,42,465.0,1
0,1,29,765,-891,1656,-143,-144,1,351.93617021276594,47,757.0,1
0,1,67,222,259,-37,-548,-516,-32,61.18181818181818,11,273.0,0
0,1,44,776,-1440,2216,-167,-130,-37,399.43636363636364,55,-1453.0,0
0,1,0,1644,964,680,-133,-218,85,254.0,27,964.0,0
0,1,24,229,-632,861,-241,-157,-84,314.3703703703704,27,-632.0,0
0,1,14,531,499,32,-94,-217,123,234.44,50,533.0,0
0,1,0,315,-1296,1611,-496,-289,-207,453.8918918918919,37,312.0,1
0,1,0,649,465,184,-194,-264,70,240.75,8,650.0,1
0,1,8,897,237,660,-256,-532,276,286.49056603773585,53,898.0,1
0,1,13,626,-818,1444,-243,-77,-166,309.3191489361702,47,-825.0,0
0,1,0,26,-168,194,-407,-378,-29,233.88888888888889,9,20.0,1
0,1,2,1340,-726,2066,-197,-168,-29,419.40816326530614,49,1341.0,1
0,1,45,899,169,730,-410,-524,114,284.36,25,176.0,0
0,1,0,173,-1145,1318,-554,-326,-228,340.7631578947368,38,172.0,1
0,1,27,1045,-737,1782,-195,-81,-114,436.9,40,1043.0,1
1,1,29,0,-159,159,-687,-417,-270,144.2941176470588,17,0.0,1
0,1,15,938,576,362,-65,-105,40,137.56,25,939.0,1
0,1,0,1033,-1426,2459,-214,-234,20,484.03636363636366,55,1029.0,1
0,1,0,1505,452,1053,-222,-268,46,279.3157894736842,38,1502.0,1
0,1,63,20,1,19,-667,-686,19,145.0,1,16.0,0
0,1,79,1706,1572,134,363,-62,425,80.46666666666667,15,1595.0,0
0,1,0,24,140,-116,-462,-437,-25,213.5,6,23.0,1
0,1,14,981,-1054,2035,-212,-180,-32,413.7551020408163,49,981.0,1
0,1,10,1598,529,1069,-167,-207,40,255.0,44,501.0,0
0,1,63,514,-494,1008,-205,-209,4,290.05555555555554,36,-508.0,0
0,1,0,1131,281,850,-194,-316,122,457.63157894736844,19,1132.0,1
0,1,52,172,225,-53,-552,-505,-47,284.6024096385542,83,199.0,0
0,1,4,1752,531,1221,-219,-143,-76,260.4130434782609,46,1751.0,1
0,1,0,769,-214,983,-249,-334,85,449.8,50,771.0,1
0,1,5,1167,777,390,-178,-136,-42,132.9655172413793,29,777.0,0
0,1,0,1313,901,412,-149,-96,-53,152.73076923076923,26,901.0,0
0,1,11,1023,-867,1890,-204,-216,12,408.67391304347825,46,1025.0,1
0,1,0,500,468,32,-201,-182,-19,216.0,48,499.0,0
1,1,5,1123,1074,49,-99,79,-178,39.4,10,1124.0,0
0,1,0,1633,682,951,-217,-274,57,360.0,45,361.0,1
0,1,13,837,327,510,-342,-511,169,223.04166666666666,24,315.0,0
0,1,0,579,-420,999,-184,-250,66,220.06521739130434,46,514.0,1
0,1,14,746,-1222,1968,-193,-154,-39,410.25,48,745.0,1
0,1,0,988,-576,1564,-265,-366,101,409.5897435897436,39,-587.0,0
0,1,0,191,-236,427,-572,-491,-81,209.28571428571428,21,191.0,1
0,1,16,411,-459,870,-284,-202,-82,227.1891891891892,37,-460.0,0
0,1,7,77,242,-165,-545,-498,-47,119.66666666666667,15,249.0,0
0,1,0,2006,1601,405,-232,-257,25,251.5,16,2000.0,1
0,1,40,511,-679,1190,-181,-31,-150,262.02222222222224,45,-682.0,0
0,1,0,648,-528,1176,-167,-211,44,454.7692307692308,26,650.0,1
0,1,0,561,537,24,-49,-36,-13,53.833333333333336,18,520.0,0
0,1,21,219,-217,436,-559,-498,-61,183.95833333333334,24,-229.0,0
0,1,6,1176,442,734,-264,-91,-173,218.11428571428573,35,442.0,0
0,1,15,411,493,-82,-244,-198,-46,176.30555555555554,36,141.0,1
0,1,17,101,208,-107,-515,-453,-62,133.44444444444446,9,229.0,0
0,1,0,1632,1251,381,-162,-168,6,130.40740740740742,27,1251.0,0
0,1,0,1539,915,624,-260,-258,-2,241.6,25,1522.0,1
0,1,0,1934,1397,537,-233,-240,7,227.52173913043478,23,1934.0,1
0,1,14,496,522,-26,-176,-173,-3,181.525,40,500.0,0
1,1,0,655,-309,964,-200,-327,127,248.975,40,640.0,1
0,1,0,475,-535,1010,-238,-172,-66,235.0952380952381,42,-521.0,0
0,1,3,365,-512,877,-187,-97,-90,217.6046511627907,43,-479.0,0
0,1,0,996,1142,-146,-71,-215,144,65.69444444444444,36,971.0,1
0,1,32,1064,965,99,-147,-74,-73,74.32,25,1091.0,1
0,1,0,445,-548,993,-214,-175,-39,216.9777777777778,45,-549.0,0
0,1,0,202,-237,439,-506,-463,-43,191.16666666666666,24,204.0,1
0,1,1,471,245,226,-264,-438,174,155.2608695652174,23,463.0,1
0,1,13,378,171,207,-225,-327,102,191.5625,16,138.0,0
0,1,6,511,665,-154,-194,-133,-61,193.1818181818182,44,511.0,1
0,1,0,497,551,-54,-254,-217,-37,172.52380952380952,42,494.0,0
0,1,0,816,-26,842,-205,-506,301,173.0392156862745,51,817.0,1
0,1,0,858,-334,1192,-238,-337,99,497.25,24,859.0,1
0,1,0,676,25,651,-198,-282,84,414.1875,16,678.0,1
1,1,5,629,-981,1610,-182,-236,54,344.9130434782609,46,-981.0,0
0,1,26,777,1344,-567,-242,-94,-148,238.08333333333334,24,1362.0,0
0,1,42,268,2085,-1817,-473,-99,-374,350.37735849056605,53,2086.0,0
0,1,8,1041,2039,-998,-204,-165,-39,295.74285714285713,35,1040.0,1
0,1,1,1963,798,1165,-180,-194,14,280.7105263157895,38,1964.0,1
0,1,0,922,576,346,-247,-283,36,299.8333333333333,12,921.0,1
0,1,0,626,659,-33,-148,-99,-49,54.166666666666664,30,625.0,0
0,1,8,776,-1077,1853,-225,-192,-33,399.8478260869565,46,779.0,1
0,1,0,696,-372,1068,-175,-223,48,447.4166666666667,24,688.0,1
0,1,0,908,-332,1240,-186,-246,60,364.4901960784314,51,904.0,1
0,1,0,293,-319,612,-520,-390,-130,230.92307692307693,26,294.0,1
0,1,5,72,-260,332,-549,-390,-159,164.14285714285714,21,-260.0,0
0,1,0,257,211,46,-491,-447,-44,103.65517241379311,29,257.0,0
0,1,27,284,-2092,2376,-427,-119,-308,390.78333333333336,60,-2084.0,0
0,1,0,800,-1103,1903,-322,-356,34,409.7826086956522,46,799.0,1
1,1,6,189,-535,724,-273,-98,-175,197.1315789473684,38,-550.0,0
1,1,27,476,-1173,1649,-304,-223,-81,348.29787234042556,47,-1168.0,0
0,1,0,975,512,463,-158,-98,-60,231.2,20,976.0,1
0,1,0,1966,1012,954,-265,-215,-50,297.80645161290323,31,1012.0,0
0,1,29,230,438,-208,-457,-193,-264,188.64285714285714,14,231.0,1
0,1,14,390,-612,1002,-261,-192,-69,281.74285714285713,35,-614.0,0
0,1,0,280,-128,408,-509,-580,71,402.27272727272725,11,281.0,1
0,1,5,467,-495,962,-90,-219,129,226.72093023255815,43,462.0,1
0,1,8,485,-1185,1670,-282,-74,-208,320.79245283018867,53,486.0,1
0,1,20,248,-184,432,-512,-447,-65,165.17857142857142,28,248.0,1
0,1,0,767,-435,1202,-151,-302,151,341.72222222222223,54,770.0,1
1,1,14,216,227,-11,-580,-477,-103,43.5,2,226.0,0
1,1,11,859,841,18,-201,-138,-63,9.0,1,858.0,0
0,1,0,1793,1309,484,-123,-145,22,261.1111111111111,18,1773.0,1
0,1,145,218,11,207,-517,-723,206,146.75,16,219.0,1
0,1,0,874,87,787,-205,-358,153,453.0,18,875.0,1
0,1,0,573,-494,1067,-180,-168,-12,261.4,40,558.0,1
0,1,0,968,571,397,-270,-243,-27,315.9230769230769,13,965.0,1
0,1,0,751,-162,913,-179,-576,397,361.56410256410254,39,752.0,1
0,1,2,1051,491,560,-140,-235,95,231.45833333333334,24,491.0,0
0,1,0,330,-392,722,-241,-206,-35,190.54545454545453,44,-403.0,0
0,1,0,759,-73,832,-227,-298,71,447.1578947368421,19,760.0,1
0,1,16,1236,625,611,-201,-107,-94,225.76923076923077,26,625.0,0
0,1,0,212,-310,522,-449,-432,-17,248.1904761904762,21,212.0,1
0,1,0,2039,1070,969,-376,-509,133,302.6363636363636,33,2040.0,1
0,1,18,1544,2154,-610,-348,-286,-62,309.25,20,2171.0,0
0,1,0,519,-544,1063,-267,-218,-49,298.6111111111111,36,-553.0,0
0,1,2,510,-635,1145,-164,-134,-30,299.9230769230769,39,-644.0,0
0,1,0,465,-562,1027,-229,-135,-94,241.9047619047619,42,-568.0,0
0,1,0,416,-387,803,-246,-274,28,222.94736842105263,38,405.0,1
0,1,84,550,-744,1294,-169,-211,42,295.65909090909093,44,550.0,1
0,1,0,1238,754,484,-217,-397,180,362.2142857142857,14,1220.0,1
0,1,19,690,1652,-962,-244,-99,-145,310.64516129032256,31,1653.0,0
0,1,18,607,-276,883,-222,-399,177,223.275,40,-280.0,0
0,1,0,954,-59,1013,-67,-285,218,495.8095238095238,21,943.0,1
0,1,27,584,-382,966,-226,-80,-146,261.0,38,584.0,1
0,1,2,469,-589,1058,-254,-182,-72,286.0,37,470.0,1
0,1,0,767,-666,1433,-220,-194,-26,476.9,30,769.0,1
0,1,0,519,957,-438,216,-255,471,287.70454545454544,44,519.0,1
0,1,0,1779,1360,419,-258,-214,-44,131.19565217391303,46,1781.0,1
0,1,9,565,-1081,1646,-309,-182,-127,317.2307692307692,52,-1083.0,0
0,1,27,725,1534,-809,-219,-116,-103,303.22222222222223,27,1547.0,0
0,1,0,887,548,339,-221,-220,-1,152.56521739130434,23,889.0,1
0,1,45,840,840,0,-149,-192,43,96.625,72,841.0,0
0,1,59,7,283,-276,-472,-460,-12,92.23333333333333,30,9.0,1
0,1,56,1205,1064,141,-67,-80,13,92.5945945945946,74,1206.0,1
0,1,36,1433,623,810,-166,-5,-161,251.8181818181818,33,609.0,0
0,1,86,410,-466,876,-125,-52,-73,335.77777777777777,27,-497.0,0
0,1,11,925,-529,1454,-115,-56,-59,367.2926829268293,41,-544.0,0
0,1,25,559,-1470,2029,-228,25,-253,405.94,50,-1475.0,0
0,1,57,214,1582,-1368,-469,-102,-367,328.76190476190476,42,1576.0,0
0,1,27,190,1613,-1423,-581,-5,-576,361.73809523809524,42,1603.0,0
0,1,0,1021,55,966,-173,-155,-18,482.95238095238096,21,55.0,0
0,1,27,1022,-833,1855,-240,-160,-80,301.4032258064516,62,1024.0,1
0,1,0,1978,1351,627,-173,-101,-72,289.95652173913044,23,1976.0,1
0,1,0,796,318,478,-228,-316,88,386.9230769230769,13,796.0,1
0,1,36,426,-503,929,-214,-160,-54,258.8611111111111,36,419.0,1
0,1,0,1960,1597,363,-202,-196,-6,210.1875,16,1597.0,0
0,1,35,973,-450,1423,-203,-142,-61,357.225,40,974.0,1
0,1,6,220,-259,479,-494,-453,-41,248.0,19,221.0,1
0,1,31,645,-514,1159,-210,-185,-25,314.0810810810811,37,-519.0,0
0,1,0,930,215,715,-155,-306,151,469.5,16,931.0,1
0,1,0,957,331,626,-163,-308,145,418.8125,16,960.0,1
0,1,8,754,-973,1727,-155,-149,-6,377.3478260869565,46,-973.0,0
0,1,18,429,-559,988,-197,-130,-67,294.4,35,-557.0,0
0,1,9,846,869,-23,-127,-174,47,64.0,1,869.0,0
0,1,11,245,393,-148,-264,-262,-2,236.72727272727272,33,-61.0,1
0,1,0,836,648,188,-246,-307,61,229.33333333333334,9,837.0,1
0,1,80,34,36,-2,-725,-678,-47,30.5,2,19.0,0
0,1,0,530,-226,756,-148,-214,66,294.46153846153845,26,533.0,1
1,1,14,1893,449,1444,-293,-256,-37,350.4390243902439,41,445.0,0
1,1,19,1190,276,914,-294,-485,191,256.72972972972974,37,270.0,0
0,1,6,502,-390,892,-196,-140,-56,275.4375,32,498.0,1
0,1,22,1022,282,740,-379,-300,-79,312.8333333333333,24,261.0,0
0,1,0,20,215,-195,-468,-476,8,146.6153846153846,13,215.0,0
0,1,0,1490,427,1063,-156,-451,295,466.9166666666667,24,1483.0,1
0,1,21,268,-214,482,-498,-420,-78,216.04545454545453,22,265.0,1
0,1,65,5,15,-10,-773,-738,-35,89.0,6,5.0,0
1,1,91,208,-11,219,-534,-795,261,170.78947368421052,19,209.0,1
1,1,24,1361,-20,1381,-235,-785,550,329.02222222222224,45,1363.0,1
1,1,29,1926,499,1427,-213,-180,-33,357.15,40,1924.0,1
0,1,0,286,34,252,-552,-690,138,347.55555555555554,9,283.0,1
0,1,34,1975,300,1675,-342,-507,165,309.4035087719298,57,262.0,0
0,1,18,1006,-1220,2226,-190,-118,-72,403.8363636363636,55,-1224.0,0
0,1,38,1539,6,1533,-236,-782,546,326.0,50,-6.0,0
0,1,0,1023,396,627,-209,-271,62,398.875,16,1016.0,1
1,1,83,235,-14,249,-528,-801,273,138.95833333333334,24,-23.0,0
0,1,0,1001,-41,1042,-339,-320,-19,478.3181818181818,22,1002.0,1
0,1,0,733,1330,-597,-216,-232,16,257.0,22,758.0,1
0,1,24,982,-1091,2073,-213,-136,-77,440.6521739130435,46,-1090.0,0
0,1,0,216,-142,358,-571,-550,-21,311.6363636363636,11,218.0,1
1,1,0,177,-200,377,-507,-487,-20,120.3225806451613,31,178.0,1
0,1,56,386,-486,872,-189,-189,0,256.2,35,-511.0,0
1,1,71,196,-31,227,-533,-796,263,138.41666666666666,24,199.0,1
0,1,3,1766,599,1167,-219,-219,0,247.95744680851064,47,599.0,0
1,1,44,145,4,141,-580,-773,193,140.8421052631579,19,5.0,0
0,1,0,2170,1699,471,-191,-218,27,237.1,20,1699.0,0
0,1,0,1306,2098,-792,-127,-123,-4,249.2258064516129,31,1318.0,1
0,1,14,188,-232,420,-534,-529,-5,100.02127659574468,47,175.0,1
1,1,35,245,10,235,-467,-622,155,148.8181818181818,22,6.0,0
1,1,35,847,557,290,-82,-21,-61,101.5925925925926,27,564.0,0
0,1,0,1390,487,903,-196,-112,-84,277.34285714285716,35,434.0,0
0,1,0,1823,1522,301,-185,-163,-22,280.8181818181818,11,1820.0,1
0,1,0,745,-735,1480,-250,-213,-37,368.0,40,747.0,1
0,1,23,778,-749,1527,-197,-169,-28,374.65,40,-745.0,0
0,1,17,1154,-1070,2224,-296,-82,-214,381.63793103448273,58,-1074.0,0
0,1,15,135,2175,-2040,-516,-64,-452,373.6909090909091,55,127.0,1
0,1,16,1016,-1147,2163,-198,-97,-101,430.42,50,1017.0,1
0,1,0,864,417,447,-220,-321,101,317.1333333333333,15,866.0,1
0,1,0,2176,1971,205,-239,-183,-56,210.7,10,2171.0,1
0,1,0,1098,-357,1455,-266,-215,-51,558.7307692307693,26,1100.0,1
0,1,20,989,-871,1860,-220,-189,-31,342.8,55,995.0,1
1,1,0,931,721,210,-298,-291,-7,250.66666666666666,9,933.0,1
1,1,5,470,506,-36,-171,-187,16,60.111111111111114,9,457.0,0
0,1,24,606,967,-361,-161,-163,2,160.54545454545453,22,605.0,1
0,1,0,1730,1476,254,-182,-198,16,263.0,10,1733.0,1
0,1,27,673,-1150,1823,-204,-121,-83,344.0769230769231,52,672.0,1
0,1,12,1405,646,759,-218,-156,-62,241.84848484848484,33,612.0,0
0,1,0,2,-1,3,-711,-566,-145,103.66666666666667,3,3.0,0
1,1,20,280,683,-403,-509,-187,-322,169.57142857142858,28,683.0,0
0,1,0,2079,1392,687,-203,-171,-32,193.05714285714285,35,2074.0,1
0,1,0,1249,488,761,-201,-148,-53,214.72222222222223,36,1251.0,1
0,1,2,255,161,94,-494,-304,-190,108.31818181818181,22,309.0,1
0,1,0,1108,535,573,-151,-261,110,394.4,15,535.0,0
0,1,20,278,250,28,-512,-491,-21,109.83870967741936,31,274.0,0
1,1,21,582,633,-51,-271,-196,-75,84.85714285714286,7,632.0,0
0,1,132,1422,1602,-180,-249,-51,-198,86.32,25,1422.0,1
0,1,32,226,-213,439,-467,-466,-1,130.625,32,227.0,1
0,1,0,1404,-360,1764,-170,-702,532,549.0,34,1406.0,1
1,1,43,45,-482,527,-397,-181,-216,276.7,20,-487.0,0
0,1,0,403,-164,567,-424,-317,-107,342.72727272727275,33,641.0,1
0,1,66,191,199,-8,-526,-460,-66,76.25,24,102.0,0
0,1,57,1358,590,768,-171,-149,-22,248.93333333333334,30,590.0,0
0,1,38,1223,226,997,-274,-409,135,211.35294117647058,51,188.0,0
0,1,0,956,-320,1276,-356,-342,-14,478.22222222222223,27,956.0,1
1,1,12,994,-1059,2053,-213,-117,-96,223.14285714285714,91,995.0,1
0,1,26,462,484,-22,-144,-135,-9,97.7948717948718,39,463.0,0
0,1,28,441,431,10,-175,-187,12,112.71794871794872,39,442.0,0
0,1,31,885,956,-71,-62,-89,27,111.0,36,880.0,0
0,1,46,2,-9,11,-721,-713,-8,117.07692307692308,13,2.0,0
0,1,27,1238,1699,-461,-228,-166,-62,207.66666666666666,21,1696.0,0
0,1,0,1329,974,355,-141,-126,-15,375.0571428571429,35,1324.0,1
0,1,0,954,-1311,2265,-219,-181,-38,432.71153846153845,52,944.0,1
0,1,0,608,-526,1134,-177,-265,88,483.5833333333333,24,609.0,1
0,1,0,1283,478,805,-178,-13,-165,190.3095238095238,42,1284.0,1
0,1,0,986,-71,1057,-179,-294,115,495.1363636363636,22,988.0,1
0,1,0,739,37,702,-220,-228,8,458.11764705882354,17,742.0,1
0,1,0,265,-163,428,-544,-509,-35,359.5833333333333,12,266.0,1
0,1,0,605,-270,875,-237,-16,-221,450.42105263157896,19,605.0,1
0,1,4,769,-1395,2164,-191,-62,-129,355.03333333333336,60,770.0,1
0,1,0,570,1613,-1043,-203,-319,116,221.125,48,1613.0,0
0,1,35,253,165,88,-521,-559,38,248.89285714285714,56,821.0,1
0,1,0,450,-438,888,-111,-126,15,251.3783783783784,37,451.0,1
0,1,0,490,-725,1215,-283,-340,57,454.6666666666667,27,489.0,1
0,1,0,1056,-553,1609,-168,-228,60,574.8214285714286,28,1057.0,1
0,1,0,1623,1047,576,-153,-187,34,192.96666666666667,30,1617.0,1
0,1,1,320,-142,462,-576,-569,-7,166.0,32,330.0,1
0,1,0,509,432,77,-255,-267,12,205.0,4,510.0,0
0,1,0,1477,602,875,-168,-59,-109,197.09803921568627,51,571.0,0
0,1,0,799,-924,1723,-288,-62,-226,480.6666666666667,36,791.0,1
0,1,45,1132,-225,1357,-245,-648,403,305.29787234042556,47,1134.0,1
0,1,0,1351,-307,1658,-130,-280,150,577.1724137931035,29,-307.0,0
0,1,0,652,-225,877,-278,-118,-160,590.5333333333333,15,-225.0,0
0,1,8,485,660,-175,-182,115,-297,126.47058823529412,17,484.0,1
0,1,0,645,-402,1047,-306,-147,-159,501.04761904761904,21,648.0,1
0,1,1,1547,1000,547,-166,-144,-22,159.0,34,1000.0,0
0,1,8,872,-1165,2037,-208,-162,-46,333.2950819672131,61,-1165.0,0
0,1,0,1111,1988,-877,-192,-141,-51,189.47826086956522,46,1113.0,1
0,1,0,869,619,250,-146,-230,84,270.4,10,872.0,1
0,1,0,381,418,-37,-190,-48,-142,66.54545454545455,11,447.0,0
0,1,0,1016,604,412,-192,-136,-56,399.45454545454544,11,604.0,0
0,1,0,1075,138,937,-223,-336,113,508.10526315789474,19,1080.0,1
0,1,21,195,-1994,2189,-527,-51,-476,328.2647058823529,68,196.0,1
0,1,29,1083,398,685,-203,-224,21,183.91666666666666,36,400.0,0
0,1,0,1114,726,388,-180,-160,-20,168.30434782608697,23,1107.0,1
0,1,0,1026,-216,1242,-164,-343,179,556.6521739130435,23,1017.0,1
0,1,30,516,-759,1275,-263,-204,-59,367.45454545454544,33,-746.0,0
0,1,0,889,575,314,-228,-306,78,302.27272727272725,11,891.0,1
0,1,0,897,-636,1533,-170,-296,126,410.3157894736842,38,900.0,1
0,1,6,1506,995,511,-179,-167,-12,145.3939393939394,33,995.0,0
0,1,7,1509,1463,46,-105,17,-122,11.25,4,1505.0,0
0,1,6,591,-763,1354,-239,-97,-142,284.9782608695652,46,-727.0,0
0,1,0,595,575,20,-164,83,-247,54.166666666666664,6,612.0,0
0,1,0,1931,1520,411,-207,-9,-198,198.0,22,1933.0,1
1,1,3,1955,1351,604,-148,15,-163,178.80555555555554,36,1336.0,0
1,1,0,673,494,179,-129,-33,-96,109.63636363636364,22,458.0,0
1,1,17,1330,2059,-729,-189,94,-283,185.04761904761904,42,2063.0,0
1,1,46,781,1415,-634,-96,64,-160,215.75862068965517,29,1407.0,0
1,1,0,1369,-6,1375,-232,-662,430,310.6875,48,4.0,0
0,1,36,1322,832,490,-174,-76,-98,226.30434782608697,23,817.0,0
1,1,85,1208,403,805,-146,-141,-5,168.67441860465115,43,453.0,0
1,1,58,844,1471,-627,-104,61,-165,201.55172413793105,29,856.0,1
0,1,0,619,-47,666,-79,-374,295,199.15625,64,616.0,1
1,1,0,1887,616,1271,-135,44,-179,287.5348837209302,43,1876.0,1
1,1,76,1364,24,1340,-214,-668,454,325.24444444444447,45,1368.0,1
0,1,22,730,-867,1597,-212,-111,-101,325.9591836734694,49,-875.0,0
0,1,0,443,463,-20,-98,-66,-32,85.5,2,444.0,0
0,1,11,1226,220,1006,-290,-438,148,182.6818181818182,66,133.0,0
0,1,0,881,-841,1722,-191,-280,89,427.2926829268293,41,880.0,1
0,1,0,318,53,265,-515,-485,-30,152.2941176470588,17,281.0,1
0,1,0,217,265,-48,-485,-377,-108,59.733333333333334,15,215.0,0
0,1,0,276,1364,-1088,-539,-284,-255,291.775,40,274.0,1
0,1,0,70,748,-678,-305,-209,-96,231.4,30,748.0,0
1,1,0,459,446,13,-111,-98,-13,79.55172413793103,29,450.0,0
0,1,0,260,286,-26,-568,-494,-74,73.4,5,286.0,0
1,1,1,1414,-10,1424,-108,-716,608,244.46875,64,-25.0,0
1,1,43,29,1473,-1444,-758,-186,-572,316.2916666666667,48,1464.0,0
0,1,7,621,-1081,1702,-209,-117,-92,361.4255319148936,47,-1067.0,0
0,1,0,705,566,139,-217,-231,14,166.23809523809524,21,462.0,1
0,1,0,588,655,-67,-150,-117,-33,68.375,16,635.0,0
0,1,12,1358,465,893,-206,-211,5,228.825,40,1356.0,1
0,1,0,1080,1114,-34,-125,-120,-5,35.714285714285715,14,1098.0,0
0,1,0,876,59,817,-178,-583,405,416.90909090909093,22,869.0,1
0,1,0,386,385,1,-96,-87,-9,72.8695652173913,23,385.0,0
0,1,1,1475,1180,295,-257,-265,8,86.02777777777777,36,1182.0,0
0,1,5,766,-1405,2171,-281,-159,-122,331.43939393939394,66,768.0,1
1,1,0,554,-415,969,-200,-175,-25,238.11627906976744,43,497.0,1
0,1,0,380,441,-61,-144,-39,-105,94.33333333333333,48,377.0,0
0,1,0,285,276,9,-423,-362,-61,73.89473684210526,38,286.0,0
0,1,0,819,-497,1316,-190,-261,71,376.74285714285713,35,820.0,1
0,1,0,1526,496,1030,-154,-110,-44,266.8,40,471.0,0
0,1,7,752,-377,1129,-174,-78,-96,290.6190476190476,42,751.0,1
0,1,24,12,-22,34,-768,-746,-22,74.66666666666667,3,13.0,0
0,1,0,796,-550,1346,-250,-272,22,369.6111111111111,36,794.0,1
0,1,1,912,-474,1386,-259,-193,-66,314.6,45,914.0,1
0,1,0,1478,-2,1480,-183,-624,441,546.3571428571429,28,1491.0,1
0,1,4,1161,260,901,-169,-523,354,227.11363636363637,44,1160.0,1
0,1,0,503,-416,919,-300,-190,-110,363.65384615384613,26,-433.0,0
0,1,33,1594,-1020,2614,-310,-227,-83,451.1034482758621,58,1595.0,1
0,1,0,263,-192,455,-564,-671,107,366.61538461538464,13,264.0,1
0,1,14,1053,427,626,-228,-258,30,204.2,30,1051.0,1
0,1,8,470,-336,806,-213,-389,176,280.7586206896552,29,472.0,1
0,1,54,132,-19,151,-542,-749,207,127.29411764705883,17,-19.0,0
0,1,44,1402,-1021,2423,-241,-145,-96,448.01851851851853,54,-1017.0,0
1,1,44,463,673,-210,-115,-38,-77,73.69565217391305,23,464.0,1
1,1,33,20,856,-836,-533,-108,-425,250.63888888888889,36,19.0,1
1,1,7,622,1735,-1113,-185,-125,-60,253.37777777777777,45,634.0,1
0,1,26,1420,942,478,-196,-187,-9,172.26923076923077,26,1410.0,1
0,1,23,453,-272,725,-284,-286,2,277.2307692307692,26,451.0,1
0,1,27,841,1821,-980,-183,-87,-96,397.5,24,1810.0,0
0,1,10,577,-515,1092,-203,-132,-71,296.35135135135135,37,578.0,1
0,1,23,1170,269,901,-170,-489,319,253.42105263157896,38,258.0,0
0,1,8,642,-802,1444,-209,-228,19,302.8510638297872,47,635.0,1
0,1,0,766,458,308,-200,-202,2,290.4,10,765.0,1
0,1,18,460,-253,713,-187,-303,116,299.04,25,459.0,1
0,1,10,607,-540,1147,-69,-137,68,311.8378378378378,37,592.0,1
0,1,38,1484,336,1148,-210,-407,197,325.3783783783784,37,313.0,0
0,1,30,1864,1025,839,-177,-135,-42,267.0967741935484,31,1005.0,0
0,1,0,1149,62,1087,-236,-398,162,504.8181818181818,22,1142.0,1
0,1,17,297,1295,-998,-415,-114,-301,274.8157894736842,38,296.0,1
0,1,19,252,1241,-989,-480,-68,-412,305.1714285714286,35,252.0,1
0,1,8,773,-944,1717,-208,-90,-118,321.53846153846155,52,766.0,1
0,1,0,1113,841,272,-230,-219,-11,125.0909090909091,22,841.0,0
0,1,0,704,-732,1436,-174,-251,77,357.85,40,704.0,1
0,1,7,478,-508,986,-80,-123,43,260.53846153846155,39,-508.0,0
0,1,0,1011,-914,1925,-263,-171,-92,497.61538461538464,39,-914.0,0
0,1,45,446,434,12,-89,-157,68,210.5,40,48.0,1
0,1,2,300,-246,546,-503,-502,-1,165.3030303030303,33,301.0,1
0,1,0,245,-294,539,-575,-545,-30,169.97142857142856,35,-339.0,0
0,1,2,440,740,-300,-321,-243,-78,171.05882352941177,17,740.0,0
0,1,0,456,-635,1091,-166,-171,5,241.73333333333332,45,-636.0,0
0,1,8,204,-273,477,-637,-574,-63,207.41666666666666,24,-281.0,0
0,1,0,913,-299,1212,-202,-260,58,459.82142857142856,28,937.0,1
0,1,0,232,-833,1065,-567,-672,105,491.77272727272725,22,-833.0,0
0,1,0,1465,1130,335,-147,-160,13,183.94444444444446,18,1465.0,1
0,1,11,444,-762,1206,-230,-146,-84,307.53846153846155,39,-760.0,0
0,1,0,267,-94,361,-625,-619,-6,320.8333333333333,12,267.0,1
1,1,0,439,684,-245,-355,-241,-114,124.17241379310344,29,699.0,0
0,1,1,590,468,122,-124,-232,108,112.61538461538461,13,591.0,1
0,1,9,1487,1263,224,-131,-113,-18,117.10526315789474,19,1486.0,1
0,1,0,1298,1004,294,-282,-257,-25,147.2,20,1004.0,0
0,1,0,1049,-115,1164,-278,-496,218,278.4651162790698,43,1050.0,1
1,1,0,108,456,-348,-267,-175,-92,161.55555555555554,27,480.0,0
0,1,14,428,1323,-895,-276,-129,-147,333.03846153846155,26,1323.0,0
0,1,2,471,-420,891,-239,-151,-88,265.0285714285714,35,-446.0,0
0,1,0,313,-385,698,-237,-193,-44,250.9090909090909,33,-457.0,0
0,1,3,370,-682,1052,-257,-61,-196,297.6857142857143,35,-682.0,0
0,1,35,1200,-713,1913,-219,-125,-94,387.08,50,-728.0,0
0,1,18,1406,581,825,-226,-212,-14,253.0,32,591.0,0
0,1,0,1187,893,294,-300,-175,-125,149.15384615384616,26,1296.0,1
0,1,13,301,186,115,-542,-437,-105,92.3030303030303,33,299.0,1
0,1,0,1242,54,1188,-189,-860,671,408.5882352941176,34,1243.0,1
0,1,25,481,184,297,-289,-570,281,152.28571428571428,28,483.0,1
0,1,1,889,-354,1243,-200,-592,392,322.0,41,890.0,1
1,1,40,1307,193,1114,-121,-413,292,274.2325581395349,43,1308.0,1
0,1,79,1457,979,478,-217,-189,-28,163.85714285714286,28,1455.0,1
0,1,0,1181,-410,1591,295,-422,717,529.516129032258,31,-410.0,0
0,1,4,22,-211,233,-842,-578,-264,186.64705882352942,17,22.0,1
0,1,4,714,-381,1095,-219,-331,112,275.5128205128205,39,691.0,1
0,1,24,6,1349,-1343,-493,-168,-325,388.74285714285713,35,1345.0,0
0,1,0,847,-1114,1961,-181,-274,93,579.2941176470588,34,-1114.0,0
0,1,0,801,619,182,-198,-191,-7,181.1,10,797.0,1
0,1,0,204,-267,471,-453,-450,-3,153.1951219512195,41,206.0,1
0,1,100,223,235,-12,-549,-579,30,93.31111111111112,45,225.0,0
0,1,7,17,185,-168,-701,-531,-170,150.2941176470588,17,19.0,1
0,1,22,172,-212,384,-523,-567,44,110.22222222222223,45,70.0,1
1,1,36,1145,1144,1,-103,-125,22,72.525,40,1145.0,0
0,1,2,176,-259,435,-520,-493,-27,172.64,25,173.0,1
0,1,48,395,368,27,-468,-569,101,139.69230769230768,26,401.0,0
0,1,0,1896,1318,578,-236,-228,-8,253.1304347826087,23,1318.0,0
0,1,20,168,-1885,2053,-473,-362,-111,394.2692307692308,52,-1888.0,0
0,1,65,1187,213,974,-254,-549,295,249.53061224489795,49,105.0,1
0,1,62,295,176,119,-457,-498,41,119.3,10,182.0,0
0,1,0,291,355,-64,-515,-443,-72,191.84745762711864,59,-217.0,1
0,1,0,457,-739,1196,-207,-215,8,357.93939393939394,33,445.0,1
1,1,50,17,-192,209,-733,-421,-312,175.875,16,18.0,1
1,1,48,52,843,-791,-318,-118,-200,160.58,50,643.0,1
0,1,0,432,-348,780,-214,-176,-38,304.15384615384613,26,433.0,1
1,1,74,236,2026,-1790,-629,-112,-517,417.6,45,2054.0,0
1,1,110,473,507,-34,-84,-26,-58,97.66666666666667,9,553.0,0
1,1,94,690,1182,-492,-191,-83,-108,220.41666666666666,24,1216.0,0
0,1,0,965,-317,1282,-197,-346,149,500.6923076923077,26,964.0,1
0,1,0,65,615,-550,-101,-148,47,273.5777777777778,45,953.0,1
0,1,0,924,-480,1404,-222,-322,100,618.6521739130435,23,925.0,1
0,1,16,626,-1188,1814,-189,-204,15,350.4807692307692,52,630.0,1
0,1,0,1515,1012,503,-164,-247,83,207.83333333333334,24,1506.0,1
0,1,0,430,-593,1023,-236,-177,-59,332.3666666666667,30,431.0,1
0,1,9,659,-1100,1759,-254,-215,-39,359.57142857142856,49,-1088.0,0
0,1,64,1,43,-42,-575,-662,87,177.66666666666666,3,-18.0,0
0,1,0,213,-494,707,-528,-613,85,487.3333333333333,15,214.0,1
0,1,0,395,-606,1001,-237,-303,66,307.53125,32,405.0,1
0,1,0,504,-563,1067,-196,-233,37,331.6363636363636,33,500.0,1
0,1,111,708,856,-148,-278,-205,-73,125.07142857142857,14,863.0,0
0,1,25,1,-8,9,-739,-748,9,218.47368421052633,19,0.0,0
0,1,0,1128,212,916,-205,-324,119,500.36842105263156,19,1131.0,1
0,1,57,681,-1555,2236,-157,-142,-15,325.8169014084507,71,682.0,1
0,1,0,1062,-394,1456,-130,-625,495,545.3103448275862,29,1061.0,1
0,1,61,0,-166,166,-752,-691,-61,74.5,6,-158.0,0
0,1,25,1149,237,912,-253,-338,85,335.48148148148147,27,231.0,0
0,1,20,1478,886,592,-164,-192,28,179.5,32,891.0,0
0,1,46,1122,-893,2015,-252,-201,-51,359.375,56,-883.0,0
0,1,0,598,-230,828,-168,-336,168,429.45,20,599.0,1
0,1,12,157,-601,758,-426,-162,-264,235.52941176470588,34,-595.0,0
0,1,0,782,555,227,-194,-270,76,269.44444444444446,9,555.0,0
0,1,0,184,-384,568,-463,-250,-213,309.6818181818182,22,187.0,1
0,1,21,1215,-295,1510,-101,-494,393,369.6904761904762,42,1216.0,1
0,1,0,567,368,199,-195,-261,66,204.91666666666666,12,578.0,1
0,1,0,880,-108,988,-211,-725,514,472.2916666666667,24,-108.0,0
0,1,0,895,-174,1069,-261,-438,177,481.5652173913044,23,894.0,1
0,1,0,942,-398,1340,-238,-317,79,538.68,25,943.0,1
0,1,0,956,-575,1531,-245,-275,30,377.71666666666664,60,957.0,1
0,1,6,418,-516,934,-213,-187,-26,239.28205128205127,39,-501.0,0
0,1,13,490,645,-155,-149,-34,-115,127.15384615384616,13,645.0,0
1,1,47,1206,1459,-253,-302,-128,-174,161.94117647058823,17,1461.0,0
1,1,43,1504,1125,379,-124,-64,-60,178.0,21,1135.0,0
0,1,0,1732,1029,703,-210,-74,-136,220.15625,32,1029.0,0
0,1,0,832,518,314,-263,-333,70,299.27272727272725,11,834.0,1
0,1,33,195,-248,443,-594,-565,-29,213.38095238095238,21,195.0,1
0,1,6,259,-229,488,-523,-525,2,153.28125,32,261.0,1
0,1,0,653,-16,669,-161,-310,149,402.6470588235294,17,640.0,1
0,1,29,290,291,-1,-498,-486,-12,26.0,1,294.0,0
0,1,36,1154,265,889,-405,-466,61,310.67857142857144,28,267.0,0
0,1,0,492,-598,1090,-173,-157,-16,302.80555555555554,36,487.0,1
0,1,0,737,-527,1264,-187,-304,117,496.88461538461536,26,-527.0,0
0,1,0,764,-22,786,-172,-547,375,345.125,32,766.0,1
0,1,0,666,495,171,-219,-137,-82,175.21621621621622,37,251.0,1
0,1,0,884,-852,1736,-246,-206,-40,382.0444444444444,45,885.0,1
0,1,24,944,706,238,-174,-156,-18,105.57894736842105,19,938.0,1
0,1,48,1368,-5,1373,-300,-677,377,338.4186046511628,43,-12.0,0
0,1,0,661,-769,1430,-211,-71,-140,318.2888888888889,45,663.0,1
0,1,41,569,208,361,-240,-454,214,170.25,24,570.0,1
0,1,0,713,-680,1393,-203,-261,58,374.6216216216216,37,713.0,1
0,1,32,385,250,135,-482,-446,-36,99.4,35,163.0,0
0,1,0,336,-309,645,-492,-375,-117,273.625,24,-319.0,0
0,1,0,838,-19,857,-173,-562,389,367.4,30,840.0,1
0,1,0,790,-597,1387,-166,-224,58,314.6031746031746,63,773.0,1
0,1,35,248,265,-17,-488,-445,-43,88.97826086956522,46,277.0,0
0,1,0,1477,1431,46,-196,-211,15,114.875,8,1522.0,0
0,1,17,1273,597,676,-119,20,-139,274.72,25,1268.0,1
0,1,86,265,304,-39,-450,-484,34,90.73469387755102,49,264.0,0
0,1,1,504,-1117,1621,-228,-179,-49,304.66037735849056,53,-1117.0,0
0,1,0,694,-825,1519,-212,-232,20,423.55555555555554,36,-825.0,0
1,1,40,911,697,214,-96,-28,-68,110.10526315789474,19,690.0,0
1,1,6,810,785,25,-188,-108,-80,304.1730769230769,52,14.0,1
0,1,0,587,-637,1224,-305,-162,-143,282.04651162790697,43,-637.0,0
0,1,0,828,-892,1720,-280,-175,-105,419.5121951219512,41,821.0,1
0,1,0,575,-583,1158,-234,-166,-68,239.04255319148936,47,566.0,1
0,1,33,748,1118,-370,-140,11,-151,194.22222222222223,18,1113.0,0
0,1,0,1243,1045,198,-99,-196,97,337.0,51,1240.0,1
0,1,0,651,-942,1593,-206,-158,-48,348.73333333333335,45,647.0,1
0,1,2,1898,1288,610,-237,-217,-20,178.6060606060606,33,1888.0,1
0,1,0,2106,1416,690,-321,-327,6,396.0,18,2108.0,1
0,1,47,247,305,-58,-442,-458,16,151.0,30,132.0,1
0,1,0,749,-581,1330,-174,-233,59,358.02702702702703,37,746.0,1
0,1,0,550,-478,1028,-233,-315,82,384.2962962962963,27,551.0,1
0,1,0,562,-579,1141,-171,-294,123,387.5,30,556.0,1
0,1,0,266,-369,635,-523,-500,-23,445.0,15,265.0,1
0,1,32,299,244,55,-473,-431,-42,119.57142857142857,21,298.0,0
0,1,62,849,-980,1829,-172,-173,1,319.62068965517244,58,-991.0,0
0,1,0,746,-847,1593,-171,-191,20,372.04651162790697,43,747.0,1
0,1,56,40,176,-136,-598,-440,-158,112.47058823529412,17,183.0,0
0,1,0,242,-120,362,-490,-556,66,347.27272727272725,11,242.0,1
0,1,11,319,-489,808,-270,-205,-65,272.62068965517244,29,-492.0,0
0,1,0,890,266,624,-195,-288,93,433.6,15,891.0,1
0,1,3,947,-810,1757,-176,-203,27,385.69565217391306,46,-810.0,0
0,1,38,399,-553,952,-260,-174,-86,299.03921568627453,51,697.0,1
0,1,0,936,639,297,-161,-243,82,324.7,10,935.0,1
0,1,23,859,-584,1443,-194,-175,-19,297.1041666666667,48,-589.0,0
0,1,0,1040,-742,1782,-178,-177,-1,366.18367346938777,49,-742.0,0
0,1,0,1148,374,774,-219,-358,139,469.3529411764706,17,1146.0,1
0,1,4,834,-418,1252,-218,-231,13,284.70454545454544,44,-418.0,0
0,1,8,612,-1181,1793,-197,-134,-63,360.24,50,-1181.0,0
0,1,0,1261,-2,1263,-193,-627,434,494.4074074074074,27,-2.0,0
0,1,1,961,405,556,-178,-230,52,212.29166666666666,48,961.0,1
0,1,40,246,991,-745,-417,-133,-284,256.6,30,245.0,1
0,1,8,1186,540,646,-173,-216,43,240.30769230769232,26,540.0,0
0,1,0,770,553,217,-220,-260,40,311.57142857142856,7,769.0,1
0,1,0,522,-1021,1543,-268,-156,-112,321.4375,48,-1021.0,0
0,1,0,672,-1015,1687,-208,-221,13,302.3818181818182,55,-1015.0,0
0,1,55,454,-749,1203,-265,-218,-47,302.125,40,-760.0,0
0,1,0,229,18,211,-484,-550,66,234.5,10,227.0,1
0,1,0,421,-260,681,-282,-281,-1,310.1363636363636,22,422.0,1
0,1,0,1290,623,667,-155,-166,11,228.13793103448276,29,623.0,0
0,1,0,847,572,275,-229,-278,49,285.1,10,847.0,1
0,1,17,930,26,904,-178,-780,602,296.6111111111111,36,931.0,1
0,1,0,774,622,152,-237,-302,65,218.625,8,776.0,1
0,1,0,1488,1070,418,-173,-180,7,156.53846153846155,26,1070.0,0
0,1,12,313,-763,1076,-378,-198,-180,202.87719298245614,57,314.0,1
0,1,3,564,-532,1096,-224,-264,40,292.0810810810811,37,565.0,1
0,1,0,728,480,248,-250,-308,58,251.3,10,728.0,1
0,1,8,464,-576,1040,-233,-175,-58,280.1842105263158,38,-595.0,0
1,1,16,510,-489,999,-249,-212,-37,283.25714285714287,35,-493.0,0
0,1,20,738,1781,-1043,-190,-120,-70,240.36363636363637,44,1785.0,0
0,1,0,838,-628,1466,-218,-237,19,512.3103448275862,29,838.0,1
0,1,19,757,223,534,-147,-444,297,268.95348837209303,43,757.0,1
0,1,20,32,410,-378,-364,-142,-222,314.24,50,1026.0,1
0,1,0,882,-396,1278,-133,-243,110,498.88461538461536,26,885.0,1
0,1,23,294,1058,-764,-503,-10,-493,305.8888888888889,27,1054.0,0
0,1,28,112,-786,898,-280,-265,-15,288.0967741935484,31,-798.0,0
0,1,0,813,-97,910,-192,-187,-5,483.2631578947368,19,814.0,1
0,1,40,508,-494,1002,-227,-147,-80,317.38709677419354,31,-484.0,0
0,1,0,240,-357,597,-600,-604,4,387.8125,16,239.0,1
0,1,4,812,-1174,1986,-207,-92,-115,443.0888888888889,45,-1174.0,0
0,1,0,181,835,-654,-284,-62,-222,320.05,20,816.0,0
1,1,45,888,-921,1809,-131,-21,-110,274.3731343283582,67,884.0,1
1,1,29,821,1145,-324,-75,-160,85,92.54347826086956,46,822.0,1
0,1,14,444,651,-207,-214,-142,-72,109.58823529411765,17,443.0,1
0,1,35,928,-223,1151,-249,-482,233,205.93203883495147,103,929.0,1
1,1,46,784,1377,-593,-73,-75,2,213.56140350877192,57,785.0,1
1,1,43,276,-287,563,-485,-453,-32,147.30769230769232,39,277.0,1
1,1,0,475,-502,977,-181,-170,-11,249.0,39,477.0,1
0,1,27,160,-1748,1908,-447,-100,-347,415.0851063829787,47,-1752.0,0
0,1,0,848,-351,1199,-217,-204,-13,455.2692307692308,26,850.0,1
0,1,18,816,-1172,1988,-143,-130,-13,374.79245283018867,53,816.0,1
0,1,75,12,-671,683,-216,-105,-111,264.0,25,-657.0,0
0,1,60,449,-441,890,-128,-157,29,274.27272727272725,33,446.0,1
0,1,126,51,203,-152,-627,-533,-94,111.6923076923077,13,204.0,0
0,1,0,936,-267,1203,-163,-274,111,505.0416666666667,24,935.0,1
0,1,0,293,-481,774,-511,-642,131,380.0952380952381,21,290.0,1
0,1,25,465,-493,958,-178,-164,-14,287.79411764705884,34,-504.0,0
0,1,15,573,7,566,-174,-488,314,212.13513513513513,37,-70.0,0
0,1,39,472,-240,712,-190,-410,220,272.60714285714283,28,-233.0,0
0,1,0,1007,-43,1050,-208,-779,571,505.625,24,1006.0,1
0,1,0,688,-322,1010,-164,-208,44,486.42857142857144,21,691.0,1
0,1,10,690,1663,-973,-293,-195,-98,366.7692307692308,26,1671.0,0
0,1,6,874,-1142,2016,-150,-104,-46,403.2549019607843,51,-1142.0,0
0,1,0,820,-325,1145,-158,-264,106,517.3636363636364,22,822.0,1
0,1,9,282,-2022,2304,-428,-122,-306,476.3265306122449,49,285.0,1
0,1,0,1093,-234,1327,-268,-333,65,535.32,25,-234.0,0
0,1,22,440,-496,936,-86,-129,43,248.475,40,440.0,1
0,1,0,504,-322,826,-192,-206,14,423.45,20,506.0,1
0,1,0,627,456,171,-283,-282,-1,229.625,8,629.0,1
0,1,0,1872,-243,2115,-274,-744,470,581.2051282051282,39,-243.0,0
0,1,29,3,181,-178,-554,-537,-17,161.58333333333334,12,204.0,0
0,1,0,2069,1885,184,-206,-189,-17,212.11111111111111,9,2071.0,1
1,1,45,1011,513,498,-193,-160,-33,131.05128205128204,39,506.0,0
1,1,44,1450,369,1081,-235,-391,156,233.91666666666666,48,346.0,0
1,1,40,1901,837,1064,-174,-83,-91,214.95833333333334,48,847.0,0
0,1,43,1342,247,1095,-332,-485,153,284.6829268292683,41,246.0,0
0,1,28,143,-208,351,-532,-463,-69,129.65384615384616,26,-212.0,0
0,1,31,40,1141,-1101,-448,-156,-292,293.6923076923077,39,1139.0,0
0,1,0,829,-804,1633,-286,-209,-77,425.02564102564105,39,830.0,1
0,1,0,215,-92,307,-535,-567,32,282.54545454545456,11,213.0,1
0,1,33,924,-914,1838,-240,-233,-7,407.25,44,915.0,1
0,1,14,200,-541,741,-292,-156,-136,241.83333333333334,30,-420.0,1
0,1,0,1873,1562,311,-259,-216,-43,236.64285714285714,14,1875.0,1
1,1,60,508,504,4,-251,-229,-22,42.0,2,523.0,0
1,1,24,486,1930,-1444,-323,-109,-214,368.94736842105266,38,1905.0,0
1,1,19,622,-609,1231,-201,-185,-16,251.81632653061226,49,623.0,1
1,1,23,738,-1292,2030,-226,-222,-4,362.39285714285717,56,-1294.0,0
0,1,3,199,-163,362,-508,-481,-27,133.4814814814815,27,199.0,1
0,1,0,763,-14,777,-307,-310,3,410.7368421052632,19,-14.0,0
0,1,0,919,-250,1169,-203,-264,61,515.8695652173913,23,-250.0,0
0,1,0,1882,1765,117,-190,-59,-131,139.28571428571428,7,1870.0,1
1,1,39,280,-1699,1979,-452,-131,-321,345.36206896551727,58,-1715.0,0
1,1,72,979,2129,-1150,-185,-145,-40,285.1904761904762,42,976.0,1
0,1,67,191,-234,425,-483,-426,-57,191.95652173913044,23,-240.0,0
1,1,51,1333,274,1059,-207,-432,225,285.61538461538464,39,275.0,0
0,1,5,264,-260,524,-533,-427,-106,202.44,25,264.0,1
0,1,0,1014,-404,1418,-237,-209,-28,537.4814814814815,27,1014.0,1
0,1,44,1070,-521,1591,-289,-123,-166,310.36,50,1071.0,1
0,1,0,1092,-954,2046,-312,-282,-30,454.6666666666667,45,1093.0,1
0,1,27,112,530,-418,-239,-67,-172,162.4814814814815,27,547.0,0
0,1,0,1239,1897,-658,-257,-231,-26,325.0,24,1897.0,0
0,1,26,794,534,260,-69,-221,152,112.25,28,810.0,1
0,1,82,251,-2201,2452,-444,-133,-311,384.453125,64,-2197.0,0
0,1,16,1594,560,1034,-314,-190,-124,273.2631578947368,38,1597.0,1
0,1,0,692,-359,1051,-190,-241,51,341.4516129032258,31,-359.0,0
0,1,23,229,214,15,-498,-472,-26,36.5,2,228.0,0
0,1,12,442,-661,1103,-232,-36,-196,242.8913043478261,46,-665.0,0
0,1,9,228,-261,489,-475,-382,-93,235.85714285714286,21,229.0,1
0,1,0,1402,643,759,-123,-194,71,259.7586206896552,29,1402.0,1
0,1,0,1078,574,504,-269,-204,-65,397.1333333333333,15,987.0,1
0,1,13,3,390,-387,-545,-495,-50,155.6,25,385.0,0
0,1,0,906,463,443,-230,-138,-92,288.07142857142856,14,905.0,1
0,1,24,1067,-274,1341,-260,-520,260,434.51612903225805,31,-283.0,0
0,1,0,279,-29,308,-517,-618,101,323.0,10,280.0,1
0,1,55,547,601,-54,-222,-161,-61,76.8,5,589.0,0
0,1,21,162,-766,928,-522,-143,-379,287.6,35,-783.0,0
0,1,13,510,-533,1043,-214,-171,-43,281.7837837837838,37,-533.0,0
0,1,0,513,154,359,-175,-260,85,360.2,10,516.0,1
0,1,0,618,272,346,-189,-264,75,332.72727272727275,11,616.0,1
0,1,0,945,-118,1063,-190,-315,125,537.15,20,927.0,1
0,1,0,917,-244,1161,-169,-180,11,552.3181818181819,22,919.0,1
0,1,0,175,-1455,1630,-410,-343,-67,493.6060606060606,33,-1455.0,0
0,1,24,1235,-388,1623,-157,-209,52,378.83720930232556,43,1236.0,1
0,1,0,636,286,350,-238,-306,68,314.38461538461536,13,673.0,1
0,1,27,476,-475,951,-244,-202,-42,299.125,32,-484.0,0
0,1,0,852,275,577,-199,-340,141,378.625,16,853.0,1
0,1,0,1307,1240,67,-174,-201,27,99.16666666666667,6,1285.0,0
0,1,0,256,-81,337,-523,-637,114,363.4,10,253.0,1
0,1,0,973,-306,1279,-245,-204,-41,540.6666666666666,24,973.0,1
0,1,0,1013,-816,1829,-241,-235,-6,522.1428571428571,35,1010.0,1
0,1,16,1080,216,864,-166,-418,252,205.1627906976744,43,224.0,0
0,1,0,571,-145,716,-377,-574,197,233.375,32,258.0,1
0,1,0,1855,1136,719,-188,-158,-30,275.0769230769231,26,1136.0,0
0,1,9,510,-1410,1920,-214,-163,-51,379.4901960784314,51,-1410.0,0
0,1,0,1033,586,447,-221,-283,62,377.9166666666667,12,586.0,0
0,1,0,292,-184,476,-535,-577,42,324.4,15,293.0,1
0,1,0,905,-703,1608,-197,-193,-4,414.5128205128205,39,912.0,1
0,1,0,1442,700,742,-182,-218,36,413.1666666666667,18,1441.0,1
0,1,13,936,390,546,-190,-167,-23,220.76,25,938.0,1
0,1,0,961,-669,1630,-245,-293,48,393.59183673469386,49,1102.0,1
1,1,76,870,985,-115,-106,-45,-61,90.58333333333333,12,978.0,0
0,1,0,1709,722,987,-157,-104,-53,263.4166666666667,36,722.0,0
0,1,2,311,698,-387,-494,-196,-298,199.22727272727272,22,310.0,1
0,1,0,1161,-1060,2221,-282,-178,-104,444.3,50,1162.0,1
0,1,14,706,-1461,2167,-182,-95,-87,372.36206896551727,58,-1461.0,0
0,1,0,1026,306,720,-207,-333,126,437.05882352941177,17,1026.0,1
0,1,0,875,-1022,1897,-183,-155,-28,316.95,60,875.0,1
0,1,0,926,-303,1229,-207,-270,63,516.4166666666666,24,926.0,1
0,1,64,273,2131,-1858,-531,-185,-346,418.3777777777778,45,276.0,1
0,1,35,226,-1987,2213,-512,-92,-420,411.1320754716981,53,-1952.0,0
1,1,24,572,-462,1034,-181,-180,-1,288.77777777777777,36,571.0,1
1,1,58,451,-577,1028,-105,-235,130,264.1025641025641,39,452.0,1
0,1,5,692,-847,1539,-94,-165,71,407.7,40,692.0,1
0,1,26,47,10,37,-717,-734,17,163.0,1,48.0,0
0,1,0,1814,1051,763,-193,-117,-76,272.32142857142856,28,1051.0,0
0,1,1,160,-225,385,-546,-479,-67,154.36666666666667,30,186.0,1
1,1,30,232,-230,462,-536,-473,-63,121.775,40,233.0,1
1,1,35,1591,1756,-165,-79,-29,-50,108.85714285714286,14,1590.0,1
0,1,21,205,-188,393,-505,-459,-46,154.19230769230768,26,204.0,1
0,1,0,1383,137,1246,-121,-557,436,310.35714285714283,42,137.0,0
0,1,60,551,745,-194,-201,-221,20,107.0625,16,550.0,1
0,1,0,232,-1952,2184,-509,-174,-335,426.9423076923077,52,233.0,1
0,1,0,988,307,681,-194,-331,137,425.88235294117646,17,996.0,1
0,1,28,288,-432,720,-273,-230,-43,316.8636363636364,22,-438.0,0
0,1,0,1338,670,668,-290,-397,107,345.3,20,1337.0,1
0,1,0,224,-249,473,-502,-539,37,141.38709677419354,31,-225.0,0
0,1,0,970,381,589,-216,-263,47,375.25,16,381.0,0
0,1,30,1177,566,611,-189,-90,-99,215.09375,32,516.0,0
0,1,7,983,-1046,2029,-193,-161,-32,405.52,50,-1046.0,0
0,1,0,231,-204,435,-552,-510,-42,211.95,20,232.0,1
0,1,47,414,1019,-605,-193,-139,-54,206.3448275862069,29,414.0,1
0,1,0,1156,788,368,-206,-135,-71,150.875,24,1157.0,1
0,1,27,39,249,-210,-598,-523,-75,114.7,20,266.0,0
0,1,0,246,246,0,-524,-467,-57,88.5,4,248.0,0
0,1,1,1005,-208,1213,-270,-434,164,525.1666666666666,24,-208.0,0
0,1,0,196,-222,418,-550,-550,0,181.17391304347825,23,-222.0,0
0,1,1,214,-263,477,-520,-496,-24,154.16129032258064,31,217.0,1
0,1,28,514,849,-335,-53,-73,20,177.38888888888889,18,849.0,0
0,1,0,819,601,218,-218,-272,54,268.8888888888889,9,819.0,1
0,1,9,1217,439,778,-201,-224,23,250.96666666666667,30,1214.0,1
0,1,12,1013,-283,1296,-232,-514,282,295.5777777777778,45,1016.0,1
0,1,0,10,51,-41,-454,-450,-4,75.0,2,9.0,0
0,1,0,7,692,-685,-714,179,-893,204.47727272727272,44,8.0,1
0,1,0,842,855,-13,-76,350,-426,149.0,3,843.0,0
0,1,0,509,507,2,-270,130,-400,115.25,4,510.0,0
0,1,0,865,832,33,-90,318,-408,169.0,1,862.0,0
0,1,1,446,481,-35,-79,309,-388,109.0,1,449.0,0
0,1,0,530,-791,1321,-264,186,-450,263.66,50,529.0,1
0,1,0,1135,1090,45,-136,266,-402,174.5,2,1130.0,0
0,1,0,778,-570,1348,-174,-12,-162,553.9583333333334,24,779.0,1
0,1,0,253,319,-66,-469,-229,-240,102.33333333333333,3,252.0,0
0,1,0,665,-453,1118,-266,-307,41,469.0833333333333,24,667.0,1
0,1,0,1180,-451,1631,-199,-641,442,471.0952380952381,42,1179.0,1
0,1,0,343,-766,1109,-270,-324,54,583.6315789473684,19,-766.0,0
0,1,0,648,-626,1274,-269,-251,-18,401.7096774193548,31,-626.0,0
0,1,11,1390,1397,-7,-207,-221,14,36.0,1,1401.0,0
0,1,15,1258,1000,258,-196,-150,-46,110.04347826086956,23,1007.0,0
1,1,31,997,1126,-129,-66,-75,9,121.9322033898305,59,998.0,1
0,1,43,2017,567,1450,-238,-150,-88,206.31460674157304,89,353.0,1
0,1,42,2,-36,38,-721,-700,-21,143.65,20,1.0,0
0,1,17,826,855,-29,-94,-32,-62,109.09677419354838,62,824.0,0
0,1,0,700,-557,1257,-220,-217,-3,313.65,40,700.0,1
0,1,0,186,-3,189,-326,-382,56,145.76470588235293,17,-35.0,0
0,1,0,1229,-1146,2375,-205,-272,67,530.9111111111112,45,1231.0,1
0,1,0,6,219,-213,-468,-481,13,167.69230769230768,13,219.0,0
0,1,30,960,1174,-214,-148,-184,36,132.42391304347825,92,999.0,1
0,1,45,297,311,-14,-432,-427,-5,132.9156626506024,83,304.0,0
1,1,86,21,11,10,-806,-754,-52,106.0,4,16.0,0
0,1,0,874,393,481,-164,-177,13,180.26923076923077,26,871.0,1
0,1,0,0,-185,185,-449,-492,43,150.75,12,2.0,1
0,1,10,161,-1629,1790,-468,-182,-286,367.56,50,-1636.0,0
0,1,0,875,-438,1313,-276,-367,91,474.82142857142856,28,875.0,1
0,1,0,541,400,141,-323,-305,-18,197.83333333333334,6,548.0,1
0,1,0,1085,1366,-281,-108,-143,35,147.3548387096774,62,1102.0,1
0,1,0,1023,-162,1185,-274,-136,-138,471.0,25,1017.0,1
0,1,0,1416,1056,360,-167,-173,6,148.66666666666666,24,1056.0,0
0,1,0,471,133,338,-267,-291,24,287.9166666666667,12,472.0,1
0,1,0,273,-408,681,-631,-660,29,462.73333333333335,15,269.0,1
0,1,0,990,573,417,-174,-193,19,313.53846153846155,13,979.0,1
0,1,2,8,532,-524,-289,-231,-58,266.2631578947368,19,532.0,0
0,1,21,1036,-709,1745,-260,-185,-75,340.9019607843137,51,1038.0,1
0,1,13,1522,942,580,-142,-149,7,220.19230769230768,26,1521.0,1
0,1,0,829,-650,1479,-260,-309,49,548.4444444444445,27,827.0,1
0,1,6,590,-475,1065,-206,-137,-69,318.0882352941176,34,591.0,1
0,1,0,424,-512,936,-263,-197,-66,307.9,30,-507.0,0
0,1,0,477,114,363,-177,-249,72,379.1,10,475.0,1
0,1,2,1182,-1003,2185,-245,-55,-190,365.59375,64,1246.0,1
0,1,0,1173,248,925,-221,-225,4,241.575,40,494.0,1
0,1,0,1644,594,1050,-154,-159,5,209.90384615384616,52,589.0,0
0,1,0,1340,450,890,-146,-118,-28,239.97297297297297,37,459.0,0
0,1,0,1038,399,639,-204,-226,22,226.2962962962963,27,1034.0,1
0,1,25,1158,21,1137,-314,-562,248,286.6666666666667,42,1150.0,1
0,1,0,1015,194,821,-185,-249,64,405.55,20,1007.0,1
0,1,0,823,606,217,-293,-315,22,274.125,8,817.0,1
0,1,0,1070,-265,1335,-278,-519,241,277.1730769230769,52,1078.0,1
0,1,2,866,380,486,-207,-169,-38,193.6153846153846,26,868.0,1
1,1,29,268,226,42,-487,-394,-93,76.32,25,126.0,1
1,1,51,1010,619,391,-213,-72,-141,199.14285714285714,21,596.0,0
0,1,0,743,-284,1027,-300,-335,35,524.35,20,740.0,1
0,1,39,687,537,150,-164,-224,60,103.92307692307692,13,688.0,1
0,1,79,708,667,41,-62,304,-366,44.333333333333336,3,681.0,0
0,1,6,709,-828,1537,-251,-216,-35,320.9791666666667,48,-830.0,0
0,1,6,636,-962,1598,-264,-308,44,400.9,40,-965.0,0
0,1,0,1454,1041,413,-146,-126,-20,116.11111111111111,36,1041.0,0
0,1,0,241,-280,521,-503,-498,-5,190.71428571428572,28,242.0,1
0,1,7,1581,979,602,-197,-187,-10,193.38709677419354,31,1583.0,1
0,1,0,0,4,-4,-773,-554,-219,106.2,5,0.0,0
0,1,30,766,-902,1668,-204,-184,-20,352.29787234042556,47,-904.0,0
0,1,0,885,538,347,-213,-274,61,315.5833333333333,12,899.0,1
0,1,25,209,-785,994,-322,-144,-178,362.57142857142856,28,-796.0,0
1,1,24,1504,207,1297,-171,-518,347,269.92452830188677,53,158.0,0
1,1,42,864,1368,-504,-41,-48,7,148.06060606060606,33,1373.0,0
0,1,0,12,4,8,-707,-647,-60,105.0,3,13.0,0
0,1,13,198,897,-699,-280,-187,-93,296.30434782608694,23,876.0,0
0,1,0,895,146,749,-152,-293,141,435.77777777777777,18,146.0,0
0,1,0,751,773,-22,-81,236,-317,164.0,1,753.0,0
0,1,0,478,-498,976,-195,86,-281,266.94736842105266,38,479.0,1
0,1,0,7,15,-8,-687,-516,-171,133.75,4,15.0,0
0,1,0,338,-244,582,-507,-487,-20,170.0909090909091,33,339.0,1
0,1,0,1070,-320,1390,-242,-265,23,439.25,32,1073.0,1
0,1,0,2,371,-369,-774,-814,40,332.1666666666667,12,0.0,1
0,1,0,991,-451,1442,-281,-355,74,538.6666666666666,27,993.0,1
0,1,49,1394,408,986,-191,-277,86,245.925,40,404.0,0
0,1,13,619,-988,1607,-179,-121,-58,276.82456140350877,57,-860.0,1
0,1,47,1,-157,158,-685,-532,-153,86.52380952380952,21,3.0,1
0,1,21,249,227,22,-565,-464,-101,125.78571428571429,56,257.0,0
1,1,0,15,-274,289,-860,-551,-309,133.36,25,20.0,1
0,1,32,177,-486,663,-464,-246,-218,209.5151515151515,33,-486.0,0
0,1,26,778,162,616,-218,-408,190,211.86206896551724,29,771.0,1
0,1,50,184,-429,613,-452,-226,-226,192.6764705882353,34,183.0,1
0,1,1,235,-273,508,-614,-553,-61,221.08695652173913,23,236.0,1
0,1,42,1588,679,909,-165,-131,-34,260.7647058823529,34,682.0,0
0,1,0,596,-506,1102,-223,-276,53,431.84,25,594.0,1
0,1,54,150,-481,631,-445,-218,-227,172.56756756756758,37,151.0,1
0,1,0,634,373,261,-269,-270,1,238.72727272727272,11,636.0,1
0,1,0,12,251,-239,-773,-784,11,292.44444444444446,9,10.0,1
0,1,0,1001,-572,1573,-308,-293,-15,420.8205128205128,39,1002.0,1
0,1,67,830,-900,1730,-169,-177,8,380.53333333333336,45,831.0,1
0,1,28,497,232,265,-293,-269,-24,84.0,31,497.0,1
1,1,0,474,-193,667,-275,-515,240,210.67567567567568,37,475.0,1
1,1,25,21,237,-216,-563,-478,-85,109.84210526315789,19,20.0,1
1,1,27,503,951,-448,-91,-56,-35,162.6,25,507.0,1
1,1,27,466,-20,486,-265,-708,443,254.92307692307693,26,467.0,1
1,1,8,470,1149,-679,-99,-29,-70,232.86666666666667,30,464.0,1
0,1,0,16,-253,269,-511,-507,-4,137.57894736842104,19,17.0,1
0,1,25,462,-766,1228,-204,-206,2,370.75757575757575,33,-777.0,0
0,1,0,472,488,-16,-98,-76,-22,53.333333333333336,18,459.0,0
0,1,9,7,-259,266,-844,-534,-310,163.04761904761904,21,2.0,1
0,1,55,1501,1243,258,-177,-203,26,159.0625,16,1238.0,0
0,1,9,4,302,-298,-789,-547,-242,184.57894736842104,19,7.0,1
0,1,30,651,-911,1562,-191,-169,-22,328.6666666666667,48,-915.0,0
1,1,45,917,1066,-149,-198,-141,-57,113.16666666666667,12,934.0,1
1,1,32,807,1974,-1167,-74,-38,-36,330.0857142857143,35,825.0,1
1,1,34,836,1310,-474,-66,-93,27,160.96428571428572,28,843.0,1
0,1,0,1498,644,854,-260,-371,111,437.85,20,1499.0,1
0,1,0,432,189,243,-235,-385,150,190.65116279069767,43,-91.0,1
0,1,8,740,-680,1420,-251,-142,-109,284.66,50,-672.0,0
0,1,0,1037,535,502,-248,-274,26,367.0,14,1033.0,1
1,1,46,216,226,-10,-500,-394,-106,86.25,4,213.0,0
1,1,9,651,-1165,1816,-186,-118,-68,367.1224489795918,49,652.0,1
0,1,0,181,-542,723,-458,-73,-385,207.43243243243242,37,182.0,1
0,1,0,965,488,477,-215,-223,8,383.84615384615387,13,965.0,1
0,1,14,33,-731,764,-281,-88,-193,285.43333333333334,30,-736.0,0
0,1,0,493,451,42,-269,-218,-51,33.8,5,451.0,0
0,1,12,359,319,40,-459,-463,4,240.8448275862069,58,1029.0,1
0,1,0,1245,967,278,-69,36,-105,143.5,52,709.0,1
0,1,39,26,179,-153,-682,-583,-99,91.34782608695652,23,202.0,0
0,1,0,617,354,263,-229,-280,51,161.71428571428572,14,610.0,1
0,1,0,480,-242,722,-250,-297,47,436.6470588235294,17,479.0,1
0,1,0,2032,667,1365,-284,-374,90,456.2,30,667.0,0
0,1,59,188,996,-808,-502,-260,-242,235.21621621621622,37,984.0,0
0,1,0,1522,569,953,-145,-103,-42,225.46341463414635,41,1522.0,1
0,1,0,1175,474,701,-199,-252,53,432.3529411764706,17,1177.0,1
0,1,0,914,476,438,-250,-227,-23,359.0,13,476.0,0
0,1,0,1502,623,879,-193,-35,-158,241.55,40,563.0,0
0,1,0,1575,913,662,-224,-242,18,278.4583333333333,24,913.0,0
0,1,0,461,-512,973,-195,-221,26,345.42857142857144,28,460.0,1
0,1,0,649,-845,1494,-255,-209,-46,423.74285714285713,35,650.0,1
1,1,32,197,3,194,-634,-765,131,110.08333333333333,24,4.0,0
0,1,0,624,-803,1427,-224,-123,-101,386.35135135135135,37,625.0,1
0,1,0,274,-1639,1913,-478,-212,-266,499.36842105263156,38,-1639.0,0
0,1,0,799,780,19,-225,-219,-6,145.91666666666666,24,797.0,0
0,1,0,692,-960,1652,-224,-138,-86,281.9710144927536,69,690.0,1
0,1,34,498,-958,1456,-253,-49,-204,339.0487804878049,41,-931.0,0
0,1,0,992,300,692,-157,-126,-31,413.1666666666667,18,995.0,1
0,1,4,926,-1054,1980,-228,-43,-185,401.1224489795918,49,-1054.0,0
0,1,0,915,-130,1045,-200,-511,311,396.61290322580646,31,917.0,1
0,1,1,1533,951,582,-196,-178,-18,201.64285714285714,28,1531.0,1
0,1,34,166,259,-93,-570,-436,-134,204.23076923076923,39,-182.0,1
0,1,1,430,491,-61,-227,-79,-148,186.8421052631579,38,108.0,1
0,1,0,205,-159,364,-526,-365,-161,163.04761904761904,21,207.0,1
0,1,57,995,1007,-12,-77,-13,-64,35.0,1,1002.0,0
0,1,7,211,1165,-954,-479,-127,-352,253.28205128205127,39,208.0,1
0,1,0,597,-657,1254,-282,-152,-130,376.06060606060606,33,600.0,1
0,1,5,515,-465,980,-204,-143,-61,275.7142857142857,35,514.0,1
0,1,0,1635,899,736,-240,-171,-69,286.0,26,1638.0,1
0,1,21,605,-1119,1724,-198,-81,-117,276.88524590163934,61,606.0,1
0,1,0,1150,-445,1595,-197,-318,121,403.48837209302326,43,1153.0,1
0,1,10,231,-232,463,-537,-523,-14,188.57692307692307,26,220.0,1
0,1,0,904,32,872,-249,-611,362,479.55,20,904.0,1
0,1,5,1141,758,383,-233,-177,-56,205.77777777777777,18,758.0,0
0,1,0,455,490,-35,-135,-82,-53,39.241379310344826,29,466.0,0
0,1,23,569,1179,-610,-227,-182,-45,211.7741935483871,31,566.0,1
1,1,32,218,-191,409,-530,-460,-70,186.33333333333334,24,218.0,1
0,1,0,699,442,257,-212,-275,63,306.3333333333333,9,701.0,1
0,1,52,810,1592,-782,-226,-141,-85,319.7083333333333,24,1598.0,0
1,1,59,1579,627,952,-143,-151,8,251.28947368421052,38,611.0,0
1,1,55,2187,536,1651,-259,-214,-45,359.2,45,548.0,0
0,1,17,225,-1445,1670,-523,-449,-74,334.7450980392157,51,-1441.0,0
0,1,0,830,546,284,-68,-269,201,287.3,10,816.0,1
0,1,0,1206,769,437,-387,-411,24,323.7142857142857,14,1203.0,1
0,1,44,100,761,-661,-303,-271,-32,234.92592592592592,27,755.0,0
0,1,23,262,-251,513,-482,-405,-77,180.62962962962962,27,264.0,1
0,1,58,190,311,-121,-380,-418,38,117.33333333333333,9,305.0,0
0,1,0,732,422,310,-147,-286,139,369.77777777777777,9,733.0,1
0,1,55,767,-277,1044,-171,-424,253,261.4318181818182,44,768.0,1
0,1,0,151,297,-146,-449,-420,-29,171.66666666666666,6,156.0,1
0,1,0,846,-394,1240,-224,-391,167,282.5111111111111,45,-287.0,1
0,1,1,409,438,-29,-67,-62,-5,48.945945945945944,37,396.0,0
1,1,52,1103,566,537,-139,-151,12,166.32258064516128,31,569.0,0
1,1,0,557,-502,1059,-231,-164,-67,228.80392156862746,51,-568.0,0
0,1,9,161,-249,410,-605,-594,-11,200.95,20,-254.0,0
0,1,21,263,-87,350,-483,-117,-366,220.94736842105263,19,-13.0,0
0,1,0,446,-421,867,-228,-217,-11,308.67857142857144,28,447.0,1
0,1,0,862,14,848,-263,-570,307,449.4,20,14.0,0
0,1,0,88,-410,498,-275,-418,143,204.28,25,-248.0,1
0,1,0,1115,416,699,-244,-364,120,424.0,17,1123.0,1
0,1,0,722,-379,1101,-245,-293,48,384.03125,32,790.0,1
0,1,0,1262,621,641,-242,-347,105,407.5,16,1258.0,1
0,1,0,787,509,278,-191,-298,107,329.22222222222223,9,788.0,1
0,1,0,755,309,446,-171,-366,195,358.2142857142857,14,757.0,1
0,1,28,185,170,15,-491,-484,-7,15.0,2,183.0,0
0,1,0,216,-146,362,-485,-533,48,380.2,10,218.0,1
0,1,0,953,550,403,-160,-286,126,353.0833333333333,12,954.0,1
0,1,0,1070,-134,1204,-193,-629,436,517.48,25,1060.0,1
0,1,0,1137,288,849,-195,-538,343,440.5238095238095,21,1133.0,1
0,1,48,197,-202,399,-519,-566,47,182.42857142857142,21,199.0,1
0,1,67,225,-241,466,-519,-501,-18,171.0,27,-225.0,0
0,1,81,183,-1407,1590,-554,-89,-465,346.625,48,184.0,1
0,1,6,1650,1061,589,-209,-161,-48,177.4848484848485,33,1061.0,0
0,1,32,200,-202,402,-519,-508,-11,123.29032258064517,31,201.0,1
0,1,0,985,-744,1729,-186,-813,627,501.5135135135135,37,986.0,1
0,1,40,966,-817,1783,-181,-182,1,329.4259259259259,54,-831.0,0
0,1,6,234,-263,497,-585,-374,-211,214.08333333333334,24,235.0,1
0,1,0,1599,850,749,-214,-120,-94,215.11428571428573,35,1602.0,1
0,1,18,904,940,-36,-112,-4,-108,83.3225806451613,31,906.0,0
0,1,14,155,-206,361,-570,-531,-39,148.375,24,-212.0,0
0,1,0,161,-448,609,-501,-144,-357,234.5483870967742,31,-477.0,0
0,1,0,443,-179,622,-250,-329,79,371.88235294117646,17,444.0,1
0,1,0,0,1183,-1183,-791,-259,-532,321.3125,48,-61.0,1
0,1,37,785,-937,1722,-211,-38,-173,323.18518518518516,54,-952.0,0
0,1,0,900,-926,1826,-263,-157,-106,428.14285714285717,42,-926.0,0
0,1,0,1018,635,383,-226,-388,162,339.6666666666667,15,1051.0,1
0,1,34,650,1432,-782,-404,-53,-351,284.44827586206895,29,1445.0,0
1,1,19,461,-1093,1554,-223,-72,-151,313.29411764705884,51,463.0,1
1,1,0,440,-424,864,-234,-88,-146,227.52777777777777,36,442.0,1
1,1,40,587,870,-283,-94,20,-114,114.43478260869566,23,585.0,1
0,1,37,75,-239,314,-564,-404,-160,139.71428571428572,21,-226.0,0
0,1,37,27,13,14,-778,-739,-39,160.14285714285714,7,28.0,0
0,1,0,2024,413,1611,-172,-486,314,516.75,32,413.0,0
0,1,0,1248,-1166,2414,-176,-179,3,557.5348837209302,43,1251.0,1
0,1,0,1666,1327,339,-210,-165,-45,194.11111111111111,18,1667.0,1
0,1,0,1620,1071,549,-189,-193,4,180.33333333333334,30,1618.0,1
0,1,0,530,415,115,-232,-193,-39,201.57894736842104,38,531.0,1
0,1,0,848,758,90,-178,-148,-30,244.4468085106383,47,849.0,0
0,1,0,845,-109,954,-283,-280,-3,381.86764705882354,68,-930.0,1
0,1,0,1607,-220,1827,-268,-202,-66,470.1025641025641,39,1608.0,1
0,1,0,278,-244,522,-477,-458,-19,317.11764705882354,17,278.0,1
0,1,0,1862,1340,522,-236,-178,-58,237.63636363636363,22,1860.0,1
0,1,39,3,-492,495,-216,-84,-132,239.61904761904762,21,-499.0,0
0,1,0,514,-1038,1552,-223,-269,46,335.17391304347825,46,515.0,1
0,1,0,541,-1211,1752,-221,-241,20,400.1818181818182,44,539.0,1
0,1,0,441,-213,654,-253,-343,90,219.0,30,443.0,1
0,1,22,819,271,548,-349,-348,-1,223.5,28,232.0,0
1,1,35,119,-250,369,-568,-521,-47,191.35,20,-261.0,0
0,1,0,729,-1119,1848,-204,-158,-46,339.22093023255815,86,730.0,1
0,1,17,800,-833,1633,-268,-239,-29,371.5348837209302,43,-833.0,0
0,1,0,674,-1044,1718,-219,-175,-44,322.1585365853659,82,-1518.0,1
0,1,39,50,-236,286,-578,-389,-189,280.22222222222223,108,37.0,1
0,1,82,287,1008,-721,-459,-259,-200,255.31034482758622,29,1008.0,0
0,1,0,504,406,98,-200,-212,12,309.4166666666667,36,503.0,0
0,1,0,1430,762,668,-286,-212,-74,244.03703703703704,27,762.0,0
0,1,17,437,-786,1223,-233,-59,-174,356.0882352941176,34,-788.0,0
0,1,0,1504,951,553,-246,-146,-100,236.1818181818182,22,1495.0,1
0,1,12,1296,-253,1549,-372,-418,46,426.1621621621622,37,-269.0,0
0,1,0,1636,1089,547,-268,-144,-124,223.32,25,1636.0,1
0,1,0,86,747,-661,-318,-235,-83,296.95454545454544,22,747.0,0
0,1,0,501,407,94,-241,-191,-50,233.85714285714286,35,498.0,0
0,1,0,1007,-754,1761,-231,-224,-7,534.3030303030303,33,-754.0,0
0,1,0,1444,1075,369,-201,-207,6,224.41176470588235,17,1075.0,0
1,1,29,248,-203,451,-562,-537,-25,202.63636363636363,22,-199.0,0
0,1,12,153,-1182,1335,-227,-207,-20,263.16326530612247,49,-1182.0,0
0,1,0,949,133,816,-241,-266,25,407.4788732394366,71,-897.0,1
1,1,24,759,1393,-634,-161,-155,-6,206.3,30,758.0,1
1,1,22,28,240,-212,-701,-456,-245,143.5,20,27.0,1
1,1,5,346,539,-193,-187,-74,-113,122.11764705882354,17,522.0,0
1,1,22,49,471,-422,-439,-128,-311,265.7894736842105,19,481.0,0
0,1,3,1570,1156,414,-169,-115,-54,162.32,25,1156.0,0
1,1,41,97,-235,332,-548,-484,-64,157.14285714285714,21,-231.0,0
1,1,20,755,1061,-306,-136,-95,-41,150.71428571428572,21,1065.0,0
1,1,28,822,655,167,-224,-76,-148,118.61538461538461,13,668.0,0
0,1,0,994,-674,1668,-172,-280,108,379.90909090909093,44,996.0,1
0,1,22,139,256,-117,-356,-461,105,127.21052631578948,19,109.0,1
0,1,0,558,604,-46,-203,-193,-10,177.8,45,558.0,0
0,1,0,1318,914,404,-236,-207,-29,139.77777777777777,27,914.0,0
1,1,65,457,618,-161,-402,-230,-172,152.76923076923077,13,614.0,0
1,1,59,258,474,-216,-315,-163,-152,134.05263157894737,19,478.0,0
0,1,4,738,-1393,2131,-211,-100,-111,292.1666666666667,72,-1393.0,0
0,1,0,691,-761,1452,-223,-264,41,406.3611111111111,36,692.0,1
0,1,0,1643,1222,421,-200,-132,-68,175.25,24,1222.0,0
0,1,15,336,-825,1161,-237,-86,-151,244.8913043478261,46,-840.0,0
0,1,0,853,-112,965,-185,-297,112,295.28125,32,770.0,1
0,1,0,9,512,-503,-239,-239,0,382.38461538461536,13,512.0,0
0,1,67,475,603,-128,-274,-136,-138,140.72727272727272,11,599.0,0
0,1,0,640,-567,1207,-176,-252,76,320.8333333333333,48,640.0,1
1,1,77,465,558,-93,-281,-206,-75,87.45454545454545,11,560.0,0
1,1,73,461,600,-139,-199,-180,-19,94.07142857142857,14,608.0,0
0,1,0,1100,857,243,-296,-335,39,227.27272727272728,11,857.0,0
0,1,0,2033,1517,516,-148,-172,24,196.48,25,1517.0,0
0,1,0,705,453,252,-277,-265,-12,260.5,10,700.0,1
0,1,42,226,-303,529,-532,-477,-55,156.53125,32,227.0,1
0,1,1,16,212,-196,-794,-566,-228,169.625,16,14.0,1
0,1,8,901,-1066,1967,-189,-184,-5,357.2,55,-1067.0,0
1,1,5,259,-177,436,-551,-518,-33,182.41666666666666,24,259.0,1
0,1,5,894,-2147,3041,-171,-133,-38,418.3170731707317,82,895.0,1
0,1,30,872,-648,1520,-222,-192,-30,338.6666666666667,45,-646.0,0
0,1,18,906,-1119,2025,-197,-172,-25,379.188679245283,53,906.0,1
0,1,4,705,308,397,-170,-291,121,249.48979591836735,49,706.0,1
0,1,0,1495,461,1034,-146,-291,145,533.85,20,1492.0,1
0,1,11,756,356,400,-211,-269,58,263.14,50,754.0,1
0,1,0,774,647,127,-157,-897,740,456.17391304347825,46,-222.0,1
0,1,47,193,243,-50,-552,-455,-97,108.14285714285714,7,242.0,0
1,1,27,4,6,-2,-671,-746,75,154.10526315789474,19,5.0,0
0,1,0,665,541,124,-214,-259,45,180.85714285714286,7,660.0,1
0,1,53,3,-203,206,-754,-531,-223,182.625,16,0.0,1
0,1,0,282,-289,571,-498,-470,-28,290.35,20,-289.0,0
0,1,3,824,385,439,-190,-222,32,207.08695652173913,23,833.0,1
0,1,10,798,-905,1703,-196,-145,-51,338.25,52,-905.0,0
0,1,0,593,-899,1492,-267,-189,-78,394.86842105263156,38,594.0,1
0,1,11,258,-225,483,-539,-514,-25,197.16,25,259.0,1
0,1,1,240,-316,556,-527,-537,10,226.48,25,244.0,1
0,1,18,260,566,-306,-495,-188,-307,200.05,20,264.0,1
0,1,0,8,114,-106,-477,-475,-2,112.25,8,29.0,0
0,1,0,469,99,370,-268,-285,17,314.8333333333333,12,462.0,1
0,1,0,983,-584,1567,-210,-289,79,564.6071428571429,28,986.0,1
0,1,0,252,-268,520,-523,-414,-109,201.89285714285714,28,255.0,1
0,1,16,174,-315,489,-545,-431,-114,247.4,20,-312.0,0
0,1,32,169,229,-60,-556,-471,-85,89.61904761904762,21,122.0,1
0,1,66,213,451,-238,-381,-68,-313,279.25,12,463.0,0
0,1,0,482,-36,518,-216,-251,35,317.7647058823529,17,483.0,1
0,1,0,556,-1160,1716,-257,-338,81,428.125,40,557.0,1
0,1,0,1513,-411,1924,-193,-356,163,561.3235294117648,34,1501.0,1
0,1,40,217,-836,1053,-542,-182,-360,289.94736842105266,38,-839.0,0
0,1,0,528,-607,1135,-270,-254,-16,327.7647058823529,34,525.0,1
0,1,9,928,-1487,2415,-257,-214,-43,387.327868852459,61,931.0,1
0,1,0,1162,-314,1476,-182,-264,82,523.6071428571429,28,1155.0,1
1,1,30,219,265,-46,-406,-498,92,110.27586206896552,29,146.0,1
1,1,41,629,493,136,-81,-116,35,73.42857142857143,14,494.0,0
0,1,7,742,-886,1628,-225,-156,-69,283.49122807017545,57,-886.0,0
0,1,3,678,-1247,1925,-239,-193,-46,374.7647058823529,51,678.0,1
0,1,0,499,-1381,1880,-236,-309,73,413.44444444444446,45,500.0,1
0,1,0,2101,1245,856,-173,20,-193,227.9142857142857,35,2080.0,1
0,1,0,2128,2055,73,-190,-178,-12,134.33333333333334,6,2055.0,0
0,1,0,978,625,353,-173,-312,139,298.15384615384613,13,978.0,1
0,1,7,1654,1177,477,-294,-240,-54,177.88888888888889,27,1656.0,1
0,1,0,1924,1115,809,-252,-154,-98,155.56603773584905,53,1115.0,0
0,1,23,116,289,-173,-473,-534,61,74.55555555555556,18,115.0,1
0,1,11,1685,933,752,-229,-75,-154,159.04166666666666,48,1685.0,1
0,1,1,1794,1975,-181,-112,-14,-98,116.13333333333334,15,1819.0,1
0,1,0,505,64,441,-244,-459,215,228.07142857142858,42,505.0,1
0,1,0,776,528,248,-223,-235,12,252.2,10,777.0,1
0,1,0,257,-161,418,-526,-627,101,400.09090909090907,11,256.0,1
0,1,0,958,651,307,-193,-233,40,298.3636363636364,11,958.0,1
0,1,71,186,636,-450,-523,-150,-373,235.20833333333334,24,187.0,1
0,1,0,1030,-1063,2093,-186,-279,93,499.5121951219512,41,1031.0,1
0,1,0,603,-868,1471,-237,-208,-29,374.87179487179486,39,604.0,1
0,1,15,214,227,-13,-482,-505,23,154.46153846153845,26,216.0,0
0,1,0,384,-1017,1401,-356,-256,-100,338.8780487804878,41,372.0,1
0,1,0,547,-1179,1726,-236,-211,-25,383.73333333333335,45,549.0,1
0,1,0,148,-199,347,-567,-444,-123,151.875,24,-212.0,0
0,1,0,1625,1063,562,-207,-266,59,285.95,20,1063.0,0
0,1,0,952,-734,1686,-246,-340,94,467.52777777777777,36,953.0,1
0,1,0,256,-721,977,-428,-213,-215,271.5,36,258.0,1
0,1,33,68,-1790,1858,-361,-143,-218,318.70175438596493,57,-1780.0,0
0,1,19,391,-753,1144,-210,-56,-154,309.75,36,-725.0,0
1,1,35,4,-536,540,-448,-64,-384,157.82051282051282,39,5.0,1
1,1,46,518,-483,1001,-204,-119,-85,242.78048780487805,41,-487.0,0
0,1,0,458,397,61,-215,-219,4,113.14285714285714,7,479.0,0
0,1,0,1047,-319,1366,-242,-327,85,548.72,25,1050.0,1
0,1,0,8,-194,202,-788,-414,-374,156.57894736842104,19,-3.0,1
0,1,8,169,253,-84,-592,-512,-80,159.5,36,-6.0,1
0,1,0,460,-417,877,-248,-321,73,293.4054054054054,37,461.0,1
0,1,44,1354,205,1149,-291,-390,99,336.8529411764706,34,217.0,0
0,1,0,250,-201,451,-582,-322,-260,356.8,15,251.0,1
0,1,30,382,-508,890,-231,-232,1,254.88888888888889,36,-527.0,0
0,1,0,241,75,166,-568,-611,43,247.28571428571428,7,242.0,1
0,1,0,539,-341,880,-141,-268,127,485.0,19,536.0,1
0,1,27,445,-741,1186,-240,-79,-161,283.7142857142857,42,448.0,1
0,1,12,505,-420,925,-228,-160,-68,241.92105263157896,38,505.0,1
0,1,0,605,145,460,-190,-469,279,193.62962962962962,27,154.0,0
0,1,26,695,-976,1671,-162,-164,2,341.8775510204082,49,696.0,1
0,1,0,581,427,154,-184,-206,22,200.5,8,580.0,1
0,1,0,1105,-947,2052,-243,-225,-18,419.9387755102041,49,1103.0,1
0,1,0,628,-845,1473,-218,-220,2,418.85714285714283,35,630.0,1
0,1,2,459,476,-17,-161,-110,-51,55.8235294117647,34,507.0,0
0,1,0,1178,547,631,-232,-526,294,403.7647058823529,17,1178.0,1
0,1,11,209,-948,1157,-517,2,-519,300.6666666666667,42,210.0,1
1,1,0,711,-560,1271,-199,-209,10,345.6842105263158,38,714.0,1
1,1,0,441,475,-34,-148,-102,-46,56.55555555555556,36,439.0,0
0,1,72,8,-217,225,-786,-468,-318,96.3103448275862,29,11.0,1
0,1,0,811,-754,1565,-292,-213,-79,290.9074074074074,54,813.0,1
0,1,76,184,-249,433,-508,-510,2,141.76666666666668,30,-254.0,0
0,1,0,756,-831,1587,-227,-144,-83,366.97727272727275,44,758.0,1
0,1,0,934,511,423,-217,-275,58,261.29411764705884,17,934.0,1
0,1,2,595,583,12,-196,-186,-10,39.27272727272727,11,576.0,0
0,1,0,477,471,6,-97,-102,5,52.888888888888886,9,484.0,0
0,1,0,1116,553,563,-210,-133,-77,390.2857142857143,14,553.0,0
0,1,87,697,-1071,1768,-336,-173,-163,288.27868852459017,61,-1076.0,0
0,1,0,481,495,-14,-112,-27,-85,69.0,5,482.0,0
0,1,0,2062,1525,537,-217,-138,-79,265.1904761904762,21,1525.0,0
0,1,0,1228,414,814,-246,-129,-117,197.4390243902439,41,428.0,0
0,1,0,581,358,223,-230,-212,-18,194.54545454545453,11,579.0,1
0,1,0,190,1235,-1045,-404,-44,-360,362.53333333333336,30,189.0,1
0,1,72,731,763,-32,-200,27,-227,74.8,5,777.0,0
0,1,3,680,-2025,2705,-179,-134,-45,419.28125,64,-2025.0,0
0,1,0,195,409,-214,-485,-529,44,282.25,8,195.0,1
0,1,0,2008,1591,417,-271,-240,-31,261.75,16,2000.0,1
0,1,68,180,-19,199,-590,-700,110,99.22727272727273,22,-22.0,0
0,1,0,985,-191,1176,-225,-274,49,476.08,25,985.0,1
0,1,44,316,666,-350,-498,-188,-310,211.52380952380952,21,313.0,1
0,1,0,261,1081,-820,-487,-276,-211,353.44,25,260.0,1
0,1,0,987,-1027,2014,-276,-225,-51,504.75,40,989.0,1
0,1,0,516,-800,1316,-270,-213,-57,375.22857142857146,35,511.0,1
0,1,0,791,284,507,-257,-694,437,351.7,20,284.0,0
0,1,33,1184,1175,9,-163,-184,21,30.5,2,1185.0,0
0,1,0,1728,1503,225,-243,-251,8,174.53846153846155,13,1729.0,1
0,1,3,447,823,-376,-128,-108,-20,103.47222222222223,36,446.0,1
0,1,7,804,-961,1765,-246,-143,-103,336.2692307692308,52,806.0,1
0,1,56,537,-2036,2573,-300,-235,-65,455.5892857142857,56,-2045.0,0
0,1,8,947,-1109,2056,-239,-249,10,454.22222222222223,45,949.0,1
0,1,0,825,-517,1342,-187,-339,152,372.80555555555554,36,825.0,1
0,1,0,1745,1226,519,-226,-195,-31,258.57142857142856,21,1761.0,1
0,1,24,797,-894,1691,-195,-133,-62,338.04,50,788.0,1
0,1,30,1245,509,736,-228,-143,-85,247.2,30,499.0,0
0,1,28,534,-897,1431,-273,-224,-49,303.95652173913044,46,-891.0,0
0,1,45,261,2023,-1762,-515,-127,-388,375.5744680851064,47,2022.0,0
0,1,3,223,256,-33,-475,-459,-16,58.666666666666664,6,226.0,0
0,1,0,997,600,397,-203,-348,145,310.2857142857143,14,600.0,0
0,1,0,1171,854,317,-163,-141,-22,185.2941176470588,17,854.0,0
0,1,27,833,-634,1467,-248,-228,-20,305.875,48,832.0,1
0,1,0,463,411,52,-82,-75,-7,92.0,4,464.0,0
0,1,0,14,198,-184,-486,-478,-8,177.0,10,20.0,1
0,1,0,879,156,723,-209,-621,412,357.25,24,881.0,1
0,1,10,267,264,3,-525,-517,-8,14.5,2,264.0,0
0,1,23,276,-196,472,-539,-481,-58,166.42857142857142,28,270.0,1
1,1,29,1504,1045,459,-47,-49,2,172.9655172413793,29,1505.0,1
1,1,26,1973,477,1496,-164,-205,41,300.1,50,480.0,0
0,1,30,1462,219,1243,-103,-383,280,270.63829787234044,47,1414.0,1
0,1,34,600,230,370,-177,-417,240,132.37142857142857,35,579.0,1
0,1,0,1182,928,254,-209,-185,-24,150.9,20,1184.0,1
0,1,0,744,-204,948,-204,-255,51,409.60869565217394,23,745.0,1
0,1,0,1985,1542,443,-242,-347,105,258.1666666666667,18,1542.0,0
0,1,22,187,-200,387,-456,-392,-64,123.09375,32,-211.0,0
1,1,0,1554,1067,487,-178,-94,-84,259.2631578947368,19,1554.0,1
1,1,10,235,-209,444,-468,-490,22,159.93103448275863,29,-211.0,0
0,1,0,227,-287,514,-474,-467,-7,194.96153846153845,26,222.0,1
0,1,28,465,-194,659,-134,-411,277,259.4642857142857,28,-199.0,0
0,1,33,240,-198,438,-548,-495,-53,109.32432432432432,37,240.0,1
1,1,22,702,715,-13,-134,-78,-56,181.89795918367346,49,702.0,0
1,1,39,1055,936,119,-170,-102,-68,105.23076923076923,13,1050.0,1
1,1,44,1405,1420,-15,-82,-27,-55,69.38461538461539,26,1398.0,0
1,1,45,234,-209,443,-544,-449,-95,121.02380952380952,42,234.0,1
0,1,2,878,26,852,-172,-675,503,185.44827586206895,58,880.0,1
0,1,51,193,229,-36,-544,-520,-24,145.6,35,195.0,0
1,1,32,1666,1707,-41,-128,-121,-7,145.19565217391303,46,1662.0,0
0,1,0,481,499,-18,-69,-65,-4,67.33333333333333,6,450.0,0
0,1,0,2136,220,1916,-160,-421,261,282.8137254901961,102,2139.0,1
0,1,0,259,-244,503,-528,-539,11,210.20833333333334,24,263.0,1
1,1,0,572,-509,1081,-199,-131,-68,260.04545454545456,44,-548.0,0
0,1,0,443,-421,864,-141,-86,-55,237.60526315789474,38,444.0,1
1,1,51,216,-9,225,-498,-818,320,199.55555555555554,18,217.0,1
1,1,19,1876,615,1261,-191,-155,-36,294.3636363636364,44,596.0,0
0,1,18,215,-25,240,-496,-864,368,213.05555555555554,18,217.0,1
0,1,12,245,-179,424,-547,-425,-122,181.63513513513513,74,-48.0,1
0,1,0,68,256,-188,-508,-242,-266,205.76923076923077,39,533.0,1
1,1,17,632,-1093,1725,-199,211,-410,341.86,50,-1093.0,0
1,1,48,34,212,-178,-656,-111,-545,113.65,20,224.0,0
0,1,0,1115,-54,1169,-261,-311,50,496.3333333333333,24,1116.0,1
0,1,27,755,-820,1575,-230,-161,-69,357.52272727272725,44,757.0,1
0,1,36,262,-253,515,-475,-496,21,204.68,25,-255.0,0
0,1,54,55,21,34,-723,-765,42,141.2,5,54.0,0
0,1,0,924,-463,1387,-226,-84,-142,514.8214285714286,28,924.0,1
0,1,0,1041,465,576,-180,-265,85,290.6896551724138,58,-91.0,1
0,1,29,299,-269,568,-425,-420,-5,156.59459459459458,37,-268.0,0
0,1,0,880,232,648,-155,-268,113,427.125,16,232.0,0
0,1,6,257,1715,-1458,-513,-230,-283,343.74418604651163,43,1716.0,0
0,1,25,356,803,-447,-240,-170,-70,230.78947368421052,19,809.0,0
0,1,0,849,503,346,-193,-204,11,317.45454545454544,11,852.0,1
0,1,19,140,-255,395,-514,-489,-25,216.27777777777777,18,-254.0,0
0,1,76,255,29,226,-545,-695,150,160.8095238095238,21,256.0,1
0,1,28,60,-200,260,-560,-464,-96,153.22222222222223,18,-223.0,0
0,1,28,1040,-534,1574,-238,-140,-98,338.48936170212767,47,-552.0,0
1,1,0,872,658,214,-126,-103,-23,73.5625,32,653.0,0
1,1,40,173,23,150,-679,-757,78,114.25,16,16.0,0
1,1,27,1165,535,630,-251,-213,-38,254.30769230769232,26,514.0,0
1,1,19,1792,1164,628,-86,-76,-10,138.71428571428572,42,1280.0,1
1,1,108,10,-1983,1993,-780,-158,-622,417.5,50,11.0,1
1,1,112,564,1614,-1050,-169,-196,27,228.6304347826087,46,566.0,1
1,1,110,734,611,123,-183,-98,-85,84.11111111111111,18,734.0,1
1,1,127,416,966,-550,-86,-210,124,166.78125,32,415.0,1
0,1,0,244,-237,481,-519,-519,0,192.04,25,-237.0,0
0,1,31,622,437,185,-109,-93,-16,73.68181818181819,22,622.0,1
0,1,0,904,-575,1479,-271,-212,-59,464.65625,32,903.0,1
0,1,0,626,-584,1210,-188,-242,54,332.4736842105263,38,713.0,1
0,1,0,471,-572,1043,-240,-251,11,302.0857142857143,35,-572.0,0
0,1,0,1399,1229,170,-218,-261,43,179.7,10,1400.0,1
0,1,0,460,35,425,-266,-285,19,297.3333333333333,15,460.0,1
0,1,24,73,542,-469,-359,-88,-271,255.52380952380952,21,551.0,0
0,1,38,826,1370,-544,-104,-34,-70,184.09803921568627,51,833.0,1
1,1,36,22,11,11,-733,-687,-46,105.82352941176471,17,11.0,0
1,1,61,967,1111,-144,-226,-202,-24,102.62962962962963,27,964.0,1
1,1,2,566,585,-19,-186,-140,-46,89.22222222222223,90,591.0,0
0,1,0,410,396,14,-226,-210,-16,63.30769230769231,13,385.0,0
0,1,21,14,1023,-1009,-748,-282,-466,261.8636363636364,44,13.0,1
0,1,0,1149,-236,1385,-196,-389,193,471.6774193548387,31,1170.0,1
0,1,0,818,-391,1209,-248,-230,-18,352.0,56,821.0,1
0,1,0,858,410,448,-161,-296,135,438.0,11,859.0,1
0,1,17,318,172,146,-413,-472,59,201.87272727272727,55,779.0,1
0,1,81,1048,151,897,-224,-443,219,211.3111111111111,45,1043.0,1
0,1,1,99,226,-127,-499,-301,-198,92.46666666666667,15,97.0,1
0,1,0,1358,660,698,-163,-327,164,390.4736842105263,19,1352.0,1
1,1,18,711,-725,1436,-158,-114,-44,269.962962962963,54,715.0,1
1,1,0,254,-246,500,-517,-503,-14,195.72,25,243.0,1
0,1,20,586,-962,1548,-217,-112,-105,292.0740740740741,54,-982.0,0
0,1,0,1301,-538,1839,-175,-257,82,405.17021276595744,47,1305.0,1
0,1,62,45,-6,51,-700,-698,-2,57.333333333333336,12,39.0,0
0,1,0,1042,657,385,-146,-283,137,333.6666666666667,12,1037.0,1
0,1,18,548,-630,1178,-243,-162,-81,259.3333333333333,45,515.0,1
0,1,0,185,-548,733,-586,-589,3,450.94117647058823,17,182.0,1
0,1,0,696,-1166,1862,-186,-135,-51,377.6938775510204,49,-1166.0,0
0,1,0,712,-1159,1871,-210,-172,-38,425.40909090909093,44,710.0,1
0,1,0,580,-254,834,-200,-285,85,275.7096774193548,31,-254.0,0
0,1,0,910,784,126,-180,-197,17,110.3076923076923,13,911.0,1
0,1,67,1345,1235,110,-136,-167,31,69.53333333333333,15,1231.0,0
0,1,1,1118,-395,1513,-245,-61,-184,317.9387755102041,49,1118.0,1
0,1,0,728,-118,846,-215,-180,-35,337.95652173913044,46,729.0,1
0,1,0,116,191,-75,-554,-464,-90,80.75,12,217.0,0
0,1,28,222,1256,-1034,-509,-145,-364,250.2093023255814,43,223.0,1
0,1,17,90,-128,218,-564,-442,-122,107.78571428571429,28,-182.0,0
0,1,5,1403,937,466,-194,-213,19,172.07407407407408,27,1390.0,1
0,1,0,428,-495,923,-220,-179,-41,211.47916666666666,48,425.0,1
0,1,0,200,116,84,-580,-458,-122,154.71428571428572,7,189.0,0
0,1,6,828,-1118,1946,-238,-161,-77,380.9019607843137,51,-1118.0,0
0,1,5,544,-1247,1791,-213,-143,-70,408.48837209302326,43,-1247.0,0
0,1,0,1328,782,546,-198,-159,-39,177.1290322580645,31,1326.0,1
0,1,38,249,-151,400,-499,-375,-124,118.02777777777777,36,216.0,1
0,1,0,814,-628,1442,-189,-217,28,418.8285714285714,35,815.0,1
0,1,0,681,-620,1301,-200,-137,-63,306.20454545454544,44,683.0,1
0,1,37,264,1123,-859,-308,-136,-172,316.3703703703704,27,1123.0,0
0,1,0,818,503,315,-163,-153,-10,275.3636363636364,11,503.0,0
0,1,0,869,-384,1253,-239,-208,-31,307.17391304347825,46,-474.0,0
0,1,0,420,412,8,-144,-57,-87,63.65,20,438.0,0
0,1,17,479,1283,-804,-269,-112,-157,301.6923076923077,26,1283.0,0
0,1,0,945,241,704,-251,-632,381,407.65,20,936.0,1
0,1,68,1245,-15,1260,-101,-670,569,350.05,40,-28.0,0
0,1,41,1251,11,1240,-46,-665,619,319.6363636363636,44,-12.0,0
0,1,0,822,329,493,-292,-683,391,377.47058823529414,17,824.0,1
0,1,0,19,-830,849,-366,-254,-112,600.3571428571429,14,-830.0,0
0,1,0,248,268,-20,-526,-492,-34,65.5,2,271.0,0
0,1,0,1045,653,392,-242,-307,65,306.84615384615387,13,1031.0,1
0,1,15,12,-170,182,-763,-533,-230,122.28571428571429,56,13.0,1
0,1,14,700,-1350,2050,-158,-139,-19,341.8833333333333,60,702.0,1
0,1,0,781,658,123,-317,-326,9,198.0,7,781.0,1
0,1,60,278,649,-371,-456,-225,-231,174.43478260869566,23,276.0,1
0,1,10,702,-974,1676,-218,-160,-58,397.3953488372093,43,703.0,1
0,1,0,758,-484,1242,-256,-325,69,464.74074074074076,27,760.0,1
0,1,16,541,-196,737,-270,-476,206,224.21428571428572,42,608.0,1
0,1,0,563,-566,1129,-216,-153,-63,278.1707317073171,41,564.0,1
0,1,59,843,-1360,2203,-198,-156,-42,403.48148148148147,54,-1356.0,0
1,1,1,228,284,-56,-513,-549,36,60.86666666666667,15,221.0,0
0,1,0,1243,349,894,-232,-401,169,465.35,20,349.0,0
1,1,12,1226,645,581,-211,-132,-79,159.1818181818182,44,1227.0,1
0,1,0,1145,-248,1393,-227,-346,119,528.5185185185185,27,1145.0,1
0,1,21,112,204,-92,-410,-571,161,128.16666666666666,18,92.0,1
0,1,0,318,349,-31,-500,-435,-65,79.0,2,317.0,0
0,1,58,212,-271,483,-517,-447,-70,165.5,30,215.0,1
1,1,0,1249,896,353,-197,-292,95,316.5,12,1251.0,1
1,1,3,235,216,19,-508,-572,64,59.4,10,192.0,0
0,1,0,1303,-896,2199,-157,-229,72,447.55102040816325,49,1305.0,1
0,1,2,131,184,-53,-357,-494,137,91.25,32,95.0,0
0,1,0,17,22,-5,-784,-772,-12,65.875,8,39.0,0
0,1,2,257,269,-12,-463,-508,45,59.0,2,258.0,0
0,1,18,1003,-1108,2111,-188,-155,-33,401.8867924528302,53,-1106.0,0
0,1,0,238,-194,432,-550,-421,-129,309.42857142857144,14,237.0,1
0,1,22,201,277,-76,-480,-418,-62,108.78571428571429,28,202.0,0
0,1,0,527,-11,538,-110,-558,448,192.07692307692307,39,527.0,1
0,1,13,2020,921,1099,-188,-223,35,277.725,40,2010.0,1
0,1,56,437,-601,1038,-235,-194,-41,312.7352941176471,34,-615.0,0
0,1,29,173,-822,995,-552,-164,-388,249.47727272727272,44,-824.0,0
0,1,0,187,209,-22,-509,-496,-13,54.44444444444444,9,190.0,0
0,1,0,459,278,181,-241,-271,30,289.741935483871,31,461.0,1
1,1,7,320,2078,-1758,-548,-214,-334,393.73333333333335,45,320.0,1
1,1,11,271,1554,-1283,-523,-156,-367,365.1842105263158,38,270.0,1
0,1,40,251,240,11,-506,-398,-108,128.0810810810811,37,65.0,1
0,1,8,847,-935,1782,-176,-39,-137,324.75925925925924,54,842.0,1
0,1,55,491,-1266,1757,-298,-59,-239,359.8333333333333,48,-1258.0,0
0,1,0,271,-249,520,-479,-445,-34,238.2173913043478,23,272.0,1
0,1,0,649,-20,669,-187,-270,83,312.7083333333333,24,670.0,1
0,1,16,180,765,-585,-521,-205,-316,232.58620689655172,29,180.0,1
0,1,3,565,-709,1274,-249,-205,-44,271.6170212765957,47,-709.0,0
0,1,0,303,-145,448,-546,-708,162,408.8333333333333,12,302.0,1
0,1,11,510,-175,685,-268,-350,82,253.74074074074073,27,509.0,1
0,1,0,725,-746,1471,-236,-249,13,324.2888888888889,45,727.0,1
0,1,18,156,1838,-1682,-485,-128,-357,372.8510638297872,47,157.0,1
0,1,22,1145,-179,1324,-206,-543,337,340.075,40,1142.0,1
0,1,0,857,497,360,-194,-236,42,346.3636363636364,11,859.0,1
0,1,33,553,-540,1093,-233,-187,-46,264.1219512195122,41,556.0,1
0,1,14,202,1776,-1574,-552,-239,-313,371.68888888888887,45,202.0,1
0,1,9,227,569,-342,-496,-147,-349,184.17391304347825,23,580.0,0
0,1,0,965,393,572,-184,-225,41,390.0,15,966.0,1
0,1,1,505,586,-81,-196,-65,-131,226.51162790697674,43,505.0,0
0,1,0,152,215,-63,-505,-291,-214,71.8,5,215.0,0
0,1,0,1259,803,456,-265,-175,-90,260.1666666666667,18,1257.0,1
0,1,0,222,0,222,-510,-621,111,153.6875,16,223.0,1
0,1,0,892,375,517,-178,-187,9,371.73333333333335,15,893.0,1
0,1,0,861,766,95,-216,-264,48,379.94,50,860.0,0
0,1,0,500,456,44,-255,-255,0,184.0857142857143,35,499.0,0
0,1,50,902,-1253,2155,-188,-145,-43,390.6666666666667,54,904.0,1
0,1,18,855,-1127,1982,-225,-138,-87,348.9107142857143,56,856.0,1
0,1,1,474,-671,1145,-155,-90,-65,301.64864864864865,37,-671.0,0
0,1,9,521,544,-23,-195,-132,-63,203.93023255813952,43,101.0,1
0,1,0,1073,427,646,-273,-345,72,439.5,14,1048.0,1
0,1,4,223,-440,663,-558,-160,-398,247.33333333333334,30,224.0,1
0,1,0,1029,-403,1432,-206,-77,-129,299.2352941176471,51,1031.0,1
0,1,9,1168,527,641,-240,-179,-61,212.26666666666668,30,1167.0,1
0,1,0,1926,1286,640,-252,-93,-159,210.90322580645162,31,1286.0,0
0,1,0,985,476,509,-251,-327,76,353.73333333333335,15,986.0,1
0,1,0,443,258,185,-122,-285,163,240.11764705882354,34,436.0,1
0,1,5,250,-362,612,-488,-341,-147,206.25806451612902,31,251.0,1
0,1,8,1405,566,839,-211,-183,-28,275.06666666666666,30,1406.0,1
0,1,13,488,-516,1004,-229,-201,-28,270.43243243243245,37,-516.0,0
0,1,0,1037,628,409,-214,-216,2,373.0,11,1036.0,1
0,1,19,186,-174,360,-524,-447,-77,132.06896551724137,29,-183.0,0
0,1,3,597,-1390,1987,-177,-133,-44,415.875,48,-1390.0,0
0,1,0,727,-1247,1974,-249,-259,10,461.74418604651163,43,727.0,1
0,1,0,807,-1089,1896,-224,-284,60,386.8541666666667,48,808.0,1
0,1,0,1026,-119,1145,-250,-266,16,507.17391304347825,23,-119.0,0
0,1,0,448,273,175,-269,-299,30,196.75,8,421.0,1
0,1,0,548,-476,1024,-248,-166,-82,276.9166666666667,36,551.0,1
0,1,0,732,-448,1180,-177,-249,72,398.82758620689657,29,728.0,1
0,1,4,420,-496,916,-267,-178,-89,253.88888888888889,36,-496.0,0
0,1,0,831,410,421,-232,-303,71,369.8333333333333,12,832.0,1
0,1,0,933,-233,1166,-304,-361,57,525.1304347826087,23,936.0,1
0,1,0,230,-547,777,-649,-642,-7,462.47058823529414,17,230.0,1
0,1,2,234,452,-218,-355,-275,-80,150.42857142857142,14,452.0,0
0,1,0,2009,1177,832,-215,-154,-61,273.35483870967744,31,2004.0,1
0,1,0,871,634,237,-198,-235,37,241.4,10,866.0,1
0,1,7,458,-799,1257,-166,-126,-40,290.84090909090907,44,459.0,1
0,1,12,984,-975,1959,-218,-192,-26,414.6808510638298,47,-975.0,0
0,1,0,230,-181,411,-480,-463,-17,318.2307692307692,13,219.0,1
0,1,0,839,498,341,-182,-274,92,219.1764705882353,17,841.0,1
0,1,0,1272,519,753,-203,-60,-143,266.7586206896552,29,507.0,0
0,1,0,543,-401,944,-108,-183,75,270.3529411764706,34,546.0,1
0,1,0,1392,726,666,-220,-238,18,386.3529411764706,17,1392.0,1
0,1,36,161,191,-30,-504,-462,-42,59.0,1,172.0,0
0,1,0,948,-485,1433,-222,-235,13,494.37931034482756,29,946.0,1
0,1,93,10,736,-726,-275,-209,-66,335.0,21,743.0,0
0,1,49,446,1788,-1342,-323,-191,-132,348.55263157894734,38,1793.0,0
0,1,0,964,516,448,-235,-221,-14,379.75,12,964.0,1
0,1,75,152,-871,1023,-227,-144,-83,319.16129032258067,31,-864.0,0
1,1,21,907,1345,-438,-88,-74,-14,141.83870967741936,31,905.0,1
1,1,39,909,300,609,-394,-508,114,219.74193548387098,31,254.0,0
0,1,10,607,-1232,1839,-246,-86,-160,370.7551020408163,49,-1232.0,0
0,1,4,449,-488,937,-245,-201,-44,272.4,35,447.0,1
0,1,0,1887,1515,372,-240,-189,-51,199.21052631578948,19,1515.0,0
0,1,16,690,-1449,2139,-239,-184,-55,379.05357142857144,56,-1448.0,0
0,1,23,1544,260,1284,-317,-508,191,252.94117647058823,51,259.0,0
0,1,50,524,-1464,1988,-258,-112,-146,414.0833333333333,48,-1483.0,0
0,1,0,1457,952,505,79,-168,247,123.46341463414635,41,952.0,0
0,1,0,1150,-452,1602,-125,-150,25,382.07142857142856,42,1153.0,1
0,1,63,2222,2219,3,-148,-101,-47,33.5,2,2241.0,0
0,1,23,414,230,184,-218,-539,321,177.0,18,411.0,1
0,1,19,798,-297,1095,-528,-462,-66,381.7241379310345,29,-315.0,0
0,1,53,396,-537,933,-236,-170,-66,277.45454545454544,33,397.0,1
0,1,0,786,509,277,-247,-244,-3,285.6,10,789.0,1
0,1,0,302,-255,557,-276,-354,78,292.7894736842105,19,-255.0,0
0,1,0,726,564,162,-220,-248,28,187.7,10,727.0,1
0,1,48,395,-458,853,-214,-168,-46,282.26666666666665,30,-462.0,0
1,1,31,1878,1733,145,-108,-127,19,78.2,15,1755.0,0
0,1,28,1853,457,1396,-242,-185,-57,242.48275862068965,58,444.0,0
0,1,35,519,-607,1126,-236,-179,-57,292.95,40,-644.0,0
0,1,10,456,-450,906,-247,-213,-34,255.25714285714287,35,457.0,1
1,1,18,113,-247,360,-556,-423,-133,145.28,25,-250.0,0
1,1,0,1999,1449,550,-163,-122,-41,215.07692307692307,26,2000.0,1
0,1,0,749,571,178,-237,-250,13,214.5,8,748.0,1
0,1,74,1658,1761,-103,-134,-31,-103,123.18181818181819,11,1802.0,0
0,1,32,522,1416,-894,-253,-211,-42,272.57575757575756,33,1419.0,0
0,1,1,192,236,-44,-634,-514,-120,126.85714285714286,7,245.0,0
0,1,7,853,-1304,2157,-246,-83,-163,370.58620689655174,58,851.0,1
0,1,61,574,-970,1544,-224,-57,-167,343.45454545454544,44,-942.0,0
0,1,0,1153,793,360,-235,-301,66,289.9230769230769,13,1132.0,1
0,1,0,1484,971,513,-314,-172,-142,217.75,24,971.0,0
0,1,0,286,-59,345,-541,-593,52,338.3636363636364,11,-59.0,0
0,1,0,954,453,501,-136,-301,165,417.2307692307692,13,955.0,1
0,1,0,604,-460,1064,-208,-198,-10,285.9736842105263,38,603.0,1
0,1,0,836,-152,988,-246,-231,-15,370.61290322580646,31,915.0,1
0,1,0,581,-398,979,-196,-218,22,391.72,25,582.0,1
0,1,0,536,215,321,-175,-244,69,300.72727272727275,11,527.0,1
0,1,0,601,-356,957,-176,-231,55,354.74074074074076,27,594.0,1
0,1,6,250,-214,464,-455,-411,-44,195.56521739130434,23,-214.0,0
0,1,0,906,633,273,-190,-252,62,328.77777777777777,9,909.0,1
0,1,0,992,-351,1343,-171,-262,91,491.57142857142856,28,995.0,1
0,1,0,1026,665,361,-189,-267,78,350.4166666666667,12,1029.0,1
0,1,34,87,-278,365,-576,-486,-90,171.3,20,-267.0,0
0,1,0,722,-11,733,-210,-509,299,468.6666666666667,18,-11.0,0
0,1,47,987,-38,1025,-383,-752,369,376.55172413793105,29,-54.0,0
0,1,0,702,-140,842,-223,-766,543,492.85714285714283,21,695.0,1
0,1,0,973,-366,1339,-210,-612,402,508.5357142857143,28,972.0,1
0,1,0,836,-297,1133,-252,-530,278,282.3414634146341,41,-295.0,0
0,1,0,678,-927,1605,-236,-187,-49,315.88235294117646,51,-927.0,0
0,1,0,486,-1341,1827,-192,-164,-28,362.46,50,-1341.0,0
0,1,0,1466,441,1025,-192,-200,8,350.3448275862069,29,1451.0,1
0,1,0,1526,873,653,-186,-177,-9,267.5833333333333,24,1524.0,1
0,1,0,1838,1407,431,-183,-214,31,213.2,20,1407.0,0
0,1,0,1264,820,444,-205,-219,14,293.53333333333336,15,1243.0,1
0,1,6,623,1121,-498,-326,-248,-78,285.2352941176471,17,1122.0,0
0,1,0,468,-775,1243,-241,-229,-12,435.62068965517244,29,469.0,1
0,1,0,358,-833,1191,-224,-193,-31,504.0416666666667,24,-833.0,0
0,1,0,1146,582,564,-224,-277,53,357.75,16,1134.0,1
0,1,0,868,-562,1430,-196,-252,56,339.25454545454545,55,870.0,1
0,1,6,1706,381,1325,-172,-263,91,290.6222222222222,45,381.0,0
0,1,0,502,-713,1215,-269,-272,3,347.8,35,503.0,1
0,1,0,419,-724,1143,-250,-153,-97,356.9375,32,-724.0,0
0,1,36,340,485,-145,-481,-184,-297,113.85714285714286,21,340.0,1
0,1,0,470,-618,1088,-191,-150,-41,259.7358490566038,53,468.0,1
0,1,9,568,-670,1238,-224,-170,-54,300.1707317073171,41,569.0,1
0,1,7,623,-474,1097,-181,-137,-44,277.425,40,-467.0,0
0,1,0,1233,717,516,-181,-235,54,356.2,15,1232.0,1
0,1,0,1571,1022,549,-169,-137,-32,207.96153846153845,26,1553.0,1
0,1,96,163,265,-102,-558,-463,-95,64.17142857142858,35,278.0,0
0,1,0,776,-51,827,-154,-752,598,416.3061224489796,49,766.0,1
0,1,0,442,189,253,-277,-294,17,286.1111111111111,9,443.0,1
0,1,0,630,448,182,-218,-330,112,265.5,8,633.0,1
0,1,0,681,-187,868,-167,-221,54,438.85,20,-187.0,0
0,1,0,235,-234,469,-579,-580,1,202.3913043478261,23,-234.0,0
0,1,0,442,-442,884,-226,-251,25,246.13888888888889,36,443.0,1
0,1,29,252,-208,460,-530,-479,-51,190.04347826086956,23,-197.0,0
0,1,0,2171,1458,713,-205,-154,-51,222.53125,32,1458.0,0
0,1,0,845,698,147,-212,-241,29,241.16666666666666,6,847.0,1
0,1,0,687,150,537,-214,-280,66,318.34615384615387,52,250.0,1
0,1,0,1072,-403,1475,-162,-270,108,409.44444444444446,36,1074.0,1
0,1,31,479,-434,913,-258,-264,6,258.5,36,-458.0,0
0,1,5,1017,-1069,2086,-181,-114,-67,371.17857142857144,56,-1069.0,0
0,1,2,1033,-1064,2097,-182,-214,32,367.5438596491228,57,1033.0,1
0,1,27,214,-220,434,-525,-511,-14,193.95238095238096,21,214.0,1
0,1,7,649,-524,1173,-269,-177,-92,273.72093023255815,43,-522.0,0
0,1,0,17,-297,314,-742,-738,-4,363.0,9,-297.0,0
0,1,32,233,-207,440,-513,-479,-34,220.1818181818182,22,234.0,1
0,1,0,835,-337,1172,-186,-336,150,545.9090909090909,22,-337.0,0
0,1,29,661,703,-42,-267,-207,-60,115.75,4,699.0,0
0,1,0,1060,778,282,-241,-282,41,292.0,10,1056.0,1
0,1,39,1894,1897,-3,-104,-99,-5,98.40449438202248,89,1897.0,0
1,1,31,441,-543,984,-197,-190,-7,115.17391304347827,92,442.0,1
0,1,0,963,-1162,2125,-175,-291,116,452.93617021276594,47,962.0,1
0,1,23,497,492,5,-225,-192,-33,168.83333333333334,42,123.0,1
1,1,12,616,-780,1396,-252,-197,-55,269.188679245283,53,-789.0,0
0,1,21,260,-588,848,-247,-237,-10,351.375,24,-591.0,0
0,1,12,704,771,-67,-276,-268,-8,204.28571428571428,42,313.0,1
0,1,18,808,1060,-252,-236,-97,-139,174.28571428571428,14,1066.0,0
0,1,24,219,-182,401,-540,-426,-114,178.66666666666666,24,-192.0,0
1,1,13,218,-198,416,-521,-507,-14,145.39285714285714,28,219.0,1
0,1,4,1357,-406,1763,-237,-175,-62,259.4927536231884,69,-406.0,0
0,1,0,835,-347,1182,-236,-178,-58,455.5,26,837.0,1
0,1,72,342,-937,1279,-225,-136,-89,343.81081081081084,37,-935.0,0
0,1,20,346,1389,-1043,-546,-124,-422,312.6666666666667,36,1381.0,0
0,1,6,448,-507,955,-235,-155,-80,282.44117647058823,34,449.0,1
0,1,1,449,-432,881,-184,-240,56,222.43589743589743,39,-440.0,0
0,1,0,1235,918,317,-200,-184,-16,212.6875,16,1244.0,1
0,1,29,388,1946,-1558,-354,-189,-165,421.56756756756755,37,1959.0,0
1,1,72,1982,2006,-24,-175,-64,-111,15.833333333333334,6,1975.0,0
1,1,89,502,1224,-722,-306,-134,-172,307.5652173913044,23,1225.0,0
0,1,0,1046,239,807,-214,-388,174,289.82758620689657,29,1046.0,1
0,1,0,1091,483,608,-161,-300,139,400.8125,16,1091.0,1
0,1,13,426,550,-124,-366,-139,-227,149.75,12,564.0,0
0,1,20,101,916,-815,-266,-119,-147,355.8636363636364,22,898.0,0
0,1,14,178,-235,413,-534,-418,-116,145.3793103448276,29,135.0,1
0,1,0,160,-132,292,-577,-566,-11,281.72727272727275,11,158.0,1
0,1,0,288,296,-8,-526,-480,-46,20.0,2,287.0,0
0,1,0,1219,758,461,-216,-136,-80,169.8148148148148,27,758.0,0
0,1,0,31,-536,567,-270,-193,-77,193.0,28,-516.0,0
0,1,5,276,241,35,-629,-519,-110,45.833333333333336,24,272.0,0
0,1,1,399,197,202,-242,-399,157,128.17142857142858,70,398.0,1
0,1,0,796,-71,867,-265,-261,-4,442.55,20,798.0,1
0,1,0,804,-447,1251,-228,-365,137,509.52,25,805.0,1
0,1,0,480,550,-70,-204,-189,-15,66.92307692307692,13,481.0,0
0,1,0,902,657,245,-171,-315,144,293.9,10,904.0,1
0,1,12,690,-1018,1708,-231,-182,-49,356.3191489361702,47,-1017.0,0
0,1,0,403,-242,645,-289,-414,125,253.68,25,372.0,1
0,1,0,759,-744,1503,-290,-199,-91,423.6857142857143,35,-744.0,0
0,1,1,815,-1060,1875,-170,-170,0,320.58620689655174,58,-1097.0,0
0,1,0,561,545,16,-134,-154,20,28.625,8,564.0,0
0,1,0,751,-367,1118,-262,-305,43,450.52,25,738.0,1
0,1,0,825,-543,1368,-243,-260,17,296.19565217391306,46,-543.0,0
0,1,0,106,249,-143,-538,-392,-146,64.33333333333333,24,207.0,0
0,1,0,754,-448,1202,-230,-157,-73,384.93548387096774,31,744.0,1
0,1,0,648,-1012,1660,-237,-194,-43,357.59574468085106,47,649.0,1
1,1,60,263,-799,1062,-252,-139,-113,316.80645161290323,31,-759.0,0
0,1,0,369,405,-36,-125,-71,-54,66.11764705882354,51,367.0,0
0,1,0,23,738,-715,-654,-207,-447,404.6521739130435,23,22.0,1
0,1,0,767,-518,1285,-234,-271,37,435.06666666666666,30,768.0,1
0,1,0,201,-269,470,-469,-298,-171,435.9166666666667,12,-269.0,0
0,1,29,1421,-8,1429,-256,-775,519,314.32,50,1423.0,1
0,1,29,204,2273,-2069,-548,-252,-296,383.01785714285717,56,2279.0,0
0,1,0,269,-189,458,-585,-314,-271,335.4117647058824,17,-189.0,0
0,1,43,8,-199,207,-764,-511,-253,103.16666666666667,24,6.0,1
0,1,37,1517,1719,-202,-95,0,-95,158.5808,625,1514.0,1
0,1,41,3307,-249,3556,-650,-457,-193,145.29707112970712,239,3306.0,1
0,1,5,1287,2116,-829,-88,-36,-52,137.0576131687243,243,1285.0,1
0,1,27,997,953,44,-121,-51,-70,171.46969696969697,594,999.0,0
0,1,30,760,950,-190,-161,-74,-87,88.08561643835617,292,761.0,1
0,1,2,1016,391,625,-267,-271,4,232.76923076923077,26,391.0,0
0,1,7,82,983,-901,-301,-221,-80,274.03125,32,968.0,0
0,1,3,1969,1996,-27,-103,-68,-35,50.857142857142854,7,1971.0,0
1,1,26,372,298,74,-565,-467,-98,43.18181818181818,33,408.0,1
0,1,37,437,165,272,-258,-336,78,111.34782608695652,23,435.0,1
1,1,39,456,1180,-724,-491,32,-523,150.61111111111111,54,454.0,1
0,1,0,644,471,173,-320,-296,-24,144.33333333333334,15,643.0,1
0,1,12,11,-203,214,-637,-559,-78,124.0,18,-205.0,0
0,1,23,13,-237,250,-743,-551,-192,123.75,24,13.0,1
0,1,7,186,-276,462,-604,-493,-111,150.13333333333333,30,-282.0,0
0,1,4,246,252,-6,-562,-530,-32,177.17021276595744,47,-155.0,1
0,1,27,1614,234,1380,-208,-563,355,256.8375,80,1615.0,1
1,1,2,313,293,20,-526,-482,-44,39.68421052631579,19,315.0,0
1,1,0,352,-1045,1397,-262,-199,-63,268.6666666666667,51,-1045.0,0
0,1,2,819,-946,1765,-282,-152,-130,365.8775510204082,49,820.0,1
0,1,0,833,809,24,-53,-46,-7,60.75,4,809.0,0
0,1,0,1291,-244,1535,-174,-513,339,243.3582089552239,67,1297.0,1
0,1,0,1561,-517,2078,-268,-203,-65,361.2931034482759,58,1563.0,1
0,1,2,476,-488,964,-215,-143,-72,200.06382978723406,47,-478.0,0
0,1,0,520,-701,1221,-216,-333,117,405.06451612903226,31,521.0,1
0,1,0,1021,435,586,-257,-334,77,263.68,25,1019.0,1
0,1,0,847,-580,1427,-101,-72,-29,455.3225806451613,31,846.0,1
0,1,0,870,548,322,-202,-261,59,343.22222222222223,9,874.0,1
0,1,15,743,-854,1597,-235,-181,-54,310.3380281690141,71,-1131.0,1
0,1,0,1237,651,586,-85,-334,249,363.5882352941176,17,1231.0,1
0,1,0,27,-328,355,-771,-258,-513,354.42857142857144,21,6.0,1
0,1,0,744,412,332,-306,-256,-50,246.92307692307693,13,740.0,1
0,1,0,25,-6,31,-746,-704,-42,42.0,11,24.0,0
0,1,42,200,-1560,1760,-435,-149,-286,374.75,48,-1563.0,0
0,1,0,609,463,146,-253,-270,17,161.85,20,609.0,1
0,1,0,1762,878,884,-214,-181,-33,263.88235294117646,34,878.0,0
0,1,0,123,-289,412,-557,-547,-10,161.52,25,-289.0,0
0,1,0,734,-1031,1765,-245,-116,-129,456.2564102564103,39,735.0,1
0,1,0,315,324,-9,-357,-347,-10,33.25,20,239.0,0
0,1,0,972,-266,1238,-235,-323,88,479.3076923076923,26,972.0,1
0,1,0,932,585,347,-227,-301,74,318.0,12,933.0,1
0,1,66,453,-844,1297,-239,-189,-50,280.0,46,-851.0,0
0,1,4,553,522,31,-92,-14,-78,29.0,5,554.0,0
0,1,0,1775,848,927,-275,-158,-117,315.53333333333336,30,1767.0,1
0,1,1,269,251,18,-492,-375,-117,24.75,4,272.0,0
0,1,0,745,-814,1559,-285,-126,-159,432.27777777777777,36,746.0,1
0,1,3,370,-1022,1392,-281,-201,-80,314.1136363636364,44,-1022.0,0
0,1,0,676,-641,1317,-255,-288,33,337.79487179487177,39,678.0,1
0,1,1,140,-732,872,-259,-143,-116,340.2962962962963,27,-754.0,0
1,1,0,1491,1470,21,-132,-79,-53,53.85,20,1388.0,0
1,1,0,390,-550,940,-315,-215,-100,392.7083333333333,24,-550.0,0
0,1,0,1478,1462,16,-73,80,-153,52.75,16,1478.0,0
0,1,0,432,-471,903,-244,-268,24,462.65,20,426.0,1
0,1,2,627,-562,1189,-206,-180,-26,353.8235294117647,34,-562.0,0
0,1,0,725,-781,1506,-143,-81,-62,339.20454545454544,44,727.0,1
0,1,0,589,-339,928,-199,-163,-36,452.95238095238096,21,573.0,1
0,1,0,596,-859,1455,-217,-230,13,582.36,25,588.0,1
0,1,0,652,49,603,-262,-255,-7,408.8,15,651.0,1
0,1,0,464,-618,1082,-225,-86,-139,298.72972972972974,37,-618.0,0
0,1,0,441,-455,896,-253,-29,-224,239.63888888888889,36,443.0,1
0,1,35,503,-559,1062,-191,-174,-17,271.71794871794873,39,504.0,1
0,1,4,217,-255,472,-583,-456,-127,203.56521739130434,23,218.0,1
0,1,0,457,-1281,1738,-262,-185,-77,343.57142857142856,49,-1281.0,0
0,1,0,192,-224,416,-579,-406,-173,228.52631578947367,19,194.0,1
0,1,1,418,819,-401,-298,-67,-231,135.6,30,408.0,1
0,1,16,241,209,32,-488,-457,-31,115.32142857142857,28,239.0,0
0,1,0,844,74,770,-279,-257,-22,443.1111111111111,18,845.0,1
0,1,0,1478,927,551,-185,-138,-47,260.95238095238096,21,1479.0,1
0,1,0,2015,1309,706,-207,-181,-26,272.36,25,1975.0,1
0,1,0,960,593,367,-287,-305,18,326.4166666666667,12,954.0,1
0,1,24,542,-1162,1704,-334,-77,-257,385.44444444444446,45,545.0,1
0,1,18,69,190,-121,-512,-499,-13,141.1818181818182,44,-193.0,1
1,1,0,776,653,123,-276,-260,-16,363.2093023255814,43,775.0,1
0,1,0,204,6,198,-502,-444,-58,272.25,8,172.0,1
0,1,30,232,213,19,-530,-486,-44,18.0,1,233.0,0
0,1,0,1061,-156,1217,-223,-343,120,535.7391304347826,23,1048.0,1
0,1,19,225,203,22,-477,-407,-70,229.29032258064515,31,225.0,0
0,1,0,891,-391,1282,-224,-306,82,524.68,25,895.0,1
0,1,1,261,-214,475,-563,-443,-120,171.21428571428572,28,258.0,1
0,1,20,264,1448,-1184,-282,-188,-94,376.4516129032258,31,1430.0,0
0,1,43,479,-491,970,-259,-144,-115,293.03125,32,480.0,1
0,1,0,927,545,382,-239,-276,37,362.8181818181818,11,928.0,1
0,1,3,592,-638,1230,-198,-194,-4,319.28205128205127,39,590.0,1
0,1,0,950,-95,1045,-194,-264,70,486.6818181818182,22,953.0,1
0,1,0,1015,128,887,-211,-652,441,413.6,25,1004.0,1
0,1,7,638,-672,1310,-187,-190,3,330.2,40,639.0,1
0,1,10,26,247,-221,-542,-373,-169,189.54545454545453,11,242.0,0
0,1,44,1180,244,936,-367,-421,54,257.7027027027027,37,243.0,0
0,1,0,510,-516,1026,-174,-223,49,455.4782608695652,23,511.0,1
0,1,37,443,-419,862,-122,-191,69,272.8484848484849,33,443.0,1
0,1,0,683,-463,1146,-132,-146,14,286.3,40,679.0,1
0,1,7,856,-613,1469,-181,-206,25,387.2368421052632,38,-616.0,0
0,1,43,254,-718,972,-509,-139,-370,301.37142857142857,35,251.0,1
0,1,1,714,-429,1143,-192,-229,37,265.74418604651163,43,717.0,1
0,1,55,113,-1838,1951,-319,-75,-244,386.8,50,-1839.0,0
1,1,83,445,678,-233,-90,33,-123,88.14285714285714,21,662.0,0
1,1,57,589,1930,-1341,-187,-93,-94,265.96,50,1915.0,0
1,1,68,6,-1412,1418,-769,-64,-705,384.225,40,7.0,1
1,1,63,8,1315,-1307,-498,-2,-496,289.4375,48,6.0,1
0,1,59,622,-176,798,-156,-455,299,273.71875,32,-182.0,0
0,1,22,776,-848,1624,-158,-120,-38,353.7391304347826,46,772.0,1
0,1,33,517,-542,1059,-322,-179,-143,277.64102564102564,39,516.0,1
0,1,33,189,220,-31,-505,-356,-149,56.5,4,221.0,0
0,1,0,844,-430,1274,-184,-130,-54,492.8076923076923,26,-430.0,0
0,1,11,449,1076,-627,-309,-238,-71,302.65,20,1076.0,0
0,1,16,596,200,396,-182,-495,313,235.25,36,586.0,1
0,1,0,829,-197,1026,-151,-396,245,431.4,25,827.0,1
0,1,7,776,-656,1432,-244,-222,-22,366.02564102564105,39,-658.0,0
1,1,59,961,2183,-1222,-231,-222,-9,374.46875,32,2170.0,0
1,1,60,1613,693,920,-197,-79,-118,298.741935483871,31,689.0,0
0,1,8,912,-681,1593,-182,-134,-48,374.7142857142857,42,-680.0,0
0,1,28,1851,569,1282,-197,-120,-77,327.9,40,557.0,0
0,1,69,790,18,772,-175,-771,596,178.1320754716981,53,791.0,1
0,1,0,870,624,246,-145,-149,4,293.25,8,854.0,1
0,1,59,1057,-5,1062,-170,-722,552,215.1818181818182,55,1084.0,1
1,1,13,226,-224,450,-550,-573,23,201.95454545454547,22,245.0,1
0,1,4,1763,717,1046,-170,-176,6,221.12765957446808,47,717.0,0
0,1,8,227,252,-25,-508,-374,-134,82.5,4,252.0,0
0,1,56,837,26,811,-129,-746,617,217.85714285714286,42,840.0,1
0,1,36,1241,25,1216,-203,-745,542,277.32,50,1242.0,1
0,1,0,635,-325,960,-196,-624,428,485.9166666666667,24,636.0,1
0,1,53,1982,1975,7,-124,8,-132,58.85,40,1981.0,0
1,1,32,268,-1,269,-419,-675,256,114.03703703703704,27,-2.0,0
0,1,8,944,-734,1678,-241,-216,-25,341.7142857142857,49,-734.0,0
0,1,29,824,-1182,2006,-250,-72,-178,390.6666666666667,51,825.0,1
0,1,8,217,-239,456,-547,-457,-90,193.54166666666666,24,212.0,1
0,1,35,748,-1143,1891,-267,-120,-147,536.3428571428572,35,-1161.0,0
0,1,35,225,-232,457,-512,-501,-11,149.27586206896552,29,-225.0,0
0,1,37,1886,1362,524,-46,111,-157,119.3,60,1881.0,1
1,1,2,1030,465,565,-171,-21,-150,149.70731707317074,41,1025.0,1
1,1,48,261,-226,487,-516,-373,-143,118.53846153846153,39,262.0,1
0,1,34,1888,1902,-14,-107,3,-110,136.40178571428572,112,1887.0,0
0,1,0,776,-314,1090,-213,-600,387,497.44,25,780.0,1
0,1,45,886,-1123,2009,-234,-182,-52,408.3469387755102,49,-1122.0,0
0,1,10,534,-511,1045,-140,-184,44,256.675,40,535.0,1
0,1,0,900,-617,1517,-225,-207,-18,570.1111111111111,27,902.0,1
0,1,0,797,-611,1408,-135,-671,536,569.7037037037037,27,799.0,1
0,1,0,905,-180,1085,-153,-590,437,499.2916666666667,24,906.0,1
0,1,24,233,-290,523,-468,-456,-12,157.625,32,234.0,1
0,1,0,533,-478,1011,-221,-174,-47,378.9259259259259,27,529.0,1
0,1,0,232,-415,647,-566,-244,-322,243.9655172413793,29,233.0,1
0,1,0,930,-275,1205,-199,-395,196,449.10714285714283,28,929.0,1
0,1,0,980,576,404,-225,-243,18,330.61538461538464,13,994.0,1
0,1,26,256,-446,702,-432,-179,-253,215.15151515151516,33,-443.0,0
0,1,26,607,-943,1550,-314,-208,-106,435.6857142857143,35,-949.0,0
0,1,5,250,-220,470,-543,-499,-44,222.47619047619048,21,251.0,1
0,1,0,801,-595,1396,-201,-323,122,405.74285714285713,35,802.0,1
0,1,43,6,26,-20,-727,-667,-60,112.33333333333333,12,2.0,0
0,1,0,734,757,-23,-213,-45,-168,75.75,4,757.0,0
0,1,0,438,447,-9,-243,-65,-178,81.0,6,447.0,0
0,1,0,15,35,-20,-690,-509,-181,112.0,4,35.0,0
0,1,0,1446,640,806,-238,-178,-60,257.19354838709677,31,1449.0,1
0,1,0,6,-290,296,-293,-156,-137,210.0,17,3.0,1
0,1,1,257,-17,274,-496,-705,209,207.76470588235293,17,255.0,1
1,1,56,402,-400,802,-174,-153,-21,234.8,35,-413.0,0
1,1,55,462,-582,1044,-220,-51,-169,312.1111111111111,36,-599.0,0
0,1,0,366,-1115,1481,-229,-123,-106,293.72,75,721.0,1
0,1,0,831,-905,1736,-173,-122,-51,399.13953488372096,43,-905.0,0
0,1,3,329,-405,734,-227,-254,27,212.97368421052633,38,-424.0,0
0,1,15,1214,614,600,-183,-150,-33,189.03125,32,614.0,0
0,1,0,798,-832,1630,-238,-312,74,383.2325581395349,43,-832.0,0
0,1,0,1484,194,1290,-196,-284,88,314.6666666666667,42,452.0,1
0,1,0,996,100,896,-241,-408,167,360.5833333333333,24,983.0,1
1,1,33,1128,830,298,-162,-79,-83,106.2258064516129,31,1134.0,1
0,1,0,1305,780,525,-116,-390,274,419.35714285714283,14,1302.0,1
0,1,0,1005,-654,1659,-188,-180,-8,443.3157894736842,38,1005.0,1
0,1,0,1237,660,577,-232,-250,18,388.6,15,1237.0,1
0,1,0,2027,1513,514,-122,-4,-118,178.03571428571428,28,2018.0,1
0,1,16,13,-482,495,-262,-178,-84,225.36363636363637,22,-498.0,0
0,1,7,1126,731,395,-128,-133,5,145.85714285714286,28,1126.0,1
0,1,0,848,-603,1451,-207,-286,79,428.79411764705884,34,-603.0,0
0,1,0,1080,733,347,-183,-191,8,276.85714285714283,14,1085.0,1
0,1,0,300,457,-157,-289,-225,-64,135.0,14,488.0,0
1,1,0,803,413,390,-205,-249,44,306.02564102564105,39,800.0,1
0,1,0,884,654,230,-262,-273,11,299.375,8,654.0,0
0,1,13,312,299,13,-538,-528,-10,32.0,1,299.0,0
0,1,8,290,-1903,2193,-279,-185,-94,445.6938775510204,49,-1903.0,0
0,1,0,776,-335,1111,-241,-367,126,464.7916666666667,24,770.0,1
0,1,23,1384,813,571,-242,-191,-51,190.76666666666668,30,808.0,0
0,1,0,1307,198,1109,-186,-234,48,466.97777777777776,45,1308.0,1
0,1,7,1236,729,507,-175,-194,19,170.68965517241378,29,727.0,0
0,1,0,699,-386,1085,-290,-366,76,459.3333333333333,24,701.0,1
0,1,0,552,155,397,-221,-305,84,385.27272727272725,11,155.0,0
0,1,0,216,-221,437,-600,-570,-30,220.9,20,218.0,1
0,1,7,509,-316,825,-281,-492,211,293.89285714285717,28,-316.0,0
1,1,50,231,-6,237,-463,-726,263,144.0,21,231.0,1
1,1,23,1527,489,1038,-151,-228,77,225.72916666666666,48,1528.0,1
1,1,36,1932,480,1452,-154,-140,-14,357.3170731707317,41,1930.0,1
0,1,18,1026,-923,1949,-174,-116,-58,361.462962962963,54,1027.0,1
0,1,35,497,-859,1356,-229,-146,-83,371.52777777777777,36,-845.0,0
0,1,14,5,544,-539,-531,-175,-356,203.2,30,543.0,0
0,1,0,898,-385,1283,-212,-304,92,469.2857142857143,28,899.0,1
0,1,24,996,-1059,2055,-132,-154,22,391.0566037735849,53,998.0,1
0,1,50,64,-15,79,-603,-736,133,156.22222222222223,9,-23.0,0
0,1,12,1259,789,470,-210,-163,-47,172.25925925925927,27,779.0,0
0,1,0,844,274,570,-254,-299,45,380.8,15,845.0,1
0,1,3,129,841,-712,-249,-159,-90,230.5,30,841.0,0
1,1,32,1885,514,1371,-216,-93,-123,277.7551020408163,49,517.0,0
1,1,15,1488,224,1264,-126,-387,261,248.55357142857142,56,184.0,0
1,1,35,897,1195,-298,-104,35,-139,120.3913043478261,23,1183.0,0
0,1,0,1454,929,525,-252,-228,-24,182.17241379310346,29,929.0,0
0,1,0,963,482,481,-193,-267,74,419.94594594594594,37,966.0,1
0,1,0,760,393,367,-193,-268,75,369.3243243243243,37,760.0,1
0,1,0,202,1118,-916,-576,-729,153,390.06,50,-288.0,1
0,1,0,892,-50,942,-229,-269,40,456.7142857142857,21,893.0,1
0,1,33,147,-568,715,-240,-118,-122,260.18518518518516,27,-570.0,0
0,1,9,802,910,-108,-101,-33,-68,91.39583333333333,48,954.0,0
0,1,0,195,256,-61,-493,-412,-81,59.535714285714285,28,117.0,1
0,1,0,706,640,66,-263,-292,29,96.16666666666667,6,705.0,0
0,1,0,844,405,439,-240,-328,88,315.09375,32,853.0,1
0,1,0,1174,536,638,-255,-103,-152,237.96296296296296,27,530.0,0
0,1,5,1131,1141,-10,-211,-120,-91,51.0,3,1141.0,0
0,1,0,702,485,217,-250,-321,71,323.46875,32,702.0,1
0,1,19,334,-225,559,-382,-595,213,327.3888888888889,18,-236.0,0
0,1,0,523,-439,962,-188,-66,-122,286.22857142857146,35,-450.0,0
0,1,0,286,-1336,1622,-623,-683,60,609.6296296296297,27,-1336.0,0
0,1,7,1099,1081,18,-228,-73,-155,312.3170731707317,82,1100.0,0
0,1,3,257,-1976,2233,-527,-203,-324,408.05454545454546,55,257.0,1
0,1,0,741,29,712,-236,-344,108,423.8235294117647,17,742.0,1
0,1,0,980,421,559,-208,-258,50,353.75,16,979.0,1
0,1,44,61,-506,567,-281,-175,-106,235.33333333333334,24,-505.0,0
0,1,18,248,-147,395,-477,-473,-4,117.57575757575758,33,-155.0,0
0,1,0,784,575,209,-160,-296,136,366.3030303030303,33,787.0,1
0,1,12,767,-909,1676,-239,-146,-93,281.9230769230769,78,1025.0,1
0,1,0,222,-173,395,-462,-452,-10,206.94736842105263,19,223.0,1
0,1,6,106,-477,583,-261,-186,-75,261.8636363636364,22,-479.0,0
0,1,24,1201,1202,-1,-311,-266,-45,98.8157894736842,38,1199.0,0
0,1,53,465,-1421,1886,-218,-157,-61,434.1162790697674,43,-1424.0,0
0,1,0,221,-251,472,-508,-465,-43,200.95833333333334,24,214.0,1
0,1,0,1061,-396,1457,-245,-328,83,520.2857142857143,28,1047.0,1
0,1,0,10,-412,422,-268,72,-340,215.92307692307693,26,11.0,1
0,1,0,425,-382,807,-235,-208,-27,240.97058823529412,34,424.0,1
0,1,0,723,-416,1139,-221,-183,-38,255.59574468085106,47,729.0,1
0,1,0,609,341,268,-249,-259,10,232.66666666666666,12,609.0,1
0,1,0,220,-332,552,-571,-466,-105,193.0,28,221.0,1
0,1,0,1417,723,694,-268,-257,-11,263.4230769230769,26,1408.0,1
0,1,0,687,-756,1443,-265,-125,-140,412.37142857142857,35,689.0,1
0,1,0,845,-414,1259,-223,-243,20,510.84,25,846.0,1
0,1,13,1148,-256,1404,-206,-459,253,293.2291666666667,48,1150.0,1
1,1,33,180,0,180,-535,-791,256,138.0,26,181.0,1
0,1,2,2150,1294,856,-138,-121,-17,184.67391304347825,46,1294.0,0
0,1,0,924,-833,1757,-207,-146,-61,336.7169811320755,53,925.0,1
1,1,45,219,504,-285,-465,-210,-255,153.72727272727272,22,518.0,0
1,1,45,1454,809,645,-228,-110,-118,233.46428571428572,28,806.0,0
0,1,0,537,-725,1262,-243,-196,-47,369.1764705882353,34,-725.0,0
0,1,26,626,1466,-840,-333,-254,-79,352.6521739130435,23,1465.0,0
0,1,24,811,1590,-779,-336,-215,-121,306.56,25,1587.0,0
0,1,37,1308,1634,-326,-63,-89,26,121.46428571428571,28,1647.0,0
0,1,18,1289,230,1059,-293,-456,163,294.47222222222223,36,226.0,0
0,1,0,954,2,952,-229,-670,441,437.5,24,951.0,1
0,1,0,1200,424,776,-194,-550,356,435.2,20,424.0,0
0,1,0,1598,997,601,-195,-150,-45,195.74193548387098,31,997.0,0
0,1,46,185,-199,384,-537,-513,-24,175.3181818181818,22,-200.0,0
0,1,0,1121,-529,1650,-208,-330,122,523.1875,32,1098.0,1
0,1,0,820,609,211,-225,-250,25,263.75,8,819.0,1
0,1,10,733,1147,-414,-198,-148,-50,135.43283582089552,67,736.0,1
1,1,55,250,-224,474,-487,-446,-41,145.59375,32,239.0,1
0,1,2,552,-514,1066,-174,-138,-36,309.0,35,565.0,1
0,1,0,580,-500,1080,-193,-124,-69,346.93548387096774,31,-500.0,0
0,1,0,1027,230,797,-334,-438,104,301.11538461538464,26,234.0,0
0,1,37,1616,245,1371,-229,-394,165,353.1463414634146,41,197.0,0
0,1,0,809,-877,1686,-201,-248,47,401.23809523809524,42,807.0,1
0,1,34,434,1142,-708,-287,-160,-127,163.23809523809524,42,1137.0,0
0,1,0,1127,-1026,2153,-208,-116,-92,381.5357142857143,56,1129.0,1
0,1,30,775,-640,1415,-239,-183,-56,329.13953488372096,43,-643.0,0
0,1,0,1397,-722,2119,-194,-244,50,459.3695652173913,46,1399.0,1
0,1,0,990,508,482,-209,-257,48,259.57894736842104,19,993.0,1
0,1,0,472,437,35,-82,-14,-68,85.0,3,467.0,0
0,1,60,438,909,-471,-445,-204,-241,171.56666666666666,30,909.0,0
0,1,0,922,923,-1,-69,80,-149,101.5,2,921.0,0
0,1,62,275,2260,-1985,-457,-141,-316,362.45454545454544,55,2260.0,0
0,1,0,1236,-887,2123,-282,-250,-32,432.734693877551,49,1237.0,1
0,1,0,905,517,388,-190,-301,111,304.92857142857144,14,909.0,1
0,1,23,371,2162,-1791,-374,-160,-214,384.3191489361702,47,2162.0,0
0,1,0,1877,1427,450,-176,-207,31,218.25,20,1427.0,0
0,1,56,102,360,-258,-524,-466,-58,120.95238095238095,21,361.0,0
0,1,63,115,-1000,1115,-315,-139,-176,330.3235294117647,34,-1020.0,0
0,1,0,980,-574,1554,-188,-248,60,446.2307692307692,39,982.0,1
0,1,54,69,1211,-1142,-287,-185,-102,325.4,35,1216.0,0
0,1,0,859,-612,1471,-176,-211,35,420.77142857142854,35,859.0,1
0,1,0,964,-915,1879,-204,-207,3,364.80392156862746,51,965.0,1
0,1,0,824,-859,1683,-214,-268,54,386.69767441860466,43,826.0,1
0,1,16,1487,695,792,-249,-194,-55,210.83783783783784,37,700.0,0
0,1,0,509,581,-72,-180,171,-351,137.4,5,508.0,0
0,1,0,1040,-515,1555,-258,-248,-10,360.93023255813955,43,1041.0,1
0,1,28,244,595,-351,-501,-70,-431,217.45454545454547,22,243.0,1
0,1,0,619,-386,1005,-207,-216,9,285.1142857142857,35,617.0,1
0,1,0,1739,1044,695,-269,-225,-44,222.4516129032258,31,1739.0,1
0,1,0,9,4,5,-681,-605,-76,134.33333333333334,3,9.0,0
0,1,0,1377,-911,2288,-143,-143,0,397.08620689655174,58,1380.0,1
0,1,0,984,213,771,-233,-579,346,452.57894736842104,19,985.0,1
0,1,22,86,280,-194,-174,-446,272,120.64285714285714,28,83.0,1
0,1,13,963,-1186,2149,-235,-178,-57,414.34615384615387,52,-1186.0,0
0,1,0,512,-556,1068,-246,-203,-43,289.4054054054054,37,-556.0,0
0,1,3,864,-451,1315,-222,-229,7,314.0952380952381,42,866.0,1
0,1,136,1403,495,908,-219,-192,-27,224.02564102564102,39,1404.0,1
0,1,0,1884,1443,441,-250,-210,-40,184.82608695652175,23,1443.0,0
0,1,44,416,-1175,1591,-209,-186,-23,346.68888888888887,45,-1184.0,0
0,1,0,1174,-621,1795,-142,-232,90,393.60869565217394,46,-621.0,0
0,1,0,501,-556,1057,-121,-160,39,242.63636363636363,44,512.0,1
0,1,0,789,-1410,2199,-322,-305,-17,480.2608695652174,46,791.0,1
0,1,64,792,1232,-440,-310,-170,-140,153.46666666666667,30,790.0,1
0,1,0,256,-300,556,-638,-553,-85,443.3076923076923,13,-300.0,0
0,1,0,1082,-1368,2450,-136,-122,-14,444.09090909090907,55,1074.0,1
0,1,16,533,-702,1235,-264,-244,-20,354.1714285714286,35,-711.0,0
0,1,0,479,228,251,-207,-310,103,197.07142857142858,14,479.0,1
0,1,0,236,563,-327,-218,-183,-35,203.64705882352942,17,588.0,0
0,1,0,1078,717,361,-170,-239,69,332.72727272727275,11,717.0,0
0,1,0,604,161,443,-212,-775,563,427.7608695652174,46,605.0,1
0,1,0,1648,1622,26,-220,-211,-9,61.666666666666664,3,1622.0,0
0,1,0,1847,1523,324,-137,-185,48,203.5,16,1844.0,1
0,1,6,750,-515,1265,-209,-157,-52,351.02777777777777,36,-515.0,0
0,1,0,50,-229,279,-561,-423,-138,228.70833333333334,24,179.0,1
0,1,0,915,700,215,-212,-252,40,219.55555555555554,9,903.0,1
0,1,3,856,-2139,2995,-316,-196,-120,453.75757575757575,66,861.0,1
0,1,0,1373,2072,-699,-172,-132,-40,241.06896551724137,29,1372.0,1
0,1,7,499,201,298,296,-71,367,203.6315789473684,19,501.0,1
0,1,0,904,662,242,-265,-321,56,255.55555555555554,9,901.0,1
0,1,11,1053,-1078,2131,-170,-189,19,376.1929824561403,57,-1078.0,0
0,1,4,1467,1076,391,-105,-161,56,138.11111111111111,27,1463.0,1
0,1,62,333,496,-163,-253,-86,-167,151.5,12,506.0,0
0,1,0,720,-860,1580,-242,-233,-9,375.0952380952381,42,720.0,1
0,1,89,1222,1432,-210,-86,-79,-7,88.48780487804878,82,1024.0,1
0,1,0,1975,1554,421,-295,-249,-46,133.94871794871796,39,1981.0,1
0,1,270,1108,1169,-61,-256,-107,-149,47.577777777777776,45,1112.0,0
0,1,0,2380,629,1751,-278,-340,62,430.3658536585366,41,2383.0,1
0,1,0,1078,-36,1114,-231,-278,47,489.39130434782606,23,1077.0,1
0,1,0,2134,1511,623,-177,-195,18,275.54545454545456,22,2122.0,1
0,1,39,465,-458,923,-224,-197,-27,264.2,35,-458.0,0
0,1,0,1055,732,323,-175,-236,61,333.6,10,1046.0,1
0,1,0,261,-258,519,-552,-678,126,405.53846153846155,13,-258.0,0
0,1,0,218,-17,235,-77,-442,365,194.16666666666666,12,219.0,1
0,1,8,1166,613,553,-241,-175,-66,191.6551724137931,29,1162.0,1
0,1,0,240,-409,649,-537,-200,-337,244.15151515151516,33,248.0,1
0,1,0,1114,485,629,-225,-195,-30,360.05882352941177,17,1113.0,1
0,1,18,223,-1758,1981,-499,-164,-335,408.46938775510205,49,-1759.0,0
0,1,0,200,-203,403,-601,-586,-15,376.27272727272725,11,-203.0,0
0,1,0,1030,-464,1494,-193,-303,110,555.7777777777778,27,1030.0,1
0,1,0,891,-615,1506,-337,-341,4,563.2222222222222,27,-615.0,0
0,1,6,553,680,-127,-168,-141,-27,261.24444444444447,45,42.0,1
0,1,0,2048,1419,629,-111,-211,100,243.92307692307693,26,2038.0,1
0,1,0,2001,1465,536,-144,-109,-35,198.48275862068965,29,1465.0,0
0,1,1,1206,547,659,-150,-100,-50,224.51612903225808,31,1206.0,1
0,1,7,516,-723,1239,-195,-120,-75,316.25,40,-746.0,0
0,1,71,71,893,-822,-254,-159,-95,313.15384615384613,26,899.0,0
0,1,0,1997,1668,329,-165,-199,34,160.1,20,1981.0,1
0,1,9,1255,-788,2043,-202,-199,-3,369.0892857142857,56,1258.0,1
0,1,3,844,-764,1608,-232,-189,-43,329.0816326530612,49,-764.0,0
0,1,11,577,-1103,1680,-230,-161,-69,337.46938775510205,49,567.0,1
0,1,31,403,-547,950,-271,-46,-225,235.4102564102564,39,402.0,1
0,1,0,892,498,394,-285,-204,-81,166.47826086956522,23,484.0,0
0,1,5,248,-754,1002,-550,-179,-371,312.44117647058823,34,246.0,1
0,1,0,1128,-220,1348,-166,-311,145,431.60377358490564,53,1131.0,1
0,1,0,479,347,132,-204,-214,10,183.0,7,472.0,1
0,1,18,34,1108,-1074,-316,-184,-132,349.43333333333334,30,1099.0,0
0,1,0,433,-449,882,-284,-282,-2,272.59375,32,432.0,1
0,1,14,482,-388,870,-265,-264,-1,275.0,31,471.0,1
0,1,6,567,214,353,-196,-417,221,178.78125,32,530.0,1
0,1,35,14,-203,217,-764,-540,-224,194.93333333333334,15,-209.0,0
0,1,27,432,674,-242,-114,-60,-54,137.0,17,434.0,1
1,1,12,561,306,255,-91,-400,309,117.12903225806451,31,562.0,1
0,1,24,1280,1298,-18,-188,-79,-109,88.21428571428571,28,1170.0,1
1,1,20,194,-214,408,-553,-547,-6,146.5185185185185,27,195.0,1
0,1,0,265,247,18,-526,-381,-145,36.75,4,266.0,0
0,1,44,138,-446,584,-305,-262,-43,250.2608695652174,23,-449.0,0
0,1,0,13,-74,87,-497,-280,-217,216.53846153846155,39,-424.0,1
0,1,0,1747,-33,1780,-187,-606,419,561.5454545454545,33,-33.0,0
0,1,21,255,-205,460,-551,-499,-52,125.53658536585365,41,256.0,1
0,1,9,431,-867,1298,-265,-223,-42,264.6875,48,425.0,1
0,1,0,492,728,-236,-246,-135,-111,181.50943396226415,53,492.0,1
0,1,52,426,-492,918,-255,-247,-8,234.3846153846154,39,-500.0,0
0,1,12,7,-177,184,-773,-571,-202,163.375,16,10.0,1
0,1,5,31,213,-182,-818,-579,-239,161.76470588235293,17,34.0,1
0,1,0,238,-490,728,-246,-233,-13,266.85185185185185,27,-490.0,0
0,1,2,1310,818,492,-207,-188,-19,143.8181818181818,33,818.0,0
0,1,61,881,1002,-121,-153,-118,-35,64.77777777777777,18,1016.0,0
0,1,1,434,-810,1244,-249,-184,-65,282.04545454545456,44,425.0,1
0,1,18,538,-405,943,-253,-45,-208,266.3333333333333,36,538.0,1
0,1,0,1607,1338,269,-183,-192,9,224.66666666666666,12,1605.0,1
0,1,0,774,-829,1603,-153,60,-213,367.47727272727275,44,774.0,1
0,1,7,2,-225,227,-739,-487,-252,173.75,16,-221.0,0
0,1,18,155,223,-68,-603,-546,-57,112.85714285714286,7,230.0,0
0,1,8,1243,403,840,-179,-230,51,219.9189189189189,37,403.0,0
0,1,15,4,207,-203,-746,-547,-199,190.375,16,231.0,0
0,1,5,1,224,-223,-689,-529,-160,160.94117647058823,17,-0.0,1
0,1,17,12,210,-198,-674,-518,-156,137.6086956521739,23,-33.0,1
0,1,14,691,240,451,-240,-563,323,236.69565217391303,23,246.0,0
0,1,0,1001,457,544,-195,-231,36,378.53333333333336,15,1002.0,1
0,1,12,549,-552,1101,-222,-206,-16,326.9117647058824,34,-561.0,0
0,1,0,188,16,172,-466,-560,94,202.69230769230768,13,213.0,1
0,1,10,816,-918,1734,-175,-186,11,361.2708333333333,48,817.0,1
0,1,0,1133,874,259,-222,-214,-8,112.8695652173913,23,1130.0,1
0,1,0,811,245,566,-187,-309,122,394.06666666666666,15,802.0,1
0,1,20,576,-457,1033,-196,-212,16,290.4,35,-454.0,0
0,1,70,297,1916,-1619,-513,-168,-345,383.95454545454544,44,299.0,1
0,1,11,828,205,623,-233,-524,291,241.17857142857142,28,819.0,1
0,1,5,780,-1104,1884,-201,-189,-12,392.83673469387753,49,-1104.0,0
0,1,0,1488,753,735,-267,-188,-79,243.3548387096774,31,753.0,0
0,1,31,456,173,283,-238,-327,89,177.7058823529412,17,446.0,1
0,1,5,590,-545,1135,-197,-225,28,337.55882352941177,34,592.0,1
1,1,33,893,1266,-373,-275,-190,-85,219.47368421052633,19,1277.0,0
0,1,0,1071,685,386,-191,-272,81,339.5,12,1063.0,1
0,1,8,117,460,-343,-279,-203,-76,220.73333333333332,15,463.0,0
0,1,0,208,721,-513,-289,-125,-164,211.33333333333334,24,721.0,0
0,1,15,554,-476,1030,-204,-227,23,274.8918918918919,37,-474.0,0
0,1,0,974,216,758,-231,-467,236,362.8181818181818,22,976.0,1
0,1,0,1263,123,1140,-172,-737,565,379.8363636363636,55,1265.0,1
0,1,24,546,557,-11,-217,-200,-17,36.0,2,562.0,0
0,1,0,687,216,471,-259,-361,102,370.2857142857143,14,689.0,1
0,1,35,1047,-431,1478,-242,-189,-53,293.06,50,1048.0,1
0,1,20,147,-204,351,-557,-479,-78,178.66666666666666,21,-221.0,0
0,1,0,194,407,-213,-548,-241,-307,176.125,24,191.0,1
0,1,11,592,-1402,1994,-257,-233,-24,358.7090909090909,55,-1402.0,0
0,1,1,151,-375,526,-296,-544,248,216.92307692307693,26,-375.0,0
0,1,1,433,455,-22,-198,-111,-87,53.0,9,378.0,0
0,1,0,811,1905,-1094,-345,-273,-72,400.7037037037037,27,1905.0,0
0,1,0,265,1,264,-597,-603,6,351.25,8,268.0,1
0,1,0,679,-444,1123,-247,-227,-20,208.83333333333334,54,-393.0,0
0,1,16,212,-639,851,-270,-124,-146,197.32608695652175,46,-676.0,0
0,1,0,1001,333,668,-229,-294,65,454.5,16,1005.0,1
0,1,0,1093,807,286,-190,-244,54,257.8181818181818,11,1089.0,1
0,1,0,645,1243,-598,-213,-790,577,503.241935483871,62,649.0,1
0,1,0,944,313,631,-293,-394,101,440.46666666666664,15,945.0,1
0,1,0,179,378,-199,-521,-225,-296,168.96428571428572,28,467.0,0
0,1,0,932,380,552,-232,-371,139,393.8666666666667,15,933.0,1
0,1,0,272,-456,728,-302,-332,30,325.06,50,-913.0,1
0,1,0,511,-737,1248,-245,-275,30,350.48571428571427,35,-737.0,0
0,1,11,568,-875,1443,-233,-175,-58,385.6216216216216,37,-877.0,0
0,1,0,252,-1205,1457,-599,-704,105,450.6060606060606,33,254.0,1
0,1,35,260,1181,-921,-251,-119,-132,404.3181818181818,22,1171.0,0
0,1,0,264,-179,443,-650,-706,56,352.3076923076923,13,264.0,1
0,1,40,79,-1243,1322,-519,-266,-253,379.55555555555554,36,-1272.0,0
0,1,0,221,562,-341,-308,-349,41,324.62264150943395,53,1252.0,1
0,1,20,500,1031,-531,-448,-229,-219,216.76363636363635,55,193.0,1
0,1,0,1298,566,732,-189,-291,102,416.72222222222223,18,1297.0,1
0,1,5,555,-501,1056,-224,-206,-18,307.8235294117647,34,-501.0,0
0,1,0,547,199,348,-196,-260,64,319.3636363636364,11,548.0,1
0,1,0,973,532,441,-161,-296,135,358.46153846153845,13,963.0,1
0,1,60,597,-602,1199,-210,-188,-22,300.325,40,596.0,1
0,1,0,1574,1199,375,-148,-125,-23,250.66666666666666,15,1574.0,1
0,1,0,1471,587,884,-204,-333,129,409.77272727272725,22,1465.0,1
0,1,35,706,-395,1101,-163,-223,60,292.57894736842104,38,-397.0,0
0,1,14,1450,739,711,-255,-180,-75,190.27027027027026,37,734.0,0
0,1,0,212,115,97,-361,-258,-103,350.4782608695652,46,960.0,1
0,1,0,411,228,183,-202,-231,29,256.5,8,412.0,1
0,1,64,147,557,-410,-257,-208,-49,245.375,16,556.0,0
0,1,6,1,-273,274,-773,-496,-277,163.5909090909091,22,0.0,1
0,1,0,1201,97,1104,-209,-838,629,541.7083333333334,24,97.0,0
0,1,0,896,609,287,-163,-272,109,454.14285714285717,7,609.0,0
0,1,109,147,-226,373,-597,-574,-23,125.0,54,148.0,1
1,1,12,651,-652,1303,-205,-158,-47,317.2439024390244,41,652.0,1
1,1,52,193,178,15,-559,-534,-25,123.61111111111111,18,184.0,0
1,1,24,466,-1136,1602,-193,-157,-36,261.63492063492066,63,-1188.0,0
0,1,41,1101,-567,1668,-262,-183,-79,356.25531914893617,47,-585.0,0
0,1,88,406,483,-77,-370,-291,-79,66.33333333333333,6,468.0,0
0,1,0,965,194,771,-186,-270,84,436.44444444444446,18,966.0,1
0,1,39,634,-612,1246,-221,-101,-120,299.780487804878,41,635.0,1
0,1,14,853,-1040,1893,-192,-166,-26,355.48148148148147,54,854.0,1
0,1,0,791,-460,1251,-212,-303,91,384.06060606060606,33,794.0,1
0,1,0,784,-335,1119,-240,-289,49,457.08,25,786.0,1
0,1,0,1992,906,1086,-184,-238,54,441.48,25,1994.0,1
0,1,0,569,-558,1127,-206,-263,57,337.1212121212121,33,564.0,1
1,1,18,779,189,590,-209,-465,256,178.8,35,779.0,1
0,1,1,231,241,-10,-328,-298,-30,29.25,4,222.0,0
1,1,28,1430,676,754,-260,-171,-89,264.17241379310343,29,661.0,0
1,1,0,2113,2150,-37,-190,-193,3,63.42857142857143,7,2111.0,0
1,1,0,871,-414,1285,-187,-241,54,408.1875,32,886.0,1
0,1,23,228,-265,493,-502,-461,-41,186.92592592592592,27,225.0,1
0,1,0,998,542,456,-250,-287,37,349.15384615384613,13,996.0,1
0,1,0,276,-302,578,-565,-562,-3,231.88,25,277.0,1
0,1,0,1278,273,1005,-266,-460,194,299.8787878787879,33,257.0,0
0,1,0,1033,654,379,-209,-233,24,368.09090909090907,11,1033.0,1
0,1,0,277,-115,392,-538,-677,139,348.75,12,281.0,1
0,1,67,837,856,-19,349,182,167,64.5,2,854.0,0
0,1,29,209,238,-29,-533,-528,-5,48.0,3,228.0,0
0,1,22,583,-604,1187,-197,-182,-15,257.73333333333335,45,-616.0,0
0,1,0,1507,1172,335,-175,-146,-29,127.84,25,1172.0,0
0,1,0,524,474,50,-56,-97,41,61.625,8,525.0,0
0,1,0,250,403,-153,-557,-534,-23,213.5,8,249.0,1
0,1,42,1082,1637,-555,-243,-173,-70,209.52,25,1637.0,0
0,1,41,527,-603,1130,-268,-137,-131,291.55,40,-615.0,0
0,1,0,929,-966,1895,-172,-297,125,542.0,35,918.0,1
0,1,25,768,-783,1551,-215,-110,-105,345.2391304347826,46,769.0,1
0,1,45,138,263,-125,-412,-441,29,75.15789473684211,19,135.0,1
0,1,0,1114,874,240,-184,-240,56,236.0,9,1075.0,1
0,1,0,870,576,294,-185,-262,77,279.0,11,871.0,1
0,1,0,2073,1864,209,-250,-257,7,193.16666666666666,12,2074.0,1
0,1,23,741,326,415,-161,-412,251,187.40740740740742,27,322.0,0
0,1,0,2046,1524,522,-204,-98,-106,134.46,50,2064.0,1
0,1,99,1215,1210,5,-87,41,-128,68.62790697674419,43,1049.0,1
0,1,8,276,-259,535,-463,-424,-39,194.55555555555554,27,266.0,1
0,1,0,274,-523,797,-478,-147,-331,239.31428571428572,35,275.0,1
0,1,20,651,-1150,1801,-204,-53,-151,348.21153846153845,52,-1171.0,0
0,1,22,1810,-236,2046,-349,-441,92,375.8363636363636,55,-228.0,0
0,1,70,279,1697,-1418,-445,-166,-279,351.219512195122,41,1697.0,0
0,1,45,1,238,-237,-682,-470,-212,107.8076923076923,26,-0.0,1
0,1,26,451,-471,922,-255,-184,-71,263.0,35,-471.0,0
0,1,28,760,-867,1627,-189,-161,-28,309.8269230769231,52,-867.0,0
0,1,91,104,-415,519,-278,-261,-17,243.71428571428572,21,-428.0,0
0,1,0,1183,-576,1759,-141,-396,255,578.4516129032259,31,1175.0,1
0,1,0,1366,666,700,-151,-216,65,234.66666666666666,30,1368.0,1
0,1,32,2,216,-214,-715,-512,-203,92.71875,32,2.0,1
0,1,36,738,-904,1642,-214,-199,-15,337.40816326530614,49,-917.0,0
1,1,41,1310,3,1307,-260,-708,448,259.8703703703704,54,1311.0,1
0,1,14,707,-1096,1803,-309,-242,-67,417.95348837209303,43,-1097.0,0
0,1,17,448,-309,757,-274,-373,99,257.6666666666667,30,-318.0,0
0,1,0,211,-95,306,-440,-438,-2,237.53846153846155,13,-95.0,0
0,1,0,724,-770,1494,-293,-286,-7,369.2,40,726.0,1
0,1,14,8,-220,228,-618,-535,-83,149.66666666666666,42,8.0,1
0,1,49,56,432,-376,-298,-264,-34,193.05555555555554,18,429.0,0
0,1,0,831,-727,1558,-119,-386,267,533.0322580645161,31,827.0,1
1,1,20,1705,12,1693,-132,-745,613,358.98039215686276,51,1706.0,1
0,1,0,1488,1004,484,-220,-189,-31,212.08695652173913,23,1004.0,0
0,1,0,392,-643,1035,-231,-248,17,351.23333333333335,30,393.0,1
0,1,0,516,-1243,1759,-332,-333,1,505.6,35,-1243.0,0
0,1,72,94,-13,107,-344,-733,389,155.92307692307693,13,-19.0,0
0,1,0,1896,1017,879,-265,-268,3,262.6060606060606,33,1889.0,1
0,1,15,748,-410,1158,-262,-278,16,341.2352941176471,34,-414.0,0
0,1,9,744,1351,-607,-356,-304,-52,306.63157894736844,19,1351.0,0
0,1,0,693,-809,1502,-257,-225,-32,340.22727272727275,44,696.0,1
0,1,0,1185,535,650,-196,-300,104,392.8235294117647,17,1186.0,1
0,1,10,16,-197,213,-720,-491,-229,129.19607843137254,51,14.0,1
0,1,32,1896,1250,646,-61,-156,95,190.6,35,1812.0,1
0,1,36,1166,751,415,-267,-247,-20,124.54838709677419,31,1165.0,1
0,1,14,521,360,161,-236,-182,-54,65.72727272727273,22,520.0,1
0,1,5,226,-1013,1239,-262,-144,-118,289.36170212765956,47,-1077.0,0
0,1,0,529,-333,862,-224,-235,11,318.037037037037,27,527.0,1
0,1,0,1526,1081,445,-170,-143,-27,194.2173913043478,23,1524.0,1
0,1,48,22,238,-216,-734,-481,-253,136.1904761904762,21,236.0,0
0,1,0,722,-597,1319,-195,-202,7,317.3658536585366,41,723.0,1
0,1,0,1018,1215,-197,-180,-212,32,307.3333333333333,54,292.0,1
0,1,0,729,-327,1056,-166,-318,152,345.96774193548384,31,730.0,1
0,1,0,223,-224,447,-455,-459,4,165.55172413793105,29,-225.0,0
0,1,0,474,-484,958,-160,-140,-20,295.375,32,-469.0,0
0,1,0,531,-1,532,-159,-194,35,325.34,50,532.0,1
0,1,33,302,236,66,-499,-418,-81,96.20588235294117,34,120.0,1
0,1,0,882,-295,1177,-139,-190,51,526.7826086956521,23,882.0,1
0,1,33,623,-881,1504,-243,-150,-93,359.8333333333333,42,-883.0,0
0,1,0,855,-416,1271,-158,-601,443,539.5,26,857.0,1
0,1,0,2,29,-27,-471,-229,-242,256.3658536585366,41,1.0,0
0,1,36,641,-3,644,-416,-743,327,223.6060606060606,33,-9.0,0
0,1,36,10,-257,267,-759,-371,-388,150.76,25,11.0,1
1,1,24,1210,4,1206,-123,-755,632,271.66,50,4.0,0
0,1,43,190,1718,-1528,-484,-162,-322,277.6,60,188.0,1
0,1,72,870,1428,-558,-119,-159,40,206.5151515151515,33,1574.0,1
0,1,0,778,-453,1231,-153,-190,37,522.0416666666666,24,774.0,1
0,1,0,417,162,255,-212,-592,380,336.48387096774195,31,-155.0,1
0,1,0,1430,-141,1571,-166,-223,57,304.7692307692308,52,437.0,1
0,1,0,794,-508,1302,-211,-307,96,383.29411764705884,34,796.0,1
0,1,12,1859,492,1367,-176,-166,-10,339.65,40,499.0,0
0,1,12,293,-1258,1551,-247,-141,-106,496.7741935483871,31,-1261.0,0
0,1,0,549,-345,894,-202,-183,-19,509.1666666666667,18,552.0,1
0,1,0,217,-515,732,-496,-666,170,475.3333333333333,18,217.0,1
0,1,0,1101,690,411,-169,-115,-54,150.5185185185185,27,690.0,0
0,1,17,764,860,-96,-225,-26,-199,214.65116279069767,43,367.0,1
0,1,10,1106,681,425,-198,-96,-102,190.54545454545453,22,681.0,0
0,1,40,922,634,288,-154,8,-162,170.44444444444446,18,619.0,0
0,1,18,442,195,247,-82,-350,268,168.93333333333334,30,438.0,1
0,1,44,482,694,-212,-167,-173,6,134.66666666666666,15,698.0,0
0,1,13,441,427,14,-239,-246,7,225.5952380952381,42,441.0,0
1,1,49,882,875,7,-160,-38,-122,28.5,2,881.0,0
0,1,0,459,535,-76,-177,-44,-133,30.666666666666668,15,443.0,0
1,1,134,1142,1165,-23,-203,-97,-106,30.0,1,1150.0,0
0,1,0,721,-487,1208,-159,-257,98,520.25,24,722.0,1
0,1,44,930,30,900,-214,-627,413,170.40983606557376,61,933.0,1
0,1,80,1090,1176,-86,-380,39,-419,54.89090909090909,55,1268.0,0
0,1,79,1406,1447,-41,-388,15,-403,104.63106796116504,103,1409.0,0
0,1,36,211,81,130,-469,-129,-340,180.8125,16,212.0,1
0,1,8,1159,619,540,-145,-93,-52,182.75862068965517,29,1157.0,1
0,1,41,932,-1446,2378,-189,-136,-53,470.4117647058824,51,931.0,1
0,1,0,1311,-174,1485,-136,-88,-48,313.7708333333333,48,1312.0,1
1,1,38,1083,1870,-787,-37,-79,42,150.0,52,1082.0,1
0,1,0,912,-446,1358,-150,-656,506,383.4864864864865,37,911.0,1
1,1,74,436,1009,-573,-183,-153,-30,150.91666666666666,36,435.0,1
1,1,52,795,1497,-702,-81,-61,-20,200.45714285714286,35,793.0,1
1,1,56,1137,198,939,-182,-522,340,247.35,40,1128.0,1
0,1,0,834,-431,1265,-172,-292,120,536.8333333333334,24,832.0,1
1,1,26,1319,-4,1323,-195,-760,565,282.40384615384613,52,1322.0,1
0,1,51,245,-191,436,-225,-366,141,292.11764705882354,17,-194.0,0
0,1,19,10,223,-213,-798,-407,-391,209.26315789473685,19,8.0,1
0,1,34,2007,465,1542,-242,-88,-154,319.4166666666667,48,466.0,0
1,1,19,1554,1171,383,-291,-215,-76,146.44,25,1173.0,0
1,1,26,198,70,128,-477,-218,-259,175.06666666666666,15,199.0,1
0,1,13,227,-467,694,-475,-231,-244,244.38709677419354,31,-474.0,0
0,1,22,783,-499,1282,-207,-180,-27,325.87179487179486,39,-497.0,0
0,1,0,1187,558,629,-167,-201,34,415.6354166666667,96,-1097.0,1
0,1,29,226,-204,430,-521,-511,-10,148.3448275862069,29,207.0,1
0,1,18,15,1429,-1414,-391,-164,-227,411.3235294117647,34,1429.0,0
0,1,0,895,-403,1298,-175,-280,105,555.5,24,896.0,1
0,1,39,511,-497,1008,-233,-225,-8,300.97058823529414,34,-504.0,0
0,1,11,1337,288,1049,-300,-585,285,291.7837837837838,37,286.0,0
0,1,0,1900,504,1396,-284,-187,-97,317.9318181818182,44,504.0,0
0,1,17,1574,222,1352,-237,-516,279,284.0,63,1572.0,1
1,1,23,485,331,154,-204,-298,94,99.73333333333333,15,500.0,1
1,1,9,939,1218,-279,-59,-71,12,158.33333333333334,18,940.0,1
0,1,3,429,-846,1275,-248,-50,-198,401.64516129032256,31,-846.0,0
0,1,0,1640,830,810,-182,-298,116,386.85714285714283,21,1621.0,1
0,1,2,281,-527,808,-213,-164,-49,255.29032258064515,31,-527.0,0
0,1,0,8,157,-149,-493,-252,-241,235.15625,32,6.0,1
0,1,0,518,-232,750,-228,-212,-16,380.75,20,518.0,1
0,1,0,893,-199,1092,-240,-736,496,488.76,25,894.0,1
0,1,13,566,-648,1214,-221,-169,-52,274.47727272727275,44,567.0,1
0,1,4,811,843,-32,-219,-198,-21,255.6206896551724,58,79.0,1
0,1,28,844,-602,1446,-189,-90,-99,316.0,46,-597.0,0
0,1,6,502,-702,1204,-184,-105,-79,312.0,39,-702.0,0
1,1,36,22,-205,227,-594,-511,-83,82.4,30,20.0,1
0,1,7,1058,-760,1818,-167,-172,5,389.02127659574467,47,-760.0,0
0,1,0,997,-734,1731,-215,-132,-83,483.5833333333333,36,-734.0,0
0,1,0,1831,1007,824,-236,-248,12,225.60526315789474,38,1828.0,1
0,1,0,1011,-826,1837,-151,-259,108,435.7906976744186,43,1014.0,1
0,1,0,560,-139,699,-257,-286,29,375.8421052631579,19,560.0,1
0,1,0,1085,-342,1427,-211,-312,101,501.0689655172414,29,1087.0,1
0,1,0,260,654,-394,-420,-110,-310,175.7037037037037,27,258.0,1
0,1,10,1030,659,371,-104,180,-284,131.03703703703704,27,659.0,0
0,1,0,712,-54,766,-307,-456,149,306.35185185185185,54,712.0,1
0,1,0,700,-428,1128,-232,-250,18,517.7272727272727,22,-428.0,0
0,1,32,204,230,-26,-547,-488,-59,63.0,2,203.0,0
0,1,0,283,-488,771,-532,-727,195,401.0,20,284.0,1
0,1,0,1000,-583,1583,-241,-356,115,557.7931034482758,29,-583.0,0
0,1,0,723,526,197,-234,-316,82,309.57142857142856,7,724.0,1
0,1,10,28,-568,596,-304,-163,-141,259.2173913043478,23,-560.0,0
0,1,0,496,513,-17,-176,-156,-20,72.25,4,486.0,0
0,1,0,269,-724,993,-639,-762,123,484.2857142857143,21,270.0,1
0,1,0,935,486,449,-208,-253,45,369.53846153846155,13,941.0,1
0,1,0,511,-540,1051,-173,-152,-21,273.1842105263158,38,-532.0,0
0,1,0,789,1934,-1145,-193,-166,-27,309.97297297297297,37,788.0,1
0,1,12,450,399,51,-214,-219,5,186.3125,48,-22.0,1
0,1,54,725,483,242,-161,-197,36,141.52631578947367,19,723.0,1
0,1,0,914,-490,1404,-169,-219,50,548.5769230769231,26,915.0,1
0,1,0,912,-461,1373,-208,-161,-47,449.35483870967744,31,916.0,1
0,1,0,1497,523,974,-189,-78,-111,267.8333333333333,36,509.0,0
0,1,32,1196,238,958,-276,-394,118,230.5,52,142.0,0
1,1,13,836,-887,1723,-254,-166,-88,322.2641509433962,53,835.0,1
1,1,0,257,-208,465,-476,-420,-56,173.71428571428572,28,258.0,1
0,1,0,1031,-135,1166,-225,-288,63,513.4347826086956,23,1030.0,1
0,1,0,1223,219,1004,-287,-516,229,243.02272727272728,44,1220.0,1
0,1,0,670,-496,1166,-229,-218,-11,491.3333333333333,24,671.0,1
0,1,0,945,357,588,-38,-129,91,361.3125,16,357.0,0
0,1,51,852,-930,1782,-209,-150,-59,367.7916666666667,48,-928.0,0
0,1,0,1447,523,924,-211,-82,-129,247.56410256410257,39,486.0,0
0,1,0,1152,574,578,-319,-394,75,395.6,15,574.0,0
0,1,23,774,451,323,-45,-101,56,136.41666666666666,24,775.0,1
1,1,77,237,122,115,-462,-228,-234,143.27272727272728,11,137.0,0
1,1,41,39,501,-462,-216,-212,-4,265.6470588235294,17,510.0,0
0,1,0,249,219,30,-466,-87,-379,123.33333333333333,3,219.0,0
0,1,0,537,567,-30,-182,225,-407,152.75,4,536.0,0
0,1,0,777,728,49,-70,363,-433,168.0,4,778.0,0
0,1,25,960,-1141,2101,-285,-70,-215,445.72340425531917,47,-1141.0,0
0,1,0,1229,179,1050,-199,-679,480,545.5454545454545,22,1226.0,1
0,1,8,972,-652,1624,-188,-73,-115,402.9756097560976,41,-652.0,0
0,1,0,1093,1176,-83,-207,-98,-109,125.0,7,1093.0,0
0,1,3,1178,278,900,-353,-439,86,157.7530864197531,81,116.0,1
0,1,24,322,-281,603,-569,-463,-106,228.07407407407408,27,324.0,1
0,1,55,968,-1250,2218,-211,-137,-74,431.2156862745098,51,-1244.0,0
0,1,24,260,-1521,1781,-267,-91,-176,388.5652173913044,46,-1546.0,0
0,1,18,705,-1112,1817,-242,-117,-125,324.7142857142857,56,-1106.0,0
0,1,0,511,494,17,-60,-77,17,38.5,4,512.0,0
0,1,0,261,484,-223,249,-155,404,147.84615384615384,13,462.0,0
0,1,9,46,-80,126,-261,-192,-69,127.81818181818181,11,-83.0,0
0,1,47,232,-251,483,-538,-493,-45,221.95454545454547,22,229.0,1
0,1,9,741,-1299,2040,-252,-176,-76,350.01724137931035,58,742.0,1
0,1,12,1250,998,252,-93,-101,8,156.3125,16,994.0,0
0,1,0,944,404,540,-203,-240,37,185.10344827586206,29,942.0,1
0,1,17,885,-1068,1953,-220,-228,8,394.46938775510205,49,-1061.0,0
0,1,108,107,253,-146,-546,-579,33,103.5625,16,274.0,0
0,1,0,851,-376,1227,-270,-303,33,485.0769230769231,26,853.0,1
0,1,0,785,-317,1102,-217,-280,63,448.44,25,786.0,1
0,1,0,889,455,434,-105,-122,17,181.95,40,869.0,1
0,1,0,869,-409,1278,-168,-162,-6,279.17021276595744,47,-428.0,0
0,1,0,272,-198,470,-481,-615,134,418.6666666666667,12,270.0,1
0,1,0,1769,502,1267,-220,-197,-23,329.1578947368421,38,510.0,0
0,1,0,1003,209,794,-186,-132,-54,438.47058823529414,17,982.0,1
0,1,33,964,545,419,-198,-155,-43,124.7741935483871,31,966.0,1
0,1,0,1746,1362,384,-228,-97,-131,325.8333333333333,12,1744.0,1
0,1,12,1968,1220,748,-183,-78,-105,217.6764705882353,34,1225.0,0
0,1,33,1113,962,151,-117,-125,8,70.10526315789474,19,965.0,0
0,1,0,1427,779,648,-169,-161,-8,174.55555555555554,36,779.0,0
0,1,4,877,-758,1635,-238,-78,-160,295.4,55,879.0,1
0,1,23,772,-1346,2118,-192,-81,-111,303.5,70,774.0,1
0,1,0,1069,-137,1206,-218,-276,58,511.6666666666667,24,1070.0,1
0,1,0,230,-265,495,-542,-372,-170,199.95833333333334,24,231.0,1
0,1,0,581,236,345,-240,-282,42,323.09090909090907,11,577.0,1
0,1,0,618,86,532,-180,-267,87,386.2857142857143,14,619.0,1
0,1,20,964,-1274,2238,-191,-152,-39,340.42424242424244,66,-1272.0,0
0,1,0,260,-678,938,-463,-188,-275,272.1388888888889,36,262.0,1
0,1,72,1309,1639,-330,-140,-79,-61,132.1304347826087,23,1308.0,1
0,1,11,220,-657,877,-482,-179,-303,253.31428571428572,35,221.0,1
1,1,71,246,-264,510,-414,-463,49,213.92592592592592,27,245.0,1
0,1,0,1531,991,540,-114,-133,19,241.5909090909091,22,1526.0,1
0,1,0,12,172,-160,-389,-273,-116,218.51282051282053,39,491.0,1
0,1,0,1025,-509,1534,-212,-172,-40,549.4642857142857,28,1028.0,1
0,1,0,2054,1340,714,-275,-122,-153,338.95454545454544,22,2055.0,1
1,1,25,1587,285,1302,-198,-523,325,331.8292682926829,41,1588.0,1
0,1,0,1425,1237,188,-110,-71,-39,171.0,11,1428.0,1
0,1,0,1745,1270,475,-255,-187,-68,327.4,15,1747.0,1
0,1,0,1095,917,178,-242,-244,2,221.125,8,1095.0,1
0,1,33,365,503,-138,-263,-154,-109,126.84615384615384,13,512.0,0
0,1,0,430,144,286,-213,-302,89,248.58333333333334,12,432.0,1
0,1,0,1322,361,961,-162,-230,68,192.71428571428572,49,361.0,0
0,1,170,1926,2122,-196,-113,-68,-45,111.82938388625593,211,1949.0,1
0,1,0,293,284,9,-475,-387,-88,70.00877192982456,114,293.0,0
0,1,200,1162,1217,-55,-66,12,-78,135.87313432835822,134,1163.0,0
0,1,0,1843,496,1347,-251,-446,195,437.51612903225805,31,496.0,0
0,1,21,495,743,-248,-82,75,-157,143.25,16,502.0,1
0,1,0,717,-549,1266,-189,-71,-118,327.53846153846155,39,713.0,1
0,1,0,946,114,832,-147,-728,581,376.22222222222223,27,947.0,1
0,1,0,1898,1395,503,-338,-248,-90,211.33333333333334,24,1899.0,1
0,1,0,599,-821,1420,-221,-361,140,314.4222222222222,45,-821.0,0
0,1,0,1485,1001,484,-136,-93,-43,234.5,22,1485.0,1
0,1,0,1995,1345,650,-271,-197,-74,221.9655172413793,29,1992.0,1
0,1,5,439,-635,1074,-261,-239,-22,307.0857142857143,35,-636.0,0
0,1,0,547,-23,570,-162,-458,296,225.67741935483872,31,543.0,1
0,1,0,464,431,33,-89,-121,32,16.25,4,471.0,0
0,1,0,1556,671,885,-253,-192,-61,295.93333333333334,30,1557.0,1
0,1,1,949,448,501,-285,-253,-32,230.23809523809524,21,454.0,0
0,1,27,1,224,-223,-791,-555,-236,122.76923076923077,26,-1.0,1
0,1,0,1519,646,873,-206,-160,-46,332.9230769230769,26,1511.0,1
0,1,0,1155,645,510,-172,-257,85,149.52941176470588,34,916.0,1
0,1,35,453,1520,-1067,-287,-134,-153,406.9230769230769,26,1516.0,0
0,1,0,469,466,3,-251,-257,6,24.153846153846153,13,465.0,0
0,1,0,474,-788,1262,-223,-278,55,345.9166666666667,36,-788.0,0
0,1,0,1066,121,945,-175,-768,593,348.71875,32,1066.0,1
0,1,8,530,-1285,1815,-195,-48,-147,367.9183673469388,49,-1285.0,0
0,1,8,640,-754,1394,-206,-115,-91,319.6744186046512,43,641.0,1
0,1,0,713,-746,1459,-211,-115,-96,340.90697674418607,43,-746.0,0
0,1,0,1577,1184,393,-216,-149,-67,257.06666666666666,15,1568.0,1
0,1,0,184,-199,383,-539,-456,-83,202.95238095238096,21,181.0,1
0,1,43,210,233,-23,-307,-376,69,81.55555555555556,36,161.0,0
0,1,0,1768,1348,420,-264,-217,-47,149.92592592592592,27,1348.0,0
0,1,15,286,-263,549,-451,-463,12,164.2258064516129,31,288.0,1
0,1,76,144,553,-409,-259,-215,-44,284.42857142857144,14,561.0,0
0,1,0,796,582,214,-195,-221,26,222.9,10,795.0,1
0,1,0,648,-933,1581,-169,-111,-58,376.9047619047619,42,-933.0,0
0,1,0,228,332,-104,-617,-557,-60,61.1578947368421,19,332.0,0
0,1,0,2099,1482,617,-172,-187,15,285.90909090909093,22,2101.0,1
0,1,0,1256,619,637,-183,-318,135,471.85714285714283,14,1255.0,1
0,1,82,971,1102,-131,-185,-178,-7,58.23529411764706,17,1093.0,0
0,1,6,507,180,327,-234,-491,257,215.31578947368422,19,508.0,1
0,1,0,781,-1389,2170,-230,-70,-160,417.9230769230769,52,783.0,1
0,1,0,1454,1034,420,-178,-217,39,198.23809523809524,21,1034.0,0
0,1,0,1031,536,495,-193,-257,64,420.0,12,1027.0,1
0,1,0,794,-941,1735,-274,-176,-98,402.74418604651163,43,794.0,1
0,1,18,943,224,719,-242,-440,198,266.93548387096774,31,162.0,0
0,1,31,572,-696,1268,-220,-209,-11,270.69565217391306,46,-694.0,0
0,1,59,441,213,228,-233,-439,206,164.8421052631579,19,444.0,1
0,1,19,527,660,-133,-174,-148,-26,116.0909090909091,11,526.0,1
0,1,0,1367,816,551,-331,-247,-84,185.33333333333334,30,1368.0,1
0,1,14,489,836,-347,-249,-174,-75,236.52777777777777,36,487.0,1
0,1,49,554,-928,1482,-201,-189,-12,349.5238095238095,42,-928.0,0
0,1,31,230,-204,434,-599,-505,-94,183.45454545454547,22,221.0,1
0,1,0,1848,908,940,-215,-246,31,214.11363636363637,44,1851.0,1
0,1,0,821,501,320,-384,-334,-50,298.9166666666667,12,826.0,1
0,1,0,1302,143,1159,-239,-585,346,460.85185185185185,27,1308.0,1
0,1,7,227,-213,440,-573,-445,-128,143.16666666666666,30,-198.0,0
0,1,32,470,202,268,-248,-519,271,168.13636363636363,22,471.0,1
0,1,0,170,-36,206,-589,-584,-5,253.625,8,172.0,1
0,1,0,463,496,-33,-227,-273,46,200.36,25,464.0,0
0,1,34,1328,-611,1939,-222,-217,-5,375.29411764705884,51,-606.0,0
0,1,0,1794,1261,533,-139,-189,50,235.77272727272728,22,1790.0,1
0,1,72,85,218,-133,-499,-507,8,76.45454545454545,22,255.0,0
0,1,3,516,-915,1431,-289,-195,-94,328.09302325581393,43,-915.0,0
0,1,64,151,213,-62,-386,-475,89,126.18181818181819,11,236.0,0
0,1,0,1447,1063,384,332,206,126,228.7058823529412,17,1446.0,1
0,1,28,186,-227,413,-45,-75,30,143.46666666666667,30,-242.0,0
0,1,0,609,183,426,-261,-383,122,233.10714285714286,28,611.0,1
0,1,7,427,-485,912,-273,-168,-105,272.4117647058824,34,-490.0,0
0,1,0,805,664,141,-196,-226,30,232.57142857142858,7,811.0,1
0,1,0,2009,1146,863,-226,-192,-34,269.15625,32,1146.0,0
0,1,7,1374,864,510,-317,-158,-159,176.10714285714286,28,1360.0,1
0,1,0,1328,827,501,-210,-196,-14,215.30434782608697,23,1320.0,1
0,1,0,953,-823,1776,-241,-203,-38,416.3255813953488,43,-823.0,0
0,1,0,676,-585,1261,-225,-125,-100,380.02777777777777,36,677.0,1
0,1,19,1320,-1042,2362,-211,29,-240,410.140350877193,57,1319.0,1
0,1,0,1876,1381,495,-191,-222,31,312.875,16,1877.0,1
0,1,0,1590,1271,319,-257,-253,-4,252.76923076923077,13,1591.0,1
0,1,0,1526,797,729,-209,-144,-65,263.17241379310343,29,797.0,0
0,1,23,1946,1374,572,-213,-190,-23,243.91304347826087,23,1937.0,1
0,1,0,503,206,297,-161,-255,94,350.44444444444446,9,504.0,1
0,1,1,1326,602,724,-182,-161,-21,217.8181818181818,33,1322.0,1
0,1,0,995,-283,1278,-213,-300,87,492.0,26,986.0,1
0,1,1,538,-861,1399,-212,-189,-23,313.22727272727275,44,538.0,1
0,1,0,967,694,273,-222,-232,10,237.41666666666666,12,969.0,1
0,1,0,1179,1014,165,-135,-116,-19,185.38709677419354,31,1180.0,1
0,1,0,510,349,161,-140,-231,91,223.89583333333334,48,511.0,1
0,1,0,890,-35,925,-222,-270,48,452.85714285714283,21,891.0,1
1,1,15,517,-620,1137,-228,-138,-90,294.1621621621622,37,516.0,1
1,1,20,1646,-1983,3629,-32,24,-56,450.1463414634146,82,1648.0,1
1,1,51,999,1365,-366,-88,-53,-35,106.45454545454545,44,919.0,1
0,1,0,1230,6,1224,-288,-585,297,363.8974358974359,39,1232.0,1
0,1,30,1451,1316,135,454,66,388,107.75,12,1454.0,1
0,1,14,2014,2019,-5,461,97,364,85.16129032258064,31,2013.0,0
0,1,0,470,551,-81,343,-31,374,81.7741935483871,31,475.0,0
1,1,28,260,-314,574,-536,-539,3,150.65116279069767,43,255.0,1
0,1,37,282,256,26,-17,-154,137,82.81481481481481,54,289.0,0
0,1,50,1986,1962,24,448,282,166,61.65625,32,1983.0,0
0,1,19,1768,654,1114,-124,-170,46,290.89473684210526,38,1764.0,1
0,1,0,811,-459,1270,-192,-407,215,404.65714285714284,35,-514.0,0
0,1,26,476,-531,1007,-86,-186,100,239.21428571428572,42,477.0,1
0,1,0,789,-346,1135,-224,-268,44,505.9130434782609,23,-346.0,0
0,1,0,2152,748,1404,-184,-218,34,331.0,49,2254.0,1
0,1,0,1463,1188,275,-229,-196,-33,215.30769230769232,13,1461.0,1
0,1,0,846,398,448,-139,-210,71,334.14285714285717,14,849.0,1
0,1,17,1959,1269,690,-148,-171,23,215.90625,32,1259.0,0
0,1,0,1100,-468,1568,-186,-295,109,523.2666666666667,30,1100.0,1
0,1,0,957,-514,1471,-168,-689,521,563.3571428571429,28,958.0,1
0,1,13,968,-870,1838,-254,-206,-48,353.078431372549,51,-870.0,0
0,1,0,858,-127,985,-256,-712,456,544.3809523809524,21,858.0,1
0,1,0,696,-354,1050,-218,-274,56,428.16,25,697.0,1
0,1,8,482,-625,1107,-223,-164,-59,270.2926829268293,41,474.0,1
0,1,0,1121,665,456,-169,-212,43,362.0769230769231,13,665.0,0
0,1,0,2156,900,1256,-200,-215,15,383.45454545454544,33,2158.0,1
0,1,0,2037,1584,453,-246,-65,-181,187.1304347826087,23,1584.0,0
0,1,0,1091,604,487,-192,-150,-42,185.6153846153846,26,601.0,0
0,1,5,595,-1381,1976,-312,-135,-177,375.2307692307692,52,595.0,1
0,1,0,1138,-621,1759,-244,-63,-181,399.3488372093023,43,1128.0,1
0,1,0,1364,-951,2315,-225,-213,-12,394.51724137931035,58,-951.0,0
0,1,0,1233,-465,1698,-219,-160,-59,393.4186046511628,43,-465.0,0
0,1,0,489,272,217,-264,-259,-5,247.88888888888889,9,489.0,1
0,1,0,844,250,594,-230,-312,82,400.25,16,846.0,1
0,1,4,41,903,-862,-324,-179,-145,304.7142857142857,28,903.0,0
0,1,6,1536,942,594,-303,-233,-70,171.3235294117647,34,942.0,0
0,1,29,1388,267,1121,-300,-371,71,314.9166666666667,36,252.0,0
0,1,0,1252,183,1069,-266,-364,98,244.6590909090909,44,1253.0,1
0,1,0,580,301,279,-181,-362,181,224.2325581395349,43,580.0,1
1,1,129,138,184,-46,-568,-650,82,80.16666666666667,12,142.0,0
0,1,34,776,771,5,-212,-217,5,87.80392156862744,51,777.0,0
1,1,0,1361,13,1348,-147,-771,624,216.09859154929578,71,1361.0,1
0,1,12,769,-1188,1957,-238,-110,-128,359.2037037037037,54,770.0,1
0,1,56,176,863,-687,-327,-172,-155,224.13333333333333,30,854.0,0
0,1,35,205,1861,-1656,-498,-166,-332,334.02,50,1858.0,0
0,1,0,1348,918,430,-203,-213,10,225.1578947368421,19,1349.0,1
0,1,9,616,-433,1049,-245,-203,-42,261.25,40,620.0,1
0,1,0,622,-681,1303,-222,-27,-195,373.18918918918916,37,-703.0,0
0,1,0,809,350,459,-241,-321,80,254.22222222222223,18,812.0,1
0,1,38,429,-623,1052,-210,-164,-46,168.3793103448276,87,429.0,1
0,1,29,1103,1148,-45,-69,-74,5,84.08888888888889,45,1104.0,0
1,1,0,534,407,127,-145,-92,-53,77.45,20,535.0,1
1,1,29,650,522,128,-189,-149,-40,52.72727272727273,22,652.0,1
0,1,2,1162,-963,2125,-189,-147,-42,369.2758620689655,58,1164.0,1
0,1,0,208,583,-375,-517,-250,-267,192.92,25,213.0,1
0,1,45,157,1108,-951,-500,-136,-364,248.53658536585365,41,156.0,1
0,1,0,524,374,150,-184,-221,37,244.14285714285714,7,525.0,1
0,1,0,632,-470,1102,-234,-284,50,380.0344827586207,29,634.0,1
0,1,0,1174,415,759,-222,-343,121,439.05555555555554,18,1177.0,1
0,1,17,507,-876,1383,-264,-91,-173,378.2432432432432,37,-897.0,0
0,1,25,196,2016,-1820,-494,-144,-350,351.1132075471698,53,195.0,1
0,1,0,184,-212,396,-517,-122,-395,173.46153846153845,26,185.0,1
0,1,0,451,-576,1027,-244,-161,-83,319.65625,32,-576.0,0
0,1,0,1173,551,622,-181,-259,78,432.4,15,1166.0,1
0,1,0,564,-474,1038,-200,-216,16,308.0857142857143,35,582.0,1
0,1,0,2123,1393,730,-152,-77,-75,271.0,27,1393.0,0
0,1,49,257,-1344,1601,-288,-160,-128,303.88461538461536,52,-1340.0,0
0,1,40,181,-1316,1497,-532,-114,-418,383.125,40,176.0,1
0,1,0,909,-398,1307,-185,-405,220,473.89285714285717,28,912.0,1
0,1,6,601,-755,1356,-257,-168,-89,286.1489361702128,47,571.0,1
0,1,0,292,272,20,-530,-541,11,28.0,1,295.0,0
1,1,57,221,631,-410,-362,-268,-94,129.53125,32,220.0,1
1,1,57,12,-1280,1292,-628,-101,-527,299.5869565217391,46,-1274.0,0
0,1,0,1076,-268,1344,-208,-389,181,452.3333333333333,30,1079.0,1
0,1,0,1130,554,576,-148,-247,99,460.6923076923077,13,1131.0,1
0,1,0,802,-676,1478,-198,-314,116,496.8,30,804.0,1
0,1,0,777,-173,950,-232,-755,523,462.75,24,777.0,1
1,1,57,1754,771,983,-173,-85,-88,224.38636363636363,44,760.0,0
1,1,93,206,107,99,-468,-121,-347,213.8,10,102.0,0
0,1,0,593,-264,857,-153,-251,98,294.6666666666667,42,595.0,1
0,1,0,591,503,88,-245,-150,-95,172.5,4,589.0,0
1,1,51,526,805,-279,-85,-96,11,121.48,25,527.0,1
0,1,0,795,726,69,-209,-230,21,150.4,5,726.0,0
0,1,27,1085,1298,-213,-74,-60,-14,132.91666666666666,12,1261.0,0
0,1,3,613,-463,1076,-153,-165,12,269.45,40,614.0,1
0,1,0,224,1265,-1041,-534,-547,13,404.03846153846155,26,223.0,1
0,1,10,591,-695,1286,-294,-83,-211,305.27906976744185,43,591.0,1
1,1,33,1870,1947,-77,-208,-162,-46,59.35294117647059,17,1871.0,0
0,1,0,447,-368,815,-238,-300,62,277.7586206896552,29,-381.0,0
0,1,21,233,199,34,-569,-534,-35,116.80327868852459,61,233.0,0
0,1,0,1040,746,294,-166,-293,127,334.6,10,746.0,0
0,1,2,1665,1134,531,-160,-139,-21,150.23529411764707,34,1134.0,0
0,1,30,219,-185,404,-433,-515,82,135.6,30,218.0,1
0,1,40,611,-601,1212,-230,-229,-1,290.16279069767444,43,-625.0,0
0,1,56,251,220,31,-499,-466,-33,119.95454545454545,44,249.0,0
0,1,51,824,185,639,-576,-559,-17,210.12820512820514,39,88.0,0
0,1,0,1195,499,696,-261,-331,70,406.3888888888889,18,1189.0,1
0,1,0,553,-515,1068,-257,-322,65,284.94736842105266,38,556.0,1
0,1,37,233,-278,511,-539,-529,-10,178.71428571428572,28,234.0,1
0,1,11,689,-972,1661,-283,-189,-94,345.1041666666667,48,-991.0,0
0,1,0,1077,1050,27,-79,-75,-4,55.588235294117645,34,1077.0,0
0,1,25,135,-1158,1293,-311,-183,-128,272.36170212765956,47,-1162.0,0
0,1,6,1459,-38,1497,-216,-745,529,365.95348837209303,43,-26.0,0
0,1,0,460,-498,958,-283,-308,25,351.1111111111111,27,463.0,1
0,1,0,912,470,442,-185,-212,27,325.35714285714283,14,912.0,1
0,1,0,739,-450,1189,-341,-232,-109,309.358024691358,81,740.0,1
0,1,0,120,207,-87,-328,-552,224,252.625,32,-210.0,1
1,1,23,774,1510,-736,-195,-36,-159,184.0909090909091,44,814.0,1
1,1,3,1194,185,1009,-286,-392,106,260.6,55,84.0,1
1,1,18,420,-744,1164,-223,-85,-138,280.60869565217394,46,448.0,1
0,1,1,81,-1144,1225,-288,-143,-145,358.29411764705884,34,-1144.0,0
0,1,0,1791,1162,629,-250,-143,-107,260.11538461538464,26,1788.0,1
0,1,0,426,-53,479,-271,-654,383,367.8636363636364,44,945.0,1
1,1,46,209,-272,481,-528,-485,-43,158.1851851851852,27,209.0,1
1,1,32,801,-1100,1901,-147,-214,67,308.6290322580645,62,-1115.0,0
0,1,20,1583,38,1545,-189,-671,482,349.72340425531917,47,1588.0,1
0,1,0,1097,605,492,-229,-367,138,370.2736842105263,95,-888.0,1
0,1,0,171,-251,422,-538,-505,-33,260.05882352941177,17,-274.0,0
0,1,56,50,748,-698,-311,-214,-97,255.96153846153845,26,736.0,0
0,1,2,23,-11,34,-648,-597,-51,55.5,2,26.0,0
0,1,22,67,216,-149,-557,-515,-42,127.9,10,227.0,0
0,1,0,2035,958,1077,-276,-165,-111,290.55555555555554,36,2029.0,1
0,1,0,1232,702,530,-255,-347,92,378.7142857142857,14,1201.0,1
0,1,0,214,-263,477,-559,-502,-57,102.68888888888888,45,214.0,1
0,1,0,648,-657,1305,-217,-326,109,396.3030303030303,33,649.0,1
0,1,1,1638,927,711,-232,-165,-67,210.4848484848485,33,1632.0,1
0,1,0,553,-628,1181,-281,-257,-24,383.38709677419354,31,-628.0,0
0,1,0,713,-842,1555,-251,-218,-33,443.45714285714286,35,716.0,1
1,1,47,1704,1927,-223,-170,-73,-97,103.66666666666667,21,1920.0,0
0,1,2,85,221,-136,-467,-452,-15,91.28571428571429,14,84.0,1
1,1,44,549,728,-179,-258,-39,-219,119.54545454545455,22,734.0,0
0,1,1,580,-477,1057,-215,-121,-94,198.234375,64,583.0,1
0,1,0,534,772,-238,-215,-216,1,172.5,44,533.0,1
0,1,0,998,740,258,-230,-317,87,368.0,36,222.0,1
0,1,0,1320,1057,263,-256,-284,28,157.64705882352942,17,1057.0,0
0,1,0,586,-492,1078,-169,-169,0,369.8666666666667,30,587.0,1
0,1,22,733,-680,1413,-187,-224,37,297.7659574468085,47,734.0,1
0,1,0,1382,930,452,-219,-199,-20,186.25,24,930.0,0
0,1,6,216,-219,435,-499,-466,-33,185.16666666666666,24,213.0,1
0,1,0,261,-136,397,-492,-558,66,341.4166666666667,12,-136.0,0
0,1,0,1536,980,556,-208,-203,-5,194.74074074074073,27,980.0,0
0,1,0,1504,1377,127,-358,-316,-42,162.125,8,1498.0,1
0,1,0,590,-481,1071,-187,-193,6,303.1142857142857,35,585.0,1
0,1,0,1381,1055,326,-263,-284,21,157.61904761904762,21,1055.0,0
0,1,7,1799,935,864,-203,-179,-24,259.2121212121212,33,935.0,0
0,1,0,693,223,470,-137,-413,276,264.9047619047619,21,694.0,1
0,1,0,518,827,-309,-200,-122,-78,114.57692307692308,26,519.0,1
0,1,0,470,-695,1165,-213,-199,-14,291.4,40,470.0,1
0,1,0,208,-544,752,-420,-119,-301,280.9310344827586,29,-544.0,0
0,1,4,853,-589,1442,-277,-232,-45,320.2888888888889,45,-589.0,0
0,1,59,17,444,-427,-386,-90,-296,193.96428571428572,28,468.0,0
0,1,18,494,-592,1086,-166,-125,-41,305.1388888888889,36,479.0,1
0,1,29,1023,1482,-459,-204,-189,-15,187.91666666666666,24,1486.0,0
0,1,0,4,302,-298,-795,-793,-2,303.4,10,3.0,1
0,1,25,170,-642,812,-509,-229,-280,232.33333333333334,36,-642.0,0
0,1,28,289,455,-166,-254,-210,-44,137.45454545454547,11,455.0,0
0,1,15,584,718,-134,-181,-212,31,66.0952380952381,21,736.0,0
0,1,25,217,-469,686,-406,-177,-229,191.34285714285716,35,203.0,1
0,1,0,200,-385,585,-479,-259,-220,451.93333333333334,15,-385.0,0
0,1,0,218,-248,466,-583,-430,-153,182.4,25,-248.0,0
0,1,4,239,-209,448,-588,-504,-84,163.85185185185185,27,239.0,1
0,1,77,304,-279,583,-608,-565,-43,177.28125,32,303.0,1
0,1,5,528,-589,1117,-265,-169,-96,261.75,44,535.0,1
0,1,0,784,455,329,-252,-207,-45,333.1,10,777.0,1
